id,start_time,end_time,duration,power,voltage,priority_t,priority_e
1,1713909427,1713909543,116,5.275024213365179,4.925095293687884,0.5210631076089312,0.14245993276793498
2,1713911287,1713911572,285,5.260491738714551,4.880237328761597,0.5022130318551237,0.8669310279826337
3,1714001527,1714001734,207,9.689035775583918,3.677278121559424,0.7595020676604828,0.1348525784533733
4,1714079527,1714079589,62,10.416359655898571,3.5573762999015033,0.6675774048016202,0.3042978530439898
5,1714179787,1714179895,108,19.721791547362464,4.120908779623621,0.2756603150299173,0.5389381734063464
6,1714175047,1714175077,30,11.697352685988047,3.9403705141228347,0.7354875553414606,0.360791175683258
7,1714205587,1714205627,40,14.823053093112975,4.652333769413492,0.4428904685039462,0.6993740951793364
8,1714266967,1714267075,108,15.430490145566083,3.7260074974789985,0.37785442542091374,0.6106079687861219
9,1714364587,1714364780,193,12.248949605809766,4.153475327120599,0.12416277428236125,0.767322964134356
10,1714359907,1714360041,134,11.532047283255077,4.110704663598952,0.7087577802575744,0.21660571206223678
11,1714321627,1714321891,264,5.017498653964555,4.540672185957997,0.26225578226947466,0.8850294919224213
12,1714394287,1714394462,175,17.970551012707993,4.3363182701558065,0.7083359787612559,0.8142024276133986
13,1714413127,1714413264,137,18.372375539281578,4.476385600498262,0.260460099496532,0.43468155866572133
14,1714426567,1714426831,264,5.511381137115499,3.8002473765865923,0.9621397360175528,0.2644623927892682
15,1714506847,1714506885,38,10.707184266203377,4.7163636722638165,0.427885340872069,0.37864313464657484
16,1714612807,1714613102,295,9.091009109660686,4.1176084795438115,0.598251427535964,0.8977077746220689
17,1714708687,1714708896,209,7.291116256314121,4.460338880511673,0.21665426178749314,0.6072531090338337
18,1714658587,1714658868,281,9.714501396187607,4.742211210728678,0.961833621932093,0.1534477538469367
19,1714727887,1714728124,237,14.987290703110817,3.3141160470612885,0.5664947903671254,0.17141244594202004
20,1714760227,1714760411,184,14.92418281395058,3.4105878931027758,0.5618534948106657,0.5521217409618866
21,1714754407,1714754471,64,16.45544690273379,4.773409066925581,0.8150276119065133,0.477318334057966
22,1714875727,1714875921,194,10.788962057406426,4.191541719405205,0.9771594061017991,0.8324882538238217
23,1714820227,1714820508,281,6.4368550007600955,3.3016226765702092,0.5118403379053331,0.10535327453300633
24,1714848367,1714848543,176,10.258120289397803,3.9297390960094374,0.28330352721015056,0.37147438213871564
25,1714924147,1714924405,258,5.1141104654547975,3.7212639937058123,0.6782059253489807,0.18974093219432842
26,1714985527,1714985563,36,17.20470612346943,3.882628271821649,0.5453930970307319,0.3361607165344743
27,1715065807,1715065919,112,8.173084504312115,3.521574116276944,0.9911215835047446,0.6306484251661125
28,1715111827,1715112028,201,16.019425340935456,3.778652872656632,0.20901984693520145,0.14538169494257253
29,1715131387,1715131474,87,15.592990502919086,3.350197797666301,0.5896751368095767,0.7339486865579098
30,1715093647,1715093855,208,6.465304745948653,4.496886156634766,0.3583047459804889,0.8282567597003988
31,1715209807,1715210084,277,12.685537284866108,4.3444970338091,0.9002110613835499,0.6625486691085049
32,1715279707,1715279986,279,14.07386087992609,3.962672196547893,0.9379327244766199,0.3991149595011797
33,1715266867,1715266964,97,12.853366650188,4.632426924701819,0.9539865193154731,0.2564257988901051
34,1715367727,1715367810,83,13.021993761984724,4.576855012794814,0.12564064892228521,0.4415602299962871
35,1715338147,1715338351,204,16.070893181770067,4.239953671660535,0.6204642709389145,0.8582425960404931
36,1715355067,1715355311,244,12.338104800020567,4.282926961958987,0.9284207241651852,0.4597635443963961
37,1715485327,1715485453,126,9.544790100889445,4.849114485526872,0.7012531946817968,0.15589863787047276
38,1715551687,1715551718,31,8.001007900739062,3.535529134959198,0.17812083213097132,0.7347798630389879
39,1715555467,1715555568,101,5.215423490345806,3.7314836290479354,0.1602594789496704,0.6964919281907631
40,1715639587,1715639765,178,5.457211945337473,4.66463103496147,0.6464508785834656,0.8039796911574589
41,1715606947,1715607132,185,9.722063226947096,4.565771510143219,0.28220796929088987,0.5280517134174079
42,1715708347,1715708508,161,16.718234418138053,4.516873196805873,0.44002371027363585,0.47958321491894906
43,1715808007,1715808215,208,9.707006315173,3.9895636192751374,0.3870879890764628,0.5281790646439545
44,1715920387,1715920426,39,18.03224722023453,3.7447107167212255,0.7156686083930517,0.5369830062587637
45,1715981527,1715981811,284,5.240106360457681,4.728122110656505,0.35888410911218593,0.991366660454727
46,1716056647,1716056733,86,15.642967982585883,4.624740004612169,0.8484141827394553,0.921435662524635
47,1716067507,1716067681,174,10.089358458012843,4.623960101707004,0.348135330315171,0.267008653883943
48,1716188587,1716188748,161,9.908965699548475,4.352509398245461,0.7132594153029869,0.7753312278795668
49,1716257107,1716257245,138,19.520118027733822,3.3611687776687207,0.3549497991232772,0.1855353595387012
50,1716325687,1716325958,271,7.020685584949874,3.3638132294092813,0.7458689218836966,0.9360491676086424
51,1716322687,1716322775,88,9.743649057385113,4.934715577865495,0.6295296739449662,0.4915427860456293
52,1716324967,1716325164,197,17.514777615581004,3.6394722520015397,0.25870100995697426,0.630891462338043
53,1716390727,1716390998,271,19.798469800300662,3.4995568218162654,0.5679901430326989,0.5264662915278437
54,1716428827,1716429086,259,7.817605801916693,3.941609640306754,0.12471399778665004,0.43713338703384663
55,1716367627,1716367735,108,17.43684670649307,4.129241047632231,0.8424855344679641,0.8821925448868805
56,1716491047,1716491332,285,14.778970295335014,3.542339805939161,0.5243797993903337,0.36570783733405743
57,1716449587,1716449694,107,15.379287741210561,4.696533047663248,0.2885699666642771,0.6716977717414663
58,1716520507,1716520785,278,13.593510735009088,3.4187808482493987,0.5514059119493936,0.8569605816964947
59,1716604807,1716604960,153,7.843972685791746,4.385603838002849,0.9647313348048863,0.24014926601041878
60,1716543487,1716543651,164,13.605085268152656,3.9757600069207717,0.2823411486145127,0.8651357686853322
61,1716548587,1716548635,48,19.231201620235353,3.9216944745364315,0.7342200974199433,0.23372367059162089
62,1716669067,1716669102,35,15.955069329451105,3.5537665985087434,0.5854100692741766,0.21184957477369418
63,1716713407,1716713666,259,6.276045732661342,4.253373105946191,0.42683947911661935,0.48721314238209257
64,1716755467,1716755690,223,15.487014787625128,4.189583888405667,0.401200335196522,0.3843787573850158
65,1716835507,1716835768,261,19.191784905232915,3.4704973104686845,0.20486916032163782,0.8718373470201853
66,1716908587,1716908686,99,11.927988725151748,4.122296597182246,0.8137134158974617,0.3135211102526668
67,1716944827,1716945119,292,14.289180727094045,4.2124273588498,0.5177975147965078,0.7843480525117221
68,1717010167,1717010366,199,5.75571046496803,4.085845785050707,0.7482283227218135,0.8889540468763648
69,1717009567,1717009829,262,19.362770699110214,3.408353954395284,0.34231247741778004,0.20148998108261684
70,1716990127,1716990386,259,18.409511271667867,4.180793551215387,0.9569088428283862,0.76750151608979
71,1717078207,1717078333,126,7.539907256073363,3.9206774419783073,0.9057452057309521,0.5533454072752811
72,1717075507,1717075643,136,14.12784396579523,4.422005833546367,0.14283894448996742,0.2953741064460421
73,1717217767,1717217922,155,11.713672681798364,3.8774146071423456,0.20211083852638773,0.16913508930764598
74,1717187107,1717187300,193,7.857192103263405,4.230601429682377,0.47446558034196906,0.8073952968855106
75,1717145467,1717145579,112,14.229084132267303,3.6391554312012606,0.18943270854699734,0.9222600510799636
76,1717275787,1717275963,176,10.827223771878092,4.613598606023418,0.11701189004821506,0.7181315189636713
77,1717240447,1717240647,200,17.36555840901795,4.186673835595673,0.4859170646993143,0.7688139890688925
78,1717350847,1717351145,298,12.695536819972448,4.22928759770952,0.3980747325404401,0.5175292738268106
79,1717399927,1717400111,184,7.320730311375048,4.671511095703426,0.7397156770582681,0.6681155082883445
80,1717416727,1717416763,36,5.094319291043606,3.755321424631224,0.3228197834893757,0.5326322803836251
81,1717426867,1717427041,174,14.962758023450666,4.958106462054978,0.5076561489255147,0.22450330332639362
82,1717507747,1717507941,194,13.276760085250022,3.4817882971301715,0.5616069698762327,0.5257462203647002
83,1717507687,1717507921,234,19.657670793368347,3.9576348432129747,0.5008216963309182,0.8885296465725816
84,1717536967,1717537256,289,18.620055002557613,4.163279582933726,0.3430113110803319,0.7046672821572325
85,1717615627,1717615681,54,19.220673313903077,3.731164796604899,0.4908565484713163,0.5919203098967621
86,1717666447,1717666695,248,19.575443272165828,3.7085318820352917,0.8855970020887531,0.5409925380495777
87,1717822687,1717822965,278,18.317141382051194,3.7205317018631114,0.6362975199066497,0.1152258912821559
88,1717782907,1717782950,43,10.540612937412911,3.3635530691054676,0.3193375271331361,0.7510759790700553
89,1717756867,1717756935,68,14.467851923794386,4.52550201365636,0.9391899358933533,0.8478008492804987
90,1717895707,1717895845,138,19.31875931994801,3.3988209804669975,0.31013260655725416,0.9128159677392407
91,1717845067,1717845124,57,15.933207317691854,3.849718709147564,0.8929184273692657,0.35283154323008636
92,1717848367,1717848438,71,8.906435062470132,4.282423375904147,0.42923202081072953,0.6712312043803027
93,1717947967,1717948265,298,11.772341004258546,4.1492263114346635,0.6438915696295794,0.901250295626563
94,1717955707,1717955948,241,10.745283816883772,3.6628398787278567,0.10441340993608152,0.3543568711960178
95,1718084587,1718084734,147,7.907380066486379,4.106963181120806,0.3907332435247264,0.8947745061151091
96,1718075827,1718075965,138,19.418451544974584,4.841956871540016,0.8701868166524744,0.4771058923587356
97,1718130607,1718130789,182,14.63008341366289,4.8485583580720615,0.515237105704874,0.2698814083125011
98,1718175847,1718175982,135,13.559150754132006,4.348680910766376,0.4529424272504783,0.47600058894481045
99,1718116567,1718116728,161,19.461444231840808,4.755033294215215,0.7446569469881037,0.8037771115661397
100,1718228227,1718228356,129,16.809084017043034,3.5220450010889475,0.6629326991786426,0.7210813655309816
101,1718332747,1718332940,193,7.250038699568071,4.764603826080412,0.4199724388848737,0.8306982838165031
102,1718388187,1718388250,63,7.961327849031223,4.903319209067817,0.23324780129204775,0.7502797598482656
103,1718496547,1718496583,36,19.658394334236924,4.596364978185607,0.9950117590052695,0.7116135606016248
104,1718517547,1718517737,190,11.50815400928327,4.389853724209106,0.39534128574421445,0.754882230365851
105,1718582947,1718583058,111,13.254625007069684,3.7188066751962805,0.38167506937257056,0.40278279484013646
106,1718590867,1718590973,106,14.427157343498134,4.320251108142823,0.56952222999442,0.5784603208723283
107,1718599687,1718599733,46,19.323326055169414,4.515624700081677,0.8754943374480156,0.6731879197493184
108,1718630947,1718631246,299,10.691552887242807,3.928682709595712,0.8355678919772686,0.10998237552220519
109,1718705647,1718705824,177,15.867702103089465,4.543333303849582,0.4080124842862566,0.7058780400684168
110,1718729467,1718729618,151,6.869367158894404,4.468075907561461,0.2242895834842808,0.2679984755530801
111,1718750707,1718750886,179,16.117894083835672,4.766346355115816,0.992987518495222,0.7359808973236543
112,1718846887,1718847139,252,9.584600943533239,3.754368715687389,0.42051156710081183,0.8638977881554667
113,1718887447,1718887553,106,11.012939822756408,3.8019053856049787,0.6592447943907914,0.6174252695851566
114,1719029107,1719029175,68,15.385634340048668,3.926679627980109,0.9395383376871141,0.3467318591141862
115,1718985067,1718985247,180,11.771619079138116,4.598534216436059,0.617546594649881,0.8866762492022469
116,1719028147,1719028190,43,14.711153700373675,4.783790233985479,0.5824978533729673,0.9182494693634007
117,1719064807,1719064899,92,5.700710468450632,4.230905610533405,0.8283771110875535,0.48163303521560086
118,1719057367,1719057410,43,8.867328239006659,4.81827906003478,0.801569954727166,0.5157704410290912
119,1719043327,1719043507,180,6.957675644996826,4.474015883629213,0.6042326413289505,0.5550341372757398
120,1719144427,1719144549,122,18.018651477771662,4.707462830482063,0.8392893658789978,0.42980869001527755
121,1719151927,1719152182,255,12.946494436912193,4.603614821033444,0.4730013559376173,0.1348547266236254
122,1719223267,1719223490,223,10.254834080091324,3.9022070038524594,0.81795844871775,0.6612475472172998
123,1719271987,1719272168,181,10.01021021039306,4.542594142461601,0.9828276967718746,0.5222417677469152
124,1719337147,1719337428,281,17.226642664560586,3.789204392275816,0.5618405267286212,0.9557014294371289
125,1719354367,1719354464,97,6.112361797822675,4.489358451103655,0.5629964980199236,0.7037855265357039
126,1719428347,1719428552,205,6.867023946063974,3.361256745729485,0.8623797161144537,0.3524129130422672
127,1719534907,1719534992,85,17.05531352464334,4.851888265440697,0.3611938788347714,0.7654069757906422
128,1719577807,1719577887,80,6.8153243851868055,3.4220473858835696,0.1797626043891291,0.8372433412610853
129,1719606967,1719607024,57,10.792683004003758,4.427356266292442,0.9728713816165911,0.6252346344501896
130,1719608347,1719608424,77,6.413806427733142,4.240561637665882,0.2086079211733075,0.6016801788255854
131,1719693967,1719694254,287,11.362687126979269,4.41206517885229,0.24951594228444238,0.97377902212004
132,1719714127,1719714420,293,7.789082012065656,4.214380382371999,0.6021501174229947,0.3733854243762822
133,1719719407,1719719644,237,13.973854327066986,3.9962064819355776,0.9317174651790145,0.4538016133398266
134,1719779887,1719780064,177,18.636359380640407,4.806392443139467,0.7404404134755558,0.47820319122015653
135,1719771247,1719771338,91,5.294159461525447,4.206040266067239,0.5465927876891105,0.9962891452956139
136,1719796567,1719796851,284,9.241659079591448,4.583283645381962,0.4427932821325168,0.8492098768838068
137,1719896587,1719896877,290,14.317552773990002,3.5758277872241635,0.20615197674724067,0.641268444245142
138,1719962887,1719963154,267,8.44800935438007,4.0840816022595705,0.9044004947731176,0.1523890874134084
139,1719949147,1719949227,80,17.139675379763798,4.449995358068637,0.4354998145757275,0.7939018200577385
140,1719950167,1719950323,156,14.189576498496187,3.5429825775855526,0.9801880754013096,0.1593672057371037
141,1720043167,1720043429,262,5.633339667706493,4.7442602230829545,0.6661700283588349,0.6292257313298505
142,1719993007,1719993293,286,13.085698006073164,4.65358410878085,0.1676609296584851,0.5410709157624775
143,1720082107,1720082307,200,15.076651679823936,4.216799203653361,0.4448516204568711,0.7935740941533383
144,1720093867,1720094033,166,6.788726459246989,3.6902696136429674,0.6932636628770497,0.8792198749222777
145,1720165327,1720165537,210,13.928768386732868,3.341564674543892,0.43181368228087513,0.10412240678220736
146,1720191667,1720191842,175,14.107131068594953,3.9191890525763804,0.4502577628236637,0.8771375725642548
147,1720311667,1720311716,49,18.6150718748117,3.476704698119158,0.4265703305007936,0.34470354237644685
148,1720325947,1720326122,175,17.335799724161824,3.483984694178768,0.11171262730615152,0.40947009336353035
149,1720287067,1720287145,78,14.616204291258702,4.660585390529729,0.4631490457086114,0.8663356110072177
150,1720376107,1720376352,245,16.116058373866807,4.798480798604285,0.5777638456679183,0.3058724078425408
151,1720457947,1720458068,121,17.22701638512367,4.454886482979265,0.27221424960095864,0.1914218376715689
152,1720433167,1720433308,141,18.25215928460477,4.316319231511702,0.24344214887941318,0.3105971377210088
153,1720554847,1720554944,97,7.943652062604054,3.6005188736334346,0.818583036463621,0.4202146078565713
154,1720628527,1720628637,110,9.049462388227154,3.461209158717652,0.21853803716644443,0.20712697445124456
155,1720739047,1720739107,60,14.81966412737041,3.7832293962987986,0.9257749197907834,0.2931738684799497
156,1720709107,1720709175,68,5.863653053728827,4.778301511993685,0.3899483015211944,0.38538976120755786
157,1720807507,1720807622,115,15.780638862827779,3.5540323966270346,0.7695491841242907,0.6790709453703602
158,1720776307,1720776357,50,13.788920069133084,4.00636713520507,0.3991063449897455,0.3489843834809866
159,1720807087,1720807149,62,10.776077474431922,4.689937700834987,0.4327530382918746,0.38088940915840996
160,1720883107,1720883161,54,17.691519077605257,4.98521755521281,0.31636101966549923,0.9343552557603443
161,1720932907,1720933124,217,5.341662285984045,4.300925134361552,0.8793585912218327,0.22404780673161273
162,1720875307,1720875554,247,13.163648773951618,3.6112893818517096,0.4430594129799764,0.9110256486720745
163,1720951747,1720952044,297,18.320688594781384,3.364116984667327,0.8711204888095017,0.22766807817689502
164,1721001547,1721001847,300,10.007857332057611,3.763754716757339,0.13080310536402026,0.7803666706233052
165,1720946227,1720946468,241,19.69831402765255,4.276393620171083,0.5506906235641991,0.3143712431947966
166,1721060167,1721060314,147,19.8295610545008,3.961829512724731,0.7376695962240508,0.116644111330803
167,1721117047,1721117175,128,18.55778840565501,3.680417483855271,0.9431384587213253,0.7805168277059746
168,1721193667,1721193898,231,7.38554830345866,3.515454926519341,0.9340866544524787,0.2630157737057389
169,1721125867,1721125952,85,19.01309457283397,3.727143824992129,0.4445817234308166,0.8097084335685817
170,1721207707,1721207920,213,15.34405965608559,3.9561325676880585,0.6331372272929826,0.867823251047493
171,1721364247,1721364403,156,7.412194596621825,3.55874511684297,0.37251316979484406,0.7592790459260326
172,1721455267,1721455364,97,18.86802899830203,3.749602806528383,0.6416080949917855,0.9275293605851962
173,1721475727,1721475824,97,6.649053578153394,3.4861784640223683,0.837458090209989,0.8367195920863751
174,1721522287,1721522382,95,5.599452588008686,3.7512896720465343,0.15361751709941135,0.1543562688074604
175,1721612827,1721613081,254,16.019448632393768,4.657341024762567,0.5406678812000395,0.40857118023609884
176,1721614747,1721615040,293,9.127931770533674,4.734328033973645,0.2765685411023415,0.3888038234059348
177,1721691247,1721691509,262,13.059914729017503,3.97097845861097,0.9994784263757084,0.6007485599396847
178,1721775787,1721775890,103,5.436369245870773,3.898637979452509,0.31100956982411654,0.8719380490555414
179,1721856067,1721856342,275,13.131958734548425,4.265567248700377,0.3922645759364205,0.12718174680027083
180,1721955607,1721955763,156,19.81248242593064,4.259897348055682,0.15574154304620677,0.4977921109666925
181,1721919787,1721920064,277,12.735832846157969,3.6902366408317455,0.30757570917355254,0.9364819026850909
182,1721910487,1721910674,187,11.716956645078113,4.1784419624475495,0.7479695387401313,0.2510376781515475
183,1722059167,1722059222,55,10.490415962927287,3.867011562835403,0.8130733110774245,0.5102475552559046
184,1722031987,1722032099,112,11.615420798370018,3.957058541098298,0.8482454940450762,0.15798138126126232
185,1722129967,1722130075,108,11.71943808498212,4.464270643450305,0.6971062335427056,0.990307344157381
186,1722083587,1722083777,190,17.627984445855432,3.454652212487956,0.8049732394831767,0.9275198413803691
187,1722154867,1722154929,62,9.786816486825117,4.603151069630237,0.18938634089177736,0.23690580536210523
188,1722189487,1722189576,89,18.068548910993094,3.3809857944559054,0.4961716872366997,0.42572023135111947
189,1722151207,1722151429,222,9.837360329276066,3.6469939300139442,0.8909851870892044,0.6128043876141376
190,1722256447,1722256683,236,18.546027550058092,4.285460482527428,0.699221136573166,0.3680253178964342
191,1722303667,1722303958,291,11.165206950265471,4.226157997098519,0.1744575189993432,0.35985695679236873
192,1722254527,1722254569,42,7.845076532639496,3.3632684626394087,0.40225110037908707,0.4532062319254966
193,1722363367,1722363481,114,17.94437812394527,4.433133744097,0.7897116400006603,0.280361555029253
194,1722388567,1722388605,38,12.121595871385832,3.863602533773603,0.8791955029756133,0.791551813186253
195,1722342127,1722342251,124,15.715445982465686,4.934116962899598,0.6143310608411959,0.3545978855479581
196,1722453787,1722454087,300,15.815189419075075,4.780628309987642,0.37092811101354595,0.7612791151713612
197,1722474547,1722474689,142,15.946368278162144,4.707413617405246,0.81548868195925,0.6690997368172644
198,1722536827,1722536940,113,8.448728769933938,3.3714211796189852,0.8174188367893921,0.431557913923476
199,1722559867,1722560167,300,15.469148397697047,4.795894340102043,0.6040426058833345,0.6276155494929677
200,1722616627,1722616733,106,10.404907241627898,4.332158162693097,0.12914259517075916,0.6760253828293433
201,1722587587,1722587623,36,10.38838776605311,3.4443920001313524,0.7420193072012199,0.9296320542072407
202,1722654907,1722655100,193,10.956796510645272,4.023545965369855,0.7658405209510887,0.48131494088093907
203,1722733207,1722733368,161,19.546836934203185,4.49178377527497,0.2926745636173101,0.778893491260968
204,1722709447,1722709687,240,14.397921660527574,3.4364604743240528,0.883297695651513,0.8837435050832658
205,1722830227,1722830367,140,7.878783307079574,4.520381699261355,0.17297188388304707,0.8276209156636624
206,1722822727,1722822865,138,19.02822556792907,4.310294811273149,0.798436363098666,0.4959254614181309
207,1722829267,1722829520,253,7.113922193178256,3.8318832230900313,0.7853435595547406,0.9582366845106766
208,1722855487,1722855698,211,16.97823468767385,4.553072152311883,0.9799039016541379,0.6434978086966142
209,1722928627,1722928756,129,6.120163812560252,3.816556172756538,0.38717496574281307,0.9917460249754496
210,1723070887,1723070945,58,12.092090549538248,3.6555202986235797,0.149724816404533,0.5798187572827126
211,1723114027,1723114228,201,6.767594531986547,4.285917512440199,0.4740662796468301,0.5893870772964253
212,1723161607,1723161784,177,5.292182133378928,3.906192132071606,0.15794774268809336,0.8129606002140515
213,1723261387,1723261569,182,8.073958027177369,4.910906184044746,0.5590177705542884,0.8347113290973225
214,1723250587,1723250802,215,9.414991390791045,4.533654656456632,0.44223215583490694,0.9483896501200877
215,1723293667,1723293784,117,17.411399442770154,3.520789099625633,0.49360934451120264,0.5586736397835496
216,1723283167,1723283349,182,15.22053974767486,3.3199491885572674,0.2924661305739073,0.30422882905963455
217,1723321867,1723322167,300,6.755371819611152,3.587382928586555,0.16936563494127443,0.3537327783869605
218,1723368307,1723368595,288,10.704974590062642,3.9983894489251255,0.3233391715890283,0.8300194767593213
219,1723501087,1723501256,169,13.805495386031476,4.32796163261967,0.733782483062238,0.20385246508882227
220,1723505227,1723505399,172,13.031246429695111,3.4576644304008246,0.9353414150480193,0.6484693890700881
221,1723544527,1723544620,93,12.069617457341963,4.028872549894112,0.63152694376349,0.2626360458523386
222,1723672507,1723672684,177,15.497720725581923,3.7984264939702084,0.10780785638269055,0.4944405912079729
223,1723625047,1723625279,232,9.42683751954052,4.354346635654622,0.6413056141288069,0.4550678052849272
224,1723782487,1723782784,297,17.59129347968971,4.433800761904376,0.14688820047775542,0.3992020088371624
225,1723787767,1723787800,33,12.265382130714647,3.4493500376547934,0.775905009192558,0.5531530432834242
226,1723727167,1723727437,270,12.81494879651475,4.585661105340263,0.9112628518905013,0.4417539856231496
227,1723877767,1723878046,279,6.899671835717391,4.913496767219556,0.33975480413270737,0.8929389877069212
228,1723816387,1723816422,35,14.68454818598492,3.880149208979547,0.5354509925272172,0.3833424553355098
229,1723879387,1723879675,288,7.02493284028795,4.16930841079086,0.9751873265398937,0.11181111540922162
230,1723919947,1723920004,57,13.617234511295171,4.679093911659681,0.9465099025393583,0.40385093998137633
231,1723915267,1723915554,287,16.303329004488802,4.330835163143094,0.8602084606099695,0.8536395091271312
232,1723966147,1723966191,44,19.78632467756659,3.618567740131676,0.4752275481232374,0.5829601700694813
233,1724092987,1724093199,212,18.5997379817183,3.3310478633780423,0.565297802496494,0.4891076626719505
234,1724164627,1724164729,102,13.979996469150068,3.609853166188131,0.2886870920809825,0.11252360635351971
235,1724286007,1724286254,247,6.913773578881017,4.282945506039607,0.456891219962284,0.38037862054411764
236,1724271847,1724272061,214,13.9141060856248,4.842824616711812,0.9065453958266695,0.56762676543159
237,1724371507,1724371548,41,19.84908973921464,4.939444636758091,0.8431864954029683,0.22608050723850834
238,1724407747,1724407940,193,5.513744812785319,4.852450840629116,0.1561325905324127,0.9033926640363411
239,1724436727,1724436834,107,14.792063616791575,4.854061014824075,0.32811840910714585,0.7170649226650146
240,1724464087,1724464340,253,19.947288010757866,4.450722820902444,0.1501834405091544,0.7150365424543056
241,1724514547,1724514648,101,13.459357953976117,3.4784765468880536,0.33295767229627754,0.2535917129609201
242,1724506807,1724507103,296,10.418998012285016,4.465840345785159,0.867149402772233,0.6972956344426868
243,1724610547,1724610819,272,12.688845732012286,4.774776763520769,0.571459857745555,0.6958252355850422
244,1724635747,1724635924,177,5.326082793085195,3.466575086727687,0.6280328120907849,0.8484134618962498
245,1724611567,1724611605,38,17.169610650108037,4.163240447775444,0.8287269825155382,0.7907370287552998
246,1724666167,1724666439,272,18.263783402062224,4.4975791650267585,0.8878158178285153,0.2598656982295554
247,1724798767,1724798828,61,19.439134585583858,3.8959846216376572,0.547830474890691,0.8600581694109969
248,1724829247,1724829374,127,12.553681676018414,4.518391593431808,0.9084069500421668,0.8504467845975806
249,1724957047,1724957283,236,18.75685627894518,3.704256055227071,0.9524069522901546,0.9279349471504589
250,1724920687,1724920939,252,10.834714796957012,4.823633850610271,0.5897713334674352,0.11908167865855067
251,1725061567,1725061823,256,14.628304217791015,3.518745023792078,0.2744216629984598,0.6349133855950728
252,1725085747,1725085884,137,14.595419850909494,3.622826015605522,0.5597838087496864,0.10247128472770592
253,1725155107,1725155353,246,13.577867927017161,4.158434865454794,0.17270646400284195,0.4344481366055817
254,1725171007,1725171044,37,15.80159606096527,3.627575231916116,0.6977363275284176,0.93823485459929
255,1725166627,1725166870,243,9.882017394801606,3.3952822335762796,0.28333630197311344,0.13256541266231076
256,1725233827,1725234116,289,13.328906178408854,3.44449947298313,0.41902046225631995,0.8911082568085801
257,1725248707,1725248830,123,12.971849514260178,3.5528335420254034,0.22534590909869326,0.6533378837005351
258,1725180607,1725180710,103,11.968400703081015,4.861177719486292,0.9813487260394642,0.22081310058570477
259,1725288847,1725289053,206,17.415021135598927,4.909024343429422,0.2989882246991916,0.7532949200599451
260,1725328627,1725328862,235,19.683694334675796,4.342873816756841,0.6256537046253441,0.7458838098853195
261,1725374227,1725374481,254,16.1026298914051,3.592117988046267,0.590665033791418,0.9862459413986427
262,1725400747,1725400812,65,15.523441300097641,3.814952113809306,0.43148272678492783,0.24117572558459394
263,1725434827,1725435041,214,7.552543098275042,3.661692979557834,0.11180369006312624,0.12300184939410885
264,1725527047,1725527173,126,14.27121169316076,4.876321274993433,0.7564989253831186,0.6776509035986699
265,1725535867,1725535984,117,5.509352711442396,4.735748938671801,0.24574061693896995,0.8555246332206097
266,1725618907,1725618983,76,11.760602200941994,4.178853727026311,0.45038780263419753,0.4201454129985356
267,1725640027,1725640126,99,10.439142869980717,4.928342156332169,0.6449957061634506,0.5983022538988252
268,1725717487,1725717549,62,16.74708569132203,4.94298153777751,0.37220857082991177,0.4058823210102046
269,1725799027,1725799315,288,7.789331965910437,4.287437277194141,0.8456229407508671,0.5306351110181518
270,1725835447,1725835683,236,17.715644196220893,3.965327010291673,0.26026243636458246,0.2601983404189543
271,1725947287,1725947562,275,14.981884778154596,3.748881009775235,0.4737974726357157,0.4767325472114753
272,1725991207,1725991411,204,13.80311467315521,3.307897252770214,0.6600240079522344,0.8491919069286697
273,1726043107,1726043254,147,10.641370148290402,4.076670292518683,0.5998992716120203,0.32982607021089116
274,1726087507,1726087727,220,10.894373421080491,4.853760755260135,0.42424038413500353,0.5746913152851123
275,1726152067,1726152244,177,17.222687410531694,3.563972195822954,0.8927225415649496,0.9211654488851259
276,1726146247,1726146446,199,7.414787620971457,4.0979731066599046,0.37429545966924294,0.5130307059898177
277,1726261087,1726261282,195,12.127102131833931,3.809850726154452,0.8722038080939959,0.590772675735624
278,1726215247,1726215299,52,7.507754768118078,4.372704420450832,0.3449496000465919,0.8286322082885447
279,1726367467,1726367690,223,8.742262078295203,3.994284359985672,0.8311406061214877,0.7836348945057064
280,1726302127,1726302421,294,14.072104607817513,3.6615741368578703,0.9110091655026553,0.19381198233265468
281,1726442707,1726442800,93,6.057498516736941,4.6100915977851304,0.8598949707391075,0.6598391937291238
282,1726529167,1726529234,67,9.859048707937184,3.3409952390229862,0.2450490580680307,0.6389058329244695
283,1726540507,1726540764,257,11.602875328234475,4.637213361125223,0.6386344963107959,0.35975636122639576
284,1726617127,1726617292,165,14.050504757155823,3.4277760425585706,0.4361911467623828,0.9569362865248922
285,1726622527,1726622636,109,10.30522289260729,3.8794911719356984,0.6172439253216117,0.6546430976805894
286,1726603027,1726603209,182,19.34331433554683,4.678210245873214,0.4527020325000656,0.3436806348323054
287,1726686847,1726687141,294,18.470225292751415,4.349345005812149,0.7231555012658245,0.6326650335139836
288,1726772647,1726772806,159,12.941610557540887,4.568039753788958,0.5164304151130349,0.13131251217042766
289,1726792387,1726792596,209,9.878906315880773,3.4215312495286034,0.29881586490779255,0.5463946540405795
290,1726850527,1726850669,142,19.81238634847566,4.975172052241378,0.18779564088690118,0.41973299775076256
291,1726858687,1726858740,53,18.809448234200666,4.48329075306849,0.7577441532577548,0.17373609964019304
292,1726911547,1726911634,87,12.128286570585935,4.92931192072187,0.8520963740213651,0.2650655689954527
293,1726945327,1726945391,64,10.881846134580123,4.158435099298979,0.5098280557182913,0.2643046922407162
294,1727016727,1727016776,49,14.464129514947826,4.136555541090474,0.4245688372147124,0.3204564852130133
295,1727067667,1727067726,59,5.211551314333141,3.5819719256163913,0.4699185423452453,0.10125989906914779
296,1727142487,1727142640,153,11.932061212075673,3.5054478453721214,0.3247356853322181,0.7811493653803019
297,1727091127,1727091187,60,7.343898224609082,4.504154181175527,0.5754017481033055,0.7614510065084523
298,1727172367,1727172539,172,8.988785972900914,4.521449528104723,0.14251819783359498,0.8084900833840124
299,1727182867,1727182939,72,13.091017810268694,3.6007567445225614,0.9568019675835123,0.8488813991412818
300,1727221267,1727221503,236,12.87674101835347,4.123051816098232,0.9276847641378715,0.1969499763459825
301,1727275687,1727275933,246,15.00679910311173,3.705441860312534,0.5473688066500567,0.10320117232435888
302,1727309467,1727309743,276,11.457743164694493,4.76945144217953,0.398957859737759,0.8840334603004367
303,1727277187,1727277407,220,5.286668895143759,3.4816901734973813,0.9675421005127887,0.4863095009128986
304,1727396947,1727397201,254,12.02451237910459,3.95685666494452,0.1252575761213687,0.5320453410767314
305,1727448067,1727448141,74,13.669950778982257,4.205575549782156,0.3373468487530601,0.34303769036078213
306,1727456047,1727456274,227,10.943216328341343,4.357217597260751,0.530713240168534,0.33171206510034623
307,1727541247,1727541492,245,19.870976297891225,4.596959294240855,0.7426548186670378,0.4762764125029576
308,1727588887,1727589079,192,10.33862717769599,4.116137053555661,0.929316720117745,0.17977515293034135
309,1727519527,1727519650,123,7.28688759836419,4.820411151218972,0.4198331003729744,0.9849037017817859
310,1727617207,1727617418,211,14.499431600133963,4.566234345757381,0.15495311157062414,0.6999138064265994
311,1727628187,1727628254,67,5.354259209507743,3.7527664872187936,0.6614433495199371,0.26862554312730935
312,1727690527,1727690721,194,8.063382176424714,4.585225844226861,0.4429505270315438,0.591848177960465
313,1727751907,1727752086,179,17.812278744063896,3.303931236596362,0.35989381876197735,0.8091559089772278
314,1727744047,1727744211,164,13.50295036966267,3.860460544152554,0.5313635656011964,0.5459448931427975
315,1727848687,1727848786,99,14.364672237280612,3.8758253216121834,0.7812381634881558,0.9685750628729033
316,1727904067,1727904252,185,17.64565651319455,3.467555562207497,0.4758642266253089,0.6630651077312987
317,1727975887,1727975972,85,5.105614412418226,4.315790648602853,0.5519358789004623,0.4230124579855902
318,1728023167,1728023394,227,8.017097909586077,4.365743894817469,0.3500359414543085,0.925752124229719
319,1728021427,1728021462,35,10.191303820691605,4.873537406889107,0.8892034721397941,0.5360489889258425
320,1728060187,1728060275,88,7.0361698793973915,3.7450215506085804,0.2870826687702275,0.4043936554753014
321,1728123547,1728123656,109,12.438432221275228,4.4662496338696345,0.9501262158231939,0.5419036604867051
322,1728273127,1728273388,261,17.77678986153336,4.262234095720056,0.1726088466568381,0.16989135665429364
323,1728265507,1728265673,166,10.238413590318299,3.310884466681228,0.21456566919135597,0.7904771870739077
324,1728259147,1728259265,118,8.23034489029851,4.211692789483023,0.8597466309816337,0.961722261549173
325,1728359407,1728359529,122,7.208737218541047,4.227195624926872,0.30456865594275895,0.3390113899200925
326,1728344287,1728344521,234,6.82668122108129,4.609710769536816,0.36433061628731034,0.5015295601301528
327,1728295627,1728295681,54,15.72766592731265,3.5605736776186325,0.8633554080344811,0.7314628044590555
328,1728417847,1728418108,261,10.710592436826067,4.509980821065484,0.653481172593114,0.7386050839457878
329,1728385267,1728385543,276,9.416192619605688,4.704212030494149,0.3485231262209826,0.4319763060431985
330,1728413527,1728413787,260,7.27614150985869,3.755031151669979,0.4670175993093866,0.44310689214714316
331,1728461827,1728461866,39,6.7809425528869305,4.488305120037055,0.5971530113659931,0.16814128614453114
332,1728553987,1728554241,254,7.170903018824582,3.938718307311005,0.670751095026366,0.33792981898159863
333,1728700687,1728700982,295,15.171817355655532,4.107537728576889,0.7838665642032686,0.8839302480221322
334,1728775687,1728775731,44,17.110440529471035,4.525086214197834,0.20638376219833765,0.8283019547239224
335,1728762247,1728762517,270,5.503868358448666,4.72949862731978,0.44309432734018306,0.7841605382630874
336,1728730387,1728730501,114,5.963461508635408,4.627229517930044,0.40838951422806724,0.4213887471037675
337,1728809347,1728809481,134,5.8443156637370715,4.926114153781159,0.11090535712669222,0.6610452087354314
338,1728961747,1728962013,266,18.86644790705535,4.559354602647266,0.7927918344460119,0.23320970082264642
339,1728917227,1728917282,55,11.187969580059532,4.807413195539251,0.25289453958337893,0.3143061786146465
340,1729044067,1729044335,268,6.835276226977092,4.637008537851937,0.8097594258455726,0.3563615056110051
341,1729036327,1729036432,105,6.1636187257418165,3.532455502960853,0.38848825693054034,0.558290266388592
342,1729070407,1729070495,88,11.604337806759506,4.95552293026997,0.5432562261402294,0.774111674619375
343,1729117987,1729118247,260,14.930348670872167,3.3506299612112684,0.25759719067376546,0.26682318704046337
344,1729186927,1729187025,98,10.714239646583252,3.6332568042741404,0.7360482242264978,0.5844380461706947
345,1729224907,1729225177,270,10.867048236579143,4.068031104406502,0.2108268263820821,0.5775482195933174
346,1729152007,1729152081,74,6.828361485061456,3.3415917085640907,0.5845652191452547,0.1093011210048837
347,1729260727,1729260941,214,19.37498465148075,3.915905388121182,0.9081312054469891,0.6822343395537541
348,1729284007,1729284210,203,7.915613408901663,4.8164405701061614,0.5911118781124876,0.4114335623405413
349,1729278307,1729278448,141,12.57049696359826,3.874350583904916,0.6767572470989284,0.5410644214426198
350,1729342867,1729343154,287,12.654073508139184,4.58162837114538,0.6897015275886133,0.8446514629935188
351,1729380247,1729380327,80,15.439322651496916,3.3603771562895304,0.13851019405843532,0.4706425719457883
352,1729434187,1729434402,215,19.78595825290533,3.462412312841278,0.48244658232716464,0.7961054231456187
353,1729524727,1729524985,258,15.155723352188307,3.700094271656475,0.5703136278357471,0.26516008857881607
354,1729527547,1729527727,180,10.976148759642236,3.727815677466963,0.28162518142373405,0.7818333368493868
355,1729513327,1729513442,115,16.904765066558518,3.9686515840832906,0.38752076811419833,0.9743036304877923
356,1729588987,1729589136,149,10.669110306927198,4.635705362788585,0.13467572015402546,0.27899681426684053
357,1729600327,1729600523,196,18.600617970584636,4.441141729252963,0.46912090293227193,0.5512169374554461
358,1729727947,1729728007,60,14.011070182291407,4.930247621002864,0.4846050102538879,0.3558678941454667
359,1729752007,1729752261,254,10.205053602251528,3.789852807193804,0.6767506706355972,0.277357354817002
360,1729746607,1729746792,185,18.37916969946172,3.903782417703009,0.8031545309595708,0.27541101165409937
361,1729810627,1729810883,256,9.293178352938874,4.163957527214486,0.4362655274004855,0.40835164160089876
362,1729771687,1729771823,136,8.567885086349845,3.3731794440313387,0.7800384224177244,0.41869582046527765
363,1729796107,1729796328,221,8.910852728994898,4.23839164289637,0.37713751106535154,0.9309406089346118
364,1729893007,1729893174,167,17.40997174334666,3.339792526717075,0.6068901691125641,0.9582633927773218
365,1729849147,1729849220,73,19.21520040410968,4.754610981674768,0.4455239692202435,0.13304240631066316
366,1729969627,1729969657,30,7.418669163771859,3.9373561928003427,0.17933081562176156,0.19979024935019835
367,1729931947,1729932004,57,18.462813825261478,3.336464027630807,0.1278804354700731,0.3063768787335053
368,1730019547,1730019725,178,17.586660474358474,4.327947757750803,0.28983260802575117,0.7246229499653507
369,1730075707,1730076005,298,10.748320340536441,4.022101228244966,0.7069876144144287,0.5668849929262322
370,1730121547,1730121650,103,5.46576723136478,4.835429905689512,0.2519596393537351,0.7418833197082617
371,1730213407,1730213514,107,16.004759888928128,4.843237940607928,0.7472956088003108,0.3147021019027677
372,1730202247,1730202509,262,9.316342362600125,3.541068959440859,0.9492491280500075,0.9765457958671987
373,1730192707,1730192791,84,9.746678943960811,4.616165823868309,0.22971358143234105,0.9480071984255872
374,1730338927,1730339004,77,19.50970585458729,4.2737471330717,0.9560197224435389,0.6043807087118944
375,1730340247,1730340395,148,17.502482986503008,4.416452528966512,0.9073386011241058,0.18510606167656246
376,1730356267,1730356426,159,6.076597468590158,4.39537266439997,0.37284761025871727,0.7505883240381017
377,1730444587,1730444703,116,16.804648430401436,4.33711790410746,0.6112259698079013,0.8640233385631912
378,1730478847,1730478998,151,16.433380695258837,3.4631612194697508,0.7966127557929443,0.8664332049587098
379,1730471407,1730471549,142,11.685244648490116,4.158721987979483,0.32902579544514643,0.9257217001448612
380,1730521147,1730521240,93,13.048000875888548,3.9226957046990183,0.5397854214870195,0.878577918902994
381,1730533147,1730533189,42,19.948062811182574,4.48216404328586,0.13174121743769776,0.8048088638649685
382,1730557807,1730557982,175,16.056394051265606,3.733235064624202,0.1447859378033761,0.7136743317233925
383,1730557147,1730557355,208,9.945249411663232,4.5181520379522295,0.534233512662568,0.7429655409556024
384,1730633887,1730634138,251,11.486490751356662,3.486762953367225,0.5003626141212585,0.2491676803526793
385,1730722087,1730722370,283,15.390439714516615,4.940466999745972,0.7466805492713539,0.4524154983629346
386,1730736427,1730736627,200,11.702769314348917,4.987030429178683,0.7333398718878256,0.38503327556861355
387,1730719687,1730719832,145,8.573164063894,4.989325019808246,0.13704032221301643,0.5358661448917353
388,1730868547,1730868642,95,16.140454221767648,3.6654268073545238,0.8402558301215949,0.5924065844556555
389,1730825107,1730825154,47,19.863738197260687,4.130810508274612,0.3110052932766548,0.9675952588919647
390,1730927287,1730927517,230,8.870719043227671,3.5355705600632086,0.8634403321932216,0.34163502281903985
391,1730919787,1730919891,104,7.1334853202231425,4.784166986262744,0.8427405410027511,0.45317882430300904
392,1730990587,1730990621,34,16.06638211987677,4.150141217976289,0.6803923639669962,0.8827458786678611
393,1731018727,1731018774,47,5.156407285995613,4.850766173906639,0.7393995151119197,0.5871203910335816
394,1730963887,1730964061,174,9.382820498523342,4.0871791456579585,0.8246211182717175,0.3275752390079843
395,1731081487,1731081538,51,12.714814419221476,4.625531969147543,0.7056423504422499,0.9293765036368011
396,1731100147,1731100409,262,19.581621982158893,3.3005873566709467,0.9881180520040538,0.11289054819952149
397,1731135787,1731136055,268,6.3805722918860335,3.4887184894248375,0.18640477520319534,0.785696412167931
398,1731162607,1731162881,274,9.39406041144826,4.004318310955691,0.17987371136915917,0.2193245836846025
399,1731264787,1731264910,123,19.31805582140509,4.389600503285983,0.5388789466565685,0.7454747425197106
400,1731294727,1731294856,129,6.5176180002029716,3.541455489522483,0.6083892835351563,0.8651305431914078
401,1731326287,1731326381,94,9.905791359134513,4.399361572412856,0.9224061039798626,0.7554187473142083
402,1731347407,1731347486,79,19.49840575778438,3.4118095006581273,0.25317767164270366,0.6452185914579454
403,1731441247,1731441345,98,6.1781219292584915,4.294217311129183,0.6510154707858115,0.5760500323743915
404,1731403567,1731403776,209,8.400530129515266,4.089613785954262,0.24495760640682857,0.9471412619297972
405,1731469807,1731469838,31,18.48032803833108,4.384355663987037,0.4984911166844874,0.13521112273663963
406,1731523147,1731523213,66,6.091257721478418,4.717924775599149,0.405040126108572,0.44744209175022664
407,1731524107,1731524315,208,9.251656080987111,3.5997683022033873,0.23933402795031522,0.2797003714264195
408,1731528067,1731528311,244,17.308997037638214,3.8400399693509515,0.9714649366330048,0.8540384071753533
409,1731610327,1731610408,81,17.354307012224083,4.97340501974064,0.2734144768331081,0.6232108650243706
410,1731667147,1731667414,267,11.389554868504012,4.921363714696593,0.3065385140655471,0.531418652255565
411,1731708187,1731708357,170,12.458268066550408,4.556111182193898,0.8837484739619261,0.18158555551771624
412,1731819127,1731819306,179,16.489126892411253,3.863280240167323,0.4928582628878282,0.35993264130134295
413,1731807907,1731808166,259,6.203560670491992,3.3085509639364887,0.7765159925301519,0.5457516530474702
414,1731832087,1731832312,225,9.80584525342065,3.6784556340161685,0.8965192342827685,0.14725444445608737
415,1731924247,1731924475,228,6.915248595731371,4.125050468935001,0.532114892656508,0.4932330940712383
416,1731949867,1731949958,91,7.341892205060489,4.788934817620662,0.5943010740103213,0.5259795428511463
417,1731943327,1731943600,273,10.775937922644975,4.26575400468653,0.9477242185983056,0.5471875781704512
418,1732085947,1732086135,188,18.020747089317958,4.64268973945379,0.6270284800892112,0.8763173508277117
419,1732068847,1732069041,194,5.06917952697444,3.9978161124380915,0.29146099143918375,0.22425075927818028
420,1732117627,1732117890,263,5.360162789328924,4.546073752513611,0.8057648342355138,0.46058678185110535
421,1732211347,1732211428,81,5.1828272779765046,4.310212445075913,0.9947399545063585,0.8257871380787295
422,1732227247,1732227391,144,8.628100568488506,3.510882977960632,0.1318193891873139,0.8590596500859794
423,1732328287,1732328494,207,14.543093531762928,4.048202767550468,0.7203488218394466,0.28383713547584355
424,1732350607,1732350871,264,14.664980889643044,4.547827831244237,0.8641865806723712,0.8273097806510297
425,1732392487,1732392621,134,12.888097918498913,3.318406372547083,0.20126226916557416,0.9819747201137823
426,1732360207,1732360424,217,14.27086156692953,4.010010771211808,0.8576085459263564,0.37318413442931286
427,1732493947,1732493990,43,15.423498044545006,3.9067323559234213,0.9026861401208169,0.6722699714095849
428,1732453987,1732454072,85,16.12266993339719,3.9117725809245893,0.9060601548680033,0.87491802258458
429,1732589887,1732589926,39,17.2679371907891,4.9792202085095765,0.2714419805120968,0.8829749500820671
430,1732678567,1732678794,227,19.895075827862193,3.699061464917859,0.32630169178527413,0.20368667703577165
431,1732613167,1732613236,69,11.280231027421433,3.4151843616121904,0.4432231673475624,0.14034742520164895
432,1732694587,1732694792,205,14.4552057304665,4.956464558320508,0.9150360111776034,0.673554977327245
433,1732832107,1732832289,182,17.02745419694731,4.689865917186878,0.916939972640725,0.8320079533269642
434,1732829107,1732829362,255,9.53398485128039,3.4447798830419205,0.20735232674608434,0.712574463317682
435,1732808227,1732808443,216,14.365086694758103,3.5153416113486586,0.30336528820109865,0.8956547736575122
436,1732889347,1732889481,134,12.285282161462757,3.947896333094122,0.1923893742072622,0.6980170661040204
437,1732950247,1732950323,76,15.90111426991313,3.396456649640203,0.9712572011183406,0.9052214373654567
438,1732929427,1732929698,271,10.580549678288856,4.917333459895365,0.3749060268537747,0.6416352955307937
439,1733034427,1733034537,110,13.631417041979779,4.124914432928837,0.531822638327257,0.7482867644154325
440,1733067067,1733067321,254,14.27632522825206,4.759131930463068,0.42279020365424147,0.9015884777948396
441,1733121667,1733121718,51,6.88815310543611,3.3316951621896695,0.10612479216850534,0.6680700903898192
442,1733072407,1733072679,272,16.429162815715163,3.5353776286312515,0.14304428408397976,0.5845192924339943
443,1733156167,1733156341,174,19.19685260974321,4.718176111481376,0.2103677271221488,0.46563969731024213
444,1733149387,1733149614,227,5.208638208240347,4.7650207568610865,0.17823930049548947,0.5212826264713603
445,1733275327,1733275470,143,9.467132910708145,4.886254902054323,0.4211554765857969,0.7523570246519911
446,1733264107,1733264152,45,7.509937581757169,3.757183685578723,0.41165409077837767,0.41578681779743953
447,1733246047,1733246093,46,12.741318749584492,4.168598812471014,0.14988808173998777,0.4337859472421952
448,1733365147,1733365209,62,10.438318019318613,4.304794913305364,0.7589069474508913,0.5762871103838383
449,1733366767,1733366816,49,7.862519405693618,4.177695531394766,0.4903709126635978,0.24733398434969095
450,1733387827,1733388012,185,15.031739394862417,3.9703381924805723,0.12948778474321804,0.7356431149527011
451,1733472427,1733472482,55,5.503014137989597,4.245577833825752,0.5908201634578814,0.21208175102575333
452,1733495587,1733495876,289,10.98398562115317,4.210587859510376,0.5734262111418194,0.839046237110707
453,1733622727,1733623005,278,19.206585770654947,4.2002734172306875,0.7151923944481269,0.7311055509439752
454,1733575507,1733575709,202,14.462523813913092,4.593623833015254,0.4806741097087299,0.7965768387876718
455,1733670007,1733670081,74,19.73474511575838,3.7168924298504415,0.19196147244029954,0.16734453011096917
456,1733803807,1733803842,35,19.54724240340929,3.6154153400007947,0.8825793766965467,0.7746548618518448
457,1733801467,1733801671,204,19.79613893510588,3.9138821456969954,0.7335146403289123,0.6896989417149897
458,1733834527,1733834648,121,13.41016714662526,4.126259937218892,0.4925237523012418,0.7476798267290772
459,1733821567,1733821714,147,6.230462973624719,4.89304403105451,0.4894318920792817,0.1550266401984858
460,1733817847,1733818140,293,14.33141146610838,4.185154288836472,0.3148614118493898,0.731793401984731
461,1733953087,1733953219,132,18.943188731244568,3.4357338462384384,0.18010833003565024,0.5367454772286928
462,1734051847,1734052102,255,19.6367259159829,3.43876314072817,0.6474864425570608,0.2659089041980539
463,1733999647,1733999901,254,10.132939837888856,3.800970996030236,0.35138815656777433,0.4270784049075137
464,1734079387,1734079472,85,19.82869174023137,3.7167062567191347,0.3760939888768261,0.881430504132727
465,1734242527,1734242573,46,7.479380277701313,3.3593128875870586,0.19520407109145912,0.5453352502715123
466,1734202507,1734202660,153,14.456818746939442,3.3041239351861007,0.40621511000049115,0.6589207022683735
467,1734321607,1734321711,104,13.523496509066392,4.9848759285513236,0.8634015303422793,0.26520535800559597
468,1734349567,1734349786,219,9.181199927296941,3.966757927334851,0.12029386981341166,0.36831277194815304
469,1734367747,1734367919,172,12.288536050915344,3.4089930334165492,0.5380262617447249,0.6939282819011722
470,1734494947,1734495004,57,11.50732483798252,4.26292807861841,0.6269952233480114,0.2909764942981933
471,1734534007,1734534197,190,6.504949629503489,3.56781487949539,0.19937146328390576,0.6254111249887483
472,1734593647,1734593709,62,18.491708219507245,4.375428769016317,0.31092802377818657,0.399793356933253
473,1734649807,1734649929,122,11.07980979006728,3.693089944736661,0.43479576513351625,0.9976832246334888
474,1734644467,1734644726,259,6.698532661603908,4.818189012606379,0.21619501059932925,0.9204987228764507
475,1734750907,1734751056,149,13.617303141958466,3.3439963022139985,0.8888745912314484,0.5321436312095559
476,1734807847,1734807923,76,10.50956359467338,3.5653734929165424,0.1913818052562811,0.3379368406040491
477,1734856027,1734856305,278,15.319777045042011,4.779835832548942,0.17633218476843754,0.6978026628820041
478,1734920707,1734920872,165,8.091010726859373,4.625752799263928,0.8456428768308678,0.8245911439602174
479,1734861247,1734861305,58,5.0368794187161035,4.057317530382679,0.9278318405030496,0.4542337218178999
480,1735004107,1735004334,227,5.109773490391153,4.509084660140636,0.9562056043476093,0.40779042807408017
481,1735049467,1735049627,160,15.441067827564911,4.139510839102171,0.3277688830348243,0.29802347061507234
482,1735061887,1735062142,255,10.257226914711477,3.9825424662748894,0.6418088415268873,0.6182126832717083
483,1735120627,1735120676,49,8.450233127172222,4.419313136420316,0.7662658320635362,0.5851841888667366
484,1735161907,1735161953,46,6.848604532985307,3.307750082886399,0.9553166316236796,0.39217790013381537
485,1735126627,1735126693,66,6.469748590910978,4.5491738140883875,0.14523725577007013,0.3978651324532445
486,1735259167,1735259291,124,13.320539410367708,3.9311538930448036,0.13303146763047163,0.15220924822141743
487,1735326967,1735327241,274,8.942962279549686,4.757042002171355,0.8183169910155136,0.5191454686536322
488,1735399987,1735400023,36,8.408402037866605,4.8845000365516436,0.10448746827776559,0.889106679196887
489,1735446067,1735446131,64,12.10783933248975,3.693373995312988,0.8117834857165661,0.9218955165299895
490,1735497127,1735497290,163,18.70258206329523,4.115816922191496,0.5413568664186492,0.1905881248957239
491,1735484527,1735484688,161,19.360470286444016,4.877036467606318,0.30033112778302606,0.7740995682536886
492,1735499227,1735499428,201,8.69997636009672,4.011111660308252,0.2117285390778553,0.28131114303272214
493,1735593307,1735593389,82,19.993861331918794,3.903389155160397,0.979207791099417,0.21622375148683848
494,1735576987,1735577084,97,13.987238924353589,3.5862703591877683,0.6888175848329937,0.8605047904486263
495,1735547167,1735547404,237,9.786851694111443,3.992218596257716,0.2682214215406789,0.5329537918122685
496,1735698247,1735698365,118,10.691762487052848,3.868867997959414,0.9781779482543339,0.9664907341791766
497,1735666687,1735666891,204,14.75630677151484,3.4716440431352042,0.5286098556387181,0.24960691967185497
498,1735633987,1735634088,101,8.488837074877491,4.048266118994339,0.20779244689414944,0.5406494190505152
499,1735759147,1735759433,286,13.684261972071003,3.6710255894026727,0.772642486071656,0.7138712031257535
500,1735766287,1735766394,107,15.152357190836184,4.995734716629183,0.5344748755758065,0.17955592303574935
501,1735758727,1735758902,175,6.241205754106794,4.619317582136922,0.259308921058545,0.235098500737554
502,1735834687,1735834780,93,18.399822310622213,4.3968103252574675,0.9415679908941673,0.4641146725026819
503,1735885687,1735885963,276,10.014632667160292,4.131749354376258,0.3611920328006958,0.20507366712166303
504,1735841167,1735841276,109,18.72688289917795,3.5514385274291946,0.7034706693721873,0.2196110616709015
505,1735895587,1735895882,295,14.62421136483496,3.7549504048373974,0.4480536409954916,0.8491112711678585
506,1735931587,1735931800,213,7.300170511510071,4.697880385083746,0.1829776219923953,0.5532513844098508
507,1735892947,1735893237,290,14.44276173691841,4.576168196457687,0.5577931927132498,0.7855784709109047
508,1736045827,1736046057,230,17.51639733367656,4.235932429609951,0.10174626516523262,0.4439449132275173
509,1736121127,1736121272,145,10.4441046426229,4.637647084397505,0.24187713061224095,0.9331551156810528
510,1736092567,1736092838,271,14.076604864830271,3.9412428062968003,0.44612210287066245,0.7677547359907443
511,1736226547,1736226755,208,12.132445002219724,4.055135068071916,0.5177805117945086,0.5614676048090349
512,1736149447,1736149599,152,19.31621270786425,4.088490786826462,0.18093757297393376,0.5103088868453358
513,1736206027,1736206159,132,11.010415909629835,3.8055635236865766,0.7535946161177179,0.9569592873355294
514,1736294407,1736294543,136,18.45076427713471,4.872273173732935,0.48660324646151243,0.6728060018574433
515,1736253427,1736253532,105,15.95857578322891,3.7329920695785592,0.153851908295122,0.20592944269856872
516,1736269387,1736269516,129,7.4441864271179305,3.858182852166403,0.630620971128731,0.9989678358818125
517,1736380387,1736380523,136,9.562740499471559,4.9544645737401405,0.4009678293794682,0.9228963543248129
518,1736487427,1736487517,90,15.7432231792574,3.870910959687086,0.45052169195634995,0.4317160852362112
519,1736454127,1736454211,84,17.31117888988244,4.676904097249176,0.38661850606685866,0.8824575177000922
520,1736484067,1736484149,82,5.339494294604736,4.247002089912959,0.5896551139793104,0.8579719661450443
521,1736578867,1736578897,30,10.247634272256615,4.8962628388152805,0.6822362284575536,0.5067599573278448
522,1736530027,1736530283,256,8.67326613369545,4.972913445232956,0.4146899843373607,0.7396046410833987
523,1736561047,1736561316,269,11.657245307217774,3.462027911336652,0.821982914699561,0.5296962878561219
524,1736645227,1736645286,59,14.04412365557645,4.114418663002531,0.5478574685136793,0.4818000646729562
525,1736619067,1736619204,137,11.284540332578583,3.7975550333996515,0.8076553428717756,0.730633584849281
526,1736717467,1736717689,222,13.174455482417319,4.210551133617404,0.793938626012813,0.5144051443254924
527,1736720707,1736720909,202,19.035162010063363,4.312230696554977,0.589600514484628,0.7921868613910378
528,1736695927,1736696151,224,18.877449502643906,4.804228177392414,0.30832388315742243,0.728549577125524
529,1736773087,1736773325,238,17.439139475676022,3.828110844225541,0.4021158553817361,0.3342380770506046
530,1736799487,1736799652,165,16.122453713169747,4.818125167868315,0.9354266182277349,0.4295926354266937
531,1736856307,1736856375,68,16.301958762910882,3.9144086428213694,0.27456226961950114,0.5703297136664266
532,1736888107,1736888291,184,10.629243157436216,4.249745456287792,0.7845527049612078,0.5736724668496797
533,1736958427,1736958628,201,9.180464419729216,4.347309152780417,0.2565092180189071,0.18015836318723016
534,1736996347,1736996566,219,12.666878612161522,3.4587226733576784,0.7692248528653558,0.5713498046521822
535,1737048667,1737048826,159,16.273665499835765,4.90565839756774,0.4927995358082998,0.7156213960722146
536,1737029647,1737029903,256,8.302037300171941,4.191714036636049,0.4970226807860594,0.41216539093518034
537,1737019627,1737019681,54,12.66375265090575,3.831446274712263,0.8332211778710807,0.5339156884128744
538,1737163507,1737163675,168,19.023293427969875,4.03476239760715,0.8774929972319179,0.8643628410278752
539,1737160747,1737160873,126,8.636533601143183,3.4362943114754474,0.8077382575422235,0.7422609206581486
540,1737187267,1737187538,271,17.681763640143835,3.7796486094857342,0.9522233845268747,0.315365686015058
541,1737297187,1737297482,295,19.58589644182426,4.0967364944521005,0.21515779911229616,0.34021263351206116
542,1737388207,1737388507,300,14.328403329820796,4.268904013400612,0.3663060872214179,0.12059894243671643
543,1737458767,1737458988,221,5.152312372848138,4.747533422189324,0.9413097909824194,0.7360321704579843
544,1737481627,1737481707,80,13.377961614817343,3.8216736011519403,0.3416976435683813,0.7005665448113447
545,1737523927,1737524064,137,5.7212427083246915,3.8251636781624727,0.7180792410731747,0.2181165094205202
546,1737547987,1737548262,275,5.252797214701251,3.3575481272483465,0.8062849745226845,0.5660663679143966
547,1737657547,1737657680,133,12.08168786380368,4.524361130844535,0.19142580011483262,0.30585881807774234
548,1737773107,1737773150,43,7.668163951782523,4.687146340977815,0.4749585014717038,0.20384806914595624
549,1737754987,1737755208,221,14.14177690207549,3.512245821644057,0.6315991327761715,0.8145566388998181
550,1737834427,1737834688,261,19.68690922897614,4.631903492119981,0.1280743116731,0.889704623953567
551,1737835627,1737835896,269,12.042730184462927,3.833184801157314,0.8118440696308238,0.8279155738789138
552,1737807487,1737807597,110,12.291246154262403,3.968424058873471,0.22980578205051921,0.9315958371405744
553,1737931867,1737932032,165,19.994911356385316,4.369907108688816,0.805139201016042,0.43544436595044633
554,1737958327,1737958510,183,15.017685190458646,3.715668295298832,0.5214809361585877,0.12527477128942613
555,1737991567,1737991754,187,19.534545615741028,3.4270540800882667,0.48473465810467664,0.9964913598301136
556,1738000507,1738000800,293,17.870447081489143,3.8839682857319078,0.7332194662805739,0.6558130213199244
557,1738024927,1738025212,285,7.259409487403859,3.964861058900397,0.5893526608584383,0.3278526507244929
558,1738079887,1738080082,195,18.122893586164942,4.541348626287167,0.4665644804114294,0.1785620045224689
559,1738053067,1738053303,236,8.089019730399825,4.811602692765649,0.5118452656970497,0.5149590279815188
560,1738214347,1738214632,285,18.796113896975427,3.69658861830331,0.5062818899470057,0.9890497784403426
561,1738161907,1738162136,229,14.12692337649468,4.008968728365403,0.6111868977615961,0.6201762243645157
562,1738228987,1738229119,132,5.665410871956907,4.032402595310443,0.39021783882911576,0.8540278113113228
563,1738254187,1738254470,283,12.788344499777772,3.4574031577566773,0.4217476068668413,0.6702678684981356
564,1738389787,1738389944,157,12.799168678674977,3.9501432640676915,0.6977618531808146,0.7822791035948528
565,1738346887,1738347157,270,9.063847342593487,4.974646042810789,0.4538162938414849,0.9750504128023111
566,1738411747,1738411978,231,11.441601912206652,4.61694875474424,0.28839497068617354,0.7750515452063319
567,1738541587,1738541826,239,17.35290285374864,4.422790625249314,0.9451707766359735,0.25293471408652374
568,1738490287,1738490346,59,13.485124361784354,3.446964763854215,0.5038707732242259,0.7582415908647174
569,1738551907,1738552151,244,15.618199791738064,3.392072509943069,0.3016943160159633,0.23770088715072413
570,1738571107,1738571375,268,12.871040976852985,3.79905158743098,0.5513266977943736,0.5793657583996029
571,1738604887,1738605151,264,8.4764915178116,3.996704580180146,0.40760804496882974,0.968903456834403
572,1738573867,1738573918,51,5.020347139333125,4.186902539323404,0.6832644826652189,0.971941134205129
573,1738662007,1738662299,292,19.80222891534794,4.557292457541426,0.41448139391671524,0.1995676325251206
574,1738702507,1738702670,163,10.15326955331002,3.682043254169978,0.3054905280446236,0.1055492016041017
575,1738661467,1738661615,148,7.657396322271606,4.6592031299399626,0.7476740144725875,0.28149957741008547
576,1738758187,1738758429,242,17.73471678006174,4.981902017131931,0.11653226801965537,0.6089219048757057
577,1738799107,1738799379,272,6.81692073911231,3.893687775200819,0.3918496471675632,0.2967994167419023
578,1738840027,1738840241,214,19.915577421691335,3.3590625287966827,0.21814713788974177,0.9699682468267224
579,1738872487,1738872751,264,17.981977633046753,4.593946800434685,0.17025979967163568,0.10797079725211689
580,1738886107,1738886267,160,6.896649048142605,4.662018382561137,0.5843826753790407,0.163454084611557
581,1738948147,1738948350,203,19.021521218657092,4.272796452482637,0.5044570493767914,0.22037043593442796
582,1738977487,1738977742,255,16.978617259048413,4.726412108713142,0.5115935137013701,0.32385534307694325
583,1738978867,1738979032,165,14.282415721174594,4.084763806199259,0.2671934431391666,0.6385753906069994
584,1739045647,1739045701,54,14.334963796760709,4.751290582119459,0.13662580430399335,0.3827783852015979
585,1739063767,1739063821,54,11.657717056116763,4.498155528372248,0.8764165464089919,0.3671542545665475
586,1739155207,1739155434,227,11.294462292558904,4.791425241126322,0.2502066895763031,0.8177137603411644
587,1739113447,1739113531,84,16.85577623807797,3.382614397572382,0.8462170721761182,0.6769130677981086
588,1739161147,1739161188,41,6.894159717710604,3.424514182261511,0.13956419400516565,0.5241825458757979
589,1739184487,1739184636,149,11.83291189368912,4.187024604173867,0.5118528615592037,0.2740224008570675
590,1739298607,1739298831,224,17.61165348010639,4.2061183619473335,0.4068039539562588,0.8158163635138727
591,1739334127,1739334300,173,11.69255662792371,3.9598678071059776,0.2451569478418988,0.5447544182493139
592,1739278747,1739279023,276,16.674332393113154,4.072580575125413,0.1915115719296998,0.7788066952792267
593,1739378467,1739378707,240,19.551555305259615,4.041464283600751,0.4335966214096073,0.748694852555488
594,1739457127,1739457157,30,5.928665349453437,3.6517269411386195,0.6272417652569108,0.8904657659674124
595,1739475247,1739475346,99,19.155949650138673,4.466492190841997,0.21426268661170245,0.8040661778707425
596,1739512387,1739512657,270,9.524902425737771,4.575473310041357,0.3517711247801868,0.1953413095285319
597,1739580247,1739580356,109,18.207821559013276,4.70622503121948,0.4152879890373997,0.11475028670042102
598,1739552287,1739552494,207,13.724885889856504,4.594093803616264,0.5553113422686983,0.6147054024374359
599,1739523067,1739523234,167,16.634127922753457,4.249786493721717,0.21037388898276976,0.9887206939626049
600,1739636707,1739636967,260,6.608266040774741,3.8295126884055644,0.2420951238927309,0.29769101968241485
601,1739764087,1739764343,256,11.485729968479461,4.7039115461199525,0.8963277325476507,0.6355150011698117
602,1739724607,1739724767,160,12.626144774180725,4.65494521266943,0.47706422299045514,0.3866940606583773
603,1739759107,1739759296,189,15.679415977838827,4.729148624681032,0.8428190935119263,0.8212768863151314
604,1739831347,1739831383,36,18.554513314998115,3.3271830678734515,0.5152715998550579,0.7600257033429536
605,1739778967,1739779188,221,9.318728226050885,4.566608270968597,0.7949417069322126,0.4465624150262837
606,1739919787,1739919906,119,19.024609286746617,4.872876012727959,0.5395468952901237,0.39770273461826355
607,1739992987,1739993154,167,9.7595215864586,3.60533869706106,0.8410789265443385,0.7088028273195083
608,1739985367,1739985458,91,5.706701245176194,4.010716897816641,0.4431318509161779,0.8289905358611626
609,1739951887,1739952096,209,8.917826875993004,4.8694864298372735,0.34238946452360963,0.3961242043569768
610,1740039907,1740040039,132,9.343951669604959,3.7625545830601546,0.3763791284286342,0.4626698326304549
611,1740098827,1740098871,44,18.455160475480497,4.364034142498147,0.1210447666426979,0.9356610690515794
612,1740167887,1740168138,251,6.572622214967696,4.517690187429491,0.9783647337219542,0.9468973663751231
613,1740146107,1740146185,78,18.45225022542074,4.042919997718817,0.8772785428726164,0.4568575606252361
614,1740258067,1740258362,295,16.034494354603645,4.3186904436959965,0.4309821704666409,0.5788522315117925
615,1740319987,1740320055,68,10.141722930304038,4.1530923277599605,0.7420779081387957,0.23038857393729578
616,1740315067,1740315267,200,18.674916554328377,3.8611092127203572,0.9511036320801982,0.9612488631843772
617,1740446767,1740446908,141,19.892709372813428,4.6518612318273656,0.4974459182769032,0.2816334061903111
618,1740516247,1740516298,51,10.455529018309527,3.902889448288481,0.5734895828610604,0.5081722917809317
619,1740516367,1740516659,292,6.627597310440901,4.8104083829003645,0.4181702943490927,0.4514902422404371
620,1740627307,1740627393,86,12.680172291799128,4.090542023033469,0.9525789037791514,0.8338255317143075
621,1740712267,1740712332,65,14.65320648608845,4.998621249445921,0.8271598819123858,0.9199035714808159
622,1740662347,1740662553,206,5.297663372866291,4.7658562093433,0.9676692527940985,0.15231510267499543
623,1740649387,1740649466,79,8.58908222613766,3.866740283412512,0.8281357106241207,0.9138760883816861
624,1740786427,1740786483,56,13.092288078182376,4.233716285421643,0.369948194159345,0.88115223486025
625,1740795547,1740795620,73,8.473745522966693,3.816566621041135,0.2205604878853249,0.439172442448329
626,1740789007,1740789198,191,8.06173413853325,4.518309463775746,0.21814255923699571,0.10471374520717097
627,1740878947,1740879195,248,13.71883700986581,4.132909477486655,0.22220747164281357,0.794056054441516
628,1740831847,1740832064,217,6.56622409329265,4.8735680985613525,0.2547981802794427,0.32274378040196605
629,1740839527,1740839671,144,13.896430237513826,3.49347124518279,0.8292541797792173,0.5703788754602945
630,1740920287,1740920403,116,7.868746749016217,4.17925334800712,0.35023223188393016,0.5792201434888906
631,1740935347,1740935463,116,7.487848127321081,3.5365732086343584,0.7312544646632652,0.4834220367666182
632,1741070407,1741070669,262,16.119118749043572,4.695798379483154,0.1365654692157372,0.3758693219846234
633,1741080307,1741080520,213,7.509981113831466,3.5225742666445745,0.569560522297339,0.32278655489938984
634,1741138867,1741138946,79,8.770666502750082,4.233183655433295,0.6780047275023995,0.8230466460815544
635,1741127887,1741128008,121,5.784345260204709,4.259781854735094,0.9542534112272953,0.27916214565739306
636,1741178527,1741178726,199,15.82811431240002,3.5975923500870524,0.5115679458974595,0.4970459844455216
637,1741240867,1741241052,185,6.760421014283988,3.7327141253769844,0.6513540571791376,0.10216740156005122
638,1741166347,1741166577,230,16.876828268577647,4.339991324629354,0.6205036476943638,0.5344496665577132
639,1741329127,1741329372,245,9.398575511464507,4.708198547133346,0.7101020623605538,0.5454456189710392
640,1741357027,1741357191,164,10.828082148923107,4.748791690902761,0.2831183340701195,0.41960021919526624
641,1741350967,1741351185,218,18.13756321056986,4.81933867781904,0.5284414774455691,0.6990712741517066
642,1741381447,1741381601,154,18.102602487721605,3.572746096785765,0.7818907522741866,0.11935921514133997
643,1741425367,1741425414,47,18.407342048809507,4.295328870703083,0.3504597110532086,0.8948273437926756
644,1741466467,1741466589,122,14.591503932634447,3.917204500535507,0.8417503015353732,0.25752380495491034
645,1741432447,1741432494,47,6.51212882206463,3.639356247371052,0.6513325624249081,0.8477899014013845
646,1741521067,1741521221,154,17.772376358073906,4.390055648207714,0.52434077844768,0.789272263769928
647,1741561747,1741561911,164,5.3255395270752075,3.4161658495579137,0.7115217635479248,0.5366323783557639
648,1741659067,1741659136,69,9.650776312442026,3.805038705657104,0.9310623446735482,0.8197606649119588
649,1741704487,1741704551,64,7.4607673652164905,3.4338381116846506,0.2583823026719857,0.20284013414515883
650,1741723687,1741723956,269,8.013224074222185,4.761754615224902,0.7532003990896351,0.7514833237766941
651,1741756627,1741756762,135,14.296138749736413,4.796804112829002,0.6978981302757571,0.15280427822578282
652,1741822387,1741822507,120,14.261435455342355,4.515630095239786,0.7953758640555979,0.9942877439620855
653,1741830127,1741830327,200,19.529493457283813,4.274752129797721,0.6336184000884186,0.7108208726793239
654,1741900207,1741900255,48,15.463112520052302,3.5534020136750413,0.4462699643855983,0.5602873587565895
655,1741934347,1741934557,210,13.047774186290411,4.3527743959560885,0.7840502217365035,0.7210033614539016
656,1742005027,1742005137,110,13.73191126714712,4.314885901581112,0.3967002052433851,0.34637808774562734
657,1741941247,1741941323,76,10.310031518437444,3.923514976688627,0.10014804451702194,0.9111267262595634
658,1741977787,1741977840,53,15.546438592318182,4.364833653652898,0.518816914151162,0.7677211719135087
659,1742038747,1742038881,134,5.078916170300201,4.710651942422986,0.47807445852909036,0.7336692561464319
660,1742069647,1742069808,161,15.994237774168903,3.652055237390247,0.9801448244718186,0.518597953868933
661,1742047567,1742047620,53,11.745294862836523,4.691518523058845,0.8526805735329565,0.8885388068441564
662,1742132827,1742133108,281,7.701175647929072,3.4033844053171403,0.6697494112788003,0.8355740222162135
663,1742179627,1742179827,200,16.242931293182586,4.768913431105771,0.5282208466907958,0.27791581975362345
664,1742177587,1742177713,126,12.219616204745222,4.6711656144192295,0.7068971925050722,0.33101650957623646
665,1742262847,1742262930,83,17.850524815980652,4.79276196783551,0.9817532890835251,0.9006356478006509
666,1742291347,1742291497,150,18.556699820130948,3.613596714158513,0.12679186947089585,0.11311164334987264
667,1742357647,1742357920,273,13.923649216240849,4.289606741453233,0.35199400162012606,0.9455094534800541
668,1742377927,1742378191,264,17.934306881380493,4.983050710427619,0.19834254919334998,0.3805143001051533
669,1742410507,1742410570,63,18.509836868082534,4.995346937598976,0.3556930051400957,0.61731353138717
670,1742490667,1742490890,223,9.44321461668181,4.870556359529552,0.35209079398618237,0.5018593263022291
671,1742603707,1742603813,106,15.017375264293609,4.767450255047581,0.9238282904627703,0.5155404040179076
672,1742588527,1742588689,162,15.442405333825038,3.887315082218604,0.8052666008656183,0.9093602959754112
673,1742669467,1742669655,188,12.880745630804979,4.462804557291312,0.4341825677120056,0.16763003458417602
674,1742684707,1742684912,205,7.157494089731564,3.3553667569878503,0.38362197528536235,0.8165086402669284
675,1742727727,1742728005,278,9.369731195042426,3.929231031336044,0.7212067803587905,0.9691696841531021
676,1742723167,1742723279,112,18.612779855833573,3.3192300723969717,0.26835991766620476,0.23506579950978254
677,1742833867,1742834032,165,12.779621277392112,3.5308959954807233,0.2450195714616675,0.2257284429065152
678,1742854267,1742854395,128,18.082313701637332,3.91720058172411,0.9113400310307674,0.935858400245671
679,1742802547,1742802694,147,5.606885885691935,4.80294541111814,0.5638953326821449,0.7914016235654714
680,1742940367,1742940580,213,14.934144494315396,4.466798045689908,0.9317300734811627,0.13431278992733922
681,1743039007,1743039283,276,14.295734520633388,4.6243105350549705,0.17132820998179743,0.23552384183135178
682,1743018067,1743018281,214,7.47948552103089,3.964068223666632,0.5760448171347716,0.9173488869462824
683,1742984767,1742984859,92,12.785888633057983,4.474517072903638,0.6517935297945125,0.7583437109355603
684,1743073387,1743073670,283,13.895036928816236,4.5593157420230135,0.8905790980066431,0.33506947681130506
685,1743069307,1743069607,300,19.400619021562292,3.422016233925761,0.6905197859705638,0.5412778739877663
686,1743210907,1743210968,61,19.767797575205662,4.266479671475425,0.8778269652191332,0.3093652311494452
687,1743146887,1743147082,195,16.009206295558208,4.678351201108882,0.6810376811944394,0.796937756625681
688,1743251887,1743251952,65,10.047296399110781,3.7424948570763474,0.9247190048919989,0.3315754324994198
689,1743258427,1743258701,274,19.637861926296324,4.468328920031375,0.30501167539240487,0.2094829522615827
690,1743293467,1743293623,156,15.455955945184156,4.42810484813478,0.5790100004660665,0.5833786064336108
691,1743349447,1743349689,242,12.5219448327393,3.8662861935536545,0.7313715988083609,0.910793336613317
692,1743325687,1743325928,241,7.827548033303518,4.115319969666713,0.8446180337887486,0.7672432862552598
693,1743443287,1743443522,235,14.613505723086117,3.6616699533759265,0.45848877438203317,0.9038703192019197
694,1743485047,1743485239,192,8.27803388755262,4.574665887649647,0.9772775015712621,0.5885951669329513
695,1743564907,1743564984,77,12.027782664152678,3.38029263905433,0.3019825304957595,0.1353021982338501
696,1743528367,1743528405,38,12.887633655347628,3.3896284005908615,0.733085540224563,0.2960635661667175
697,1743524767,1743524857,90,12.453765633833772,4.057191469778523,0.3996817845386922,0.5324478832208217
698,1743641647,1743641754,107,18.573137270777593,3.600176801908295,0.9094749997753873,0.7774876860201858
699,1743586627,1743586825,198,10.078612652788173,4.667319788207663,0.36838133054472655,0.3315501518006534
700,1743718867,1743719033,166,6.045924693606542,4.307961944429595,0.2238068099589019,0.5107436987333634
701,1743702607,1743702692,85,14.19861088528019,4.086363307327019,0.3252547181334713,0.44062338319957384
702,1743668467,1743668572,105,15.71735590710207,3.9216072445749743,0.9221589595094396,0.771940630127859
703,1743803647,1743803931,284,7.587810531176077,4.243391056732041,0.43932487761257477,0.6208748705155965
704,1743851467,1743851739,272,7.586447994063112,4.307457644635493,0.6665231582820319,0.13308565963164573
705,1743871087,1743871356,269,13.233036792694616,3.9043562229335915,0.38718948157561384,0.7441778611761511
706,1743896467,1743896731,264,19.796259229136353,4.957584355198454,0.4095261294806437,0.7285302440476215
707,1743925147,1743925352,205,19.115412946632183,4.855041818340273,0.9208795779417454,0.9872575430067061
708,1744002607,1744002835,228,17.907816340341,4.791787640281528,0.19834316092368498,0.2972019812921255
709,1744066807,1744066889,82,16.224486336220753,4.6785683540561465,0.18887829924361121,0.21967510058057332
710,1744060267,1744060533,266,6.063753773714685,3.780077248758919,0.9814809413739485,0.22583105562311642
711,1744109887,1744110105,218,6.9023686775164395,4.075456268015219,0.5962879843706286,0.7350272565613016
712,1744133947,1744134124,177,10.047042430786362,3.4806197040816427,0.7239701455291859,0.37929377847841006
713,1744234327,1744234603,276,14.350659830313209,4.543265202370522,0.44728246420597284,0.5663758411480388
714,1744250707,1744250843,136,10.489862247761959,4.624974042108484,0.5462127745646724,0.6950278645643563
715,1744317607,1744317662,55,19.25271725597511,4.870252837783656,0.9650800230878837,0.8780711883415986
716,1744399747,1744399837,90,5.135724731448837,3.5647430187067926,0.6218459122955549,0.21434593056819112
717,1744382107,1744382185,78,19.21533822803312,4.643991599749692,0.33368138278871495,0.14101426439267467
718,1744398607,1744398807,200,12.607908927233378,4.900670738080289,0.21850728199137776,0.13535751690649514
719,1744502227,1744502418,191,17.967865583025457,4.8777398247196935,0.7783459633154939,0.8313666076632306
720,1744582987,1744583272,285,10.460754844271987,3.7123573230152465,0.38345024767855773,0.5023922120774318
721,1744542727,1744542855,128,19.68851142163744,3.7408495777760393,0.7187200867301136,0.7345553474678412
722,1744625167,1744625267,100,16.627344061167626,3.347575929292067,0.9039596086867634,0.4501447939868294
723,1744711987,1744712182,195,19.261043068810483,4.115609439134041,0.6748654052710085,0.13044617135891218
724,1744747867,1744748150,283,16.755085206064827,3.731916092547298,0.9150460014532515,0.6497628637511408
725,1744842607,1744842894,287,14.023597777450988,3.3978144447571665,0.8817859420790948,0.4770484556009208
726,1744839007,1744839142,135,18.44242068371092,4.132564420184885,0.16564000692140182,0.8652530858705176
727,1744943407,1744943552,145,16.607180603695518,4.041442833851345,0.939871239804269,0.12411193686751645
728,1744955287,1744955496,209,11.454859907716937,3.728110555728505,0.6352155677997698,0.4446027535730598
729,1745022427,1745022619,192,11.600448790499712,3.5557076238638228,0.49286151781461074,0.42017960783117203
730,1745108587,1745108852,265,19.95468480417986,3.838749107675434,0.8851394103768091,0.10419644536014168
731,1745132887,1745132953,66,8.337010072828535,4.697458432995708,0.9636246470057033,0.4469262743107739
732,1745110627,1745110663,36,12.061271394203299,4.8519883948596485,0.9137916387186177,0.3874286508493878
733,1745138887,1745139067,180,9.691146806366303,4.969719811116729,0.19413014967748748,0.7278894901886706
734,1745188387,1745188458,71,13.146997192275407,4.032021285286626,0.2871658183860931,0.6403548866730238
735,1745302147,1745302302,155,11.606868237002432,3.425454993816263,0.20443876811445888,0.753281770957653
736,1745291647,1745291947,300,8.069823282309372,4.57549688902225,0.9754051150723146,0.274560055580994
737,1745375107,1745375242,135,19.700400770829866,4.617532042924837,0.8772655242125078,0.4407291568791146
