id,start_time,end_time,duration,power,voltage,priority_t,priority_e
1,1713856398,1713857419,1021,1.3746650436331982,4.027845065407025,0.9305502347913093,0.10127797041345088
2,1713859998,1713863473,3475,1.8974649764512153,4.498338477552903,0.8899873736887528,0.11098626210838652
3,1713863598,1713867198,3600,0.480685712074709,3.108274689707564,0.1,0.1
4,1713867198,1713870299,3101,2.3479653936958926,4.643348723291613,0.7482663276817547,0.7510353344444866
5,1713870798,1713871211,413,0.5565014149595828,3.3187819229442614,0.22050568093469253,0.5912966038002584
6,1713874398,1713877998,3600,0.3130642621361655,3.0323732516995547,0.1,0.1
7,1713877998,1713880395,2397,2.220887556501526,4.369607204691591,0.13632158372404674,0.40614348707212466
8,1713881598,1713882096,498,0.7915650842773059,3.5894988180579204,0.7065843405052067,0.3909920152150589
9,1713885198,1713887550,2352,2.181622713390412,4.488638815695024,0.7117972233453955,0.628166829356286
10,1713888798,1713892398,3600,0.38907328709676936,3.0961206798683385,0.1,0.1
11,1713892398,1713895998,3600,0.385980011458662,3.0510890260978525,0.1,0.1
12,1713895998,1713899298,3300,1.8358952221377343,4.39355319530055,0.368654691939871,0.34074902473413493
13,1713899598,1713902589,2991,1.6252382357897726,4.331833892546173,0.6900547287772322,0.4937437094742242
14,1713903198,1713906798,3600,0.4079528434646913,3.1263773626755835,0.1,0.1
15,1713906798,1713910398,3600,0.15097733244177555,3.02191861879233,0.1,0.1
16,1713910398,1713910512,114,0.8189593816421308,3.5134915008530716,0.37304772763137917,0.41013802102411245
17,1713913998,1713917598,3600,0.3462319873080002,3.152910846712726,0.1,0.1
18,1713917598,1713919928,2330,1.761424249206735,4.53318204717134,0.38553789939950855,0.352968272152981
19,1713921198,1713924798,3600,0.45492313465096634,3.1408070621175965,0.1,0.1
20,1713924798,1713928398,3600,0.33105812795456013,3.022692699728625,0.1,0.1
21,1713928398,1713931111,2713,2.1741612754638084,4.549982631574075,0.7756951791548458,0.8745188794901047
22,1713931998,1713932254,256,0.6596802348360382,3.6811801764005994,0.8065246009211013,0.12067825509083224
23,1713935598,1713939198,3600,0.28594381766011084,3.01724025278786,0.1,0.1
24,1713939198,1713942010,2812,1.5896665615981687,4.518858044892394,0.7767223899189885,0.7296659248796408
25,1713942798,1713943473,675,1.3778673264021941,4.185847395122871,0.2133521411516326,0.6044929116583004
26,1713946398,1713948741,2343,2.1731582449716624,4.663121658209638,0.10842360029405869,0.2262114444863974
27,1713949998,1713953598,3600,0.1325803290080998,3.1604436070810635,0.1,0.1
28,1713953598,1713955386,1788,1.0138208863566456,3.93769688621993,0.4240844197575223,0.9348179348068381
29,1713957198,1713960798,3600,0.1957227730554091,3.0533062015739616,0.1,0.1
30,1713960798,1713962037,1239,1.0887368331549392,4.022186075485099,0.663748515223178,0.7341949804056197
31,1713964398,1713967998,3600,0.2158630116535013,3.126739891377318,0.1,0.1
32,1713967998,1713968797,799,1.1370521778529765,4.137828319581347,0.42182717533433256,0.9648801904158771
33,1713971598,1713974300,2702,2.152573610157619,4.4302537178656705,0.1345888668489696,0.8226767337349086
34,1713975198,1713975347,149,0.9776026380561175,3.3295547192154595,0.5811564493573125,0.43730064485504927
35,1713978798,1713978960,162,0.6456615984678236,3.6311466072188243,0.9727983055381922,0.3669014272727408
36,1713982398,1713985998,3600,0.18990492867086892,3.0730398230447307,0.1,0.1
37,1713985998,1713989598,3600,0.24278122414915188,3.0087993121450647,0.1,0.1
38,1713989598,1713992334,2736,2.444792082738401,4.665720463739684,0.44028126354853725,0.3331772326171122
39,1713993198,1713996798,3600,0.24030077710899211,3.1587489891709986,0.1,0.1
40,1713996798,1713998749,1951,2.050872714650964,4.4151134078444425,0.5320289124882728,0.3475461695379822
41,1714000398,1714001603,1205,1.3448652842556492,3.959616260928106,0.2726178684651538,0.64527254872418
42,1714003998,1714007598,3600,0.21099971208683505,3.0464390433799458,0.1,0.1
43,1714007598,1714008698,1100,1.3382329559065869,4.078751888784449,0.9789686651088357,0.8016692647241622
44,1714011198,1714012184,986,1.4093475448414536,3.9633574695969886,0.80648632835409,0.8242274849671906
45,1714014798,1714018398,3600,0.16925488600778327,3.140179464967822,0.1,0.1
46,1714018398,1714021998,3600,0.30564433176809924,3.0887349525370547,0.1,0.1
47,1714021998,1714025598,3600,0.37593653471039523,3.1623879116956797,0.1,0.1
48,1714025598,1714029198,3600,0.15099272896761132,3.194422738638932,0.1,0.1
49,1714029198,1714032798,3600,0.22421939678608724,3.133069723200738,0.1,0.1
50,1714032798,1714034007,1209,1.1206411955750188,3.84772713798593,0.9560456801060156,0.1210053611344109
51,1714036398,1714039998,3600,0.24373192184568782,3.0072638773262867,0.1,0.1
52,1714039998,1714043598,3600,0.2392954055608626,3.1582807988051256,0.1,0.1
53,1714043598,1714046083,2485,1.7497590443844784,4.4160947626445495,0.15623753448874778,0.2974668926983924
54,1714047198,1714050798,3600,0.4798953110851034,3.1720076807737736,0.1,0.1
55,1714050798,1714054398,3600,0.3323898330462396,3.03780079377025,0.1,0.1
56,1714054398,1714054582,184,0.9849864736870604,3.3815561708997612,0.7692749273896355,0.9094609226042596
57,1714057998,1714061598,3600,0.3981814878549427,3.0809344464642936,0.1,0.1
58,1714061598,1714063710,2112,1.9408973616509395,4.391229300880222,0.7633996180031556,0.1518280444057649
59,1714065198,1714068798,3600,0.2134271261316837,3.149036190871328,0.1,0.1
60,1714068798,1714070812,2014,1.8110870382075612,4.324169356295438,0.736065916551129,0.8072604623258733
61,1714072398,1714075998,3600,0.4581470027729223,3.1702418661587104,0.1,0.1
62,1714075998,1714076273,275,0.9895276319560538,3.6731728455212243,0.5592711742602438,0.25295190297171594
63,1714079598,1714083198,3600,0.41400713936791955,3.0161080339767685,0.1,0.1
64,1714083198,1714086798,3600,0.171356968728965,3.1843354396655417,0.1,0.1
65,1714086798,1714088172,1374,1.2677987514774545,4.020724115321837,0.1198481651997688,0.7759385548892769
66,1714090398,1714091191,793,1.085716495405689,3.945719344358728,0.839785913781302,0.3809912724917779
67,1714093998,1714097598,3600,0.4811436864514478,3.064510606052019,0.1,0.1
68,1714097598,1714097997,399,0.5368991827766434,3.617072797949396,0.5793963219749119,0.4915560669021797
69,1714101198,1714101829,631,1.1982400822983859,4.157120358015805,0.16680812706151915,0.8403021323630429
70,1714104798,1714108083,3285,2.2644874252637166,4.657271311112914,0.9227974502051739,0.6134644740468271
71,1714108398,1714111506,3108,1.909426997426421,4.403122152389219,0.5093778664837422,0.23866727994921777
72,1714111998,1714115598,3600,0.22114820619070819,3.0558733522326524,0.1,0.1
73,1714115598,1714119198,3600,0.3773683780728331,3.022730431240144,0.1,0.1
74,1714119198,1714119259,61,0.5604413235291257,3.6159897331910424,0.15001908403643358,0.3655271174154139
75,1714122798,1714124178,1380,1.0331354037332734,4.127569533158617,0.22512563216570178,0.6551506879396224
76,1714126398,1714129998,3600,0.3432520516954359,3.1727545475852,0.1,0.1
77,1714129998,1714130401,403,0.6857124290472069,3.3548442775111473,0.9012028856073856,0.771306147511564
78,1714133598,1714137198,3600,0.4731180965641245,3.02799103599766,0.1,0.1
79,1714137198,1714137586,388,0.9786678779156655,3.3451569069588096,0.3752585313834158,0.3197436315680756
80,1714140798,1714143787,2989,1.9212010402247444,4.367230977095479,0.15362784655243636,0.26275917351491096
81,1714144398,1714146051,1653,1.3579924304774598,3.8863613622953426,0.7192306745258984,0.9680988350805348
82,1714147998,1714151598,3600,0.12084714664075175,3.138818364206064,0.1,0.1
83,1714151598,1714153917,2319,1.827625182014785,4.570645996967829,0.25113698675448237,0.24641633281901504
84,1714155198,1714158798,3600,0.1672136797262957,3.055763787745306,0.1,0.1
85,1714158798,1714160938,2140,1.7038524312957897,4.652385507885628,0.2794309739540234,0.6556809692836192
86,1714162398,1714165188,2790,1.752232940810613,4.317278334993337,0.38167865696414927,0.7557982103953884
87,1714165998,1714169598,3600,0.17305070731193611,3.0215549052715343,0.1,0.1
88,1714169598,1714173198,3600,0.4431779519795126,3.0551728437679215,0.1,0.1
89,1714173198,1714176798,3600,0.23914598972717763,3.054625022462869,0.1,0.1
90,1714176798,1714177170,372,0.7270896710054062,3.523782532833292,0.13628673159112759,0.2610349159130622
91,1714180398,1714182436,2038,2.3934711757905895,4.478848629811622,0.769492110145552,0.3336898108155052
92,1714183998,1714185813,1815,2.089837246582184,4.6899943288034756,0.7654523375459484,0.36847029955443744
93,1714187598,1714191198,3600,0.3264469033968691,3.119670606816927,0.1,0.1
94,1714191198,1714193581,2383,1.673983798603452,4.645697573676091,0.10249974207485016,0.6632073193142574
95,1714194798,1714198398,3600,0.4424715515119275,3.175717168005558,0.1,0.1
96,1714198398,1714201429,3031,1.9897329571544735,4.655813173321808,0.5002055809199303,0.38708464934480336
97,1714201998,1714204498,2500,2.0953091174549474,4.536093528528869,0.4702414103752919,0.3756735851719666
98,1714205598,1714205772,174,0.7943692552065258,3.3126638309199294,0.5424713134911886,0.931198857317328
99,1714209198,1714212798,3600,0.3976494760406474,3.105293317474727,0.1,0.1
100,1714212798,1714216398,3600,0.36312420737181295,3.029390345901846,0.1,0.1
101,1714216398,1714216610,212,0.6011547452076548,3.3559661336333027,0.3406846398476379,0.44646157302145495
102,1714219998,1714222417,2419,2.037592886788337,4.616291596232556,0.6373954268253575,0.6393871261158106
103,1714223598,1714224055,457,0.8111682257935993,3.4842741745237755,0.149839872303517,0.3033757995606808
104,1714227198,1714230798,3600,0.13444067887122113,3.1277049765282787,0.1,0.1
105,1714230798,1714234398,3600,0.1364344264490669,3.0488327789676233,0.1,0.1
106,1714234398,1714234558,160,0.8569087137198208,3.619452994265255,0.18547918259275548,0.8249868629810796
107,1714237998,1714241598,3600,0.26518463544311077,3.108765088384079,0.1,0.1
108,1714241598,1714245198,3600,0.3527496204230668,3.130077360175603,0.1,0.1
109,1714245198,1714248638,3440,2.3596045577132854,4.507160856080541,0.23535862824932635,0.7964289316866439
110,1714248798,1714249372,574,0.7722887431232336,3.6335055413652557,0.33954677244418463,0.35706845976457424
111,1714252398,1714255998,3600,0.15079432237357368,3.078003170835015,0.1,0.1
112,1714255998,1714259598,3600,0.3890353361352695,3.1565682577350516,0.1,0.1
113,1714259598,1714260327,729,1.123232768268887,3.8754825987998944,0.7195541240835124,0.8445448912327759
114,1714263198,1714266798,3600,0.2985189438871255,3.151665449179246,0.1,0.1
115,1714266798,1714270398,3600,0.22713661515446928,3.187112568452368,0.1,0.1
116,1714270398,1714273998,3600,0.22620683825879173,3.0724027323077654,0.1,0.1
117,1714273998,1714277598,3600,0.37353772903571825,3.0210482968721113,0.1,0.1
118,1714277598,1714281198,3600,0.12351375522656297,3.0316975729497253,0.1,0.1
119,1714281198,1714284798,3600,0.38587720730515496,3.167603493810738,0.1,0.1
120,1714284798,1714288398,3600,0.3083038333600319,3.1160077101465182,0.1,0.1
121,1714288398,1714291998,3600,0.3196425079185499,3.0966333658998804,0.1,0.1
122,1714291998,1714295598,3600,0.4223680837052789,3.0577015051078282,0.1,0.1
123,1714295598,1714299198,3600,0.4187951211539036,3.00139540406241,0.1,0.1
124,1714299198,1714302744,3546,1.796750738528412,4.371755275324977,0.1366788449631875,0.24854673194635196
125,1714302798,1714305892,3094,2.3105504153855905,4.4392928729382,0.21100957839061713,0.6384169457924656
126,1714306398,1714307647,1249,1.4278842185064042,3.965329233561789,0.6405645692043346,0.5570915549181884
127,1714309998,1714313598,3600,0.13082975230137703,3.07521020943519,0.1,0.1
128,1714313598,1714315846,2248,1.7415595322426602,4.408441631460267,0.6351751570397253,0.386663702514469
129,1714317198,1714317881,683,1.1184006059355147,4.194702102614434,0.6909720902997907,0.40841600770964337
130,1714320798,1714324398,3600,0.3093645034427464,3.055908408552582,0.1,0.1
131,1714324398,1714326976,2578,1.909456912491098,4.590112558901421,0.36356772498219625,0.6584384146696689
132,1714327998,1714330014,2016,1.9932358923562759,4.407244742352398,0.49698885671247606,0.18737809158412957
133,1714331598,1714332541,943,1.039323882213646,3.80908048119195,0.8330174810437101,0.5785550022110328
134,1714335198,1714337046,1848,1.606855606040718,4.43010460528751,0.40204846261154514,0.13016213435393945
135,1714338798,1714339416,618,1.274811069643521,4.092822761029408,0.6688289315402298,0.6173008013246299
136,1714342398,1714345998,3600,0.47448290743087684,3.11742071357136,0.1,0.1
137,1714345998,1714349598,3600,0.4111067614780133,3.041512088569843,0.1,0.1
138,1714349598,1714353198,3600,0.30293273705423013,3.0646744434290607,0.1,0.1
139,1714353198,1714353815,617,1.1896952773946121,4.15860302558522,0.682516648684772,0.18214565240227548
140,1714356798,1714360398,3600,0.1907379685691084,3.1322593154443323,0.1,0.1
141,1714360398,1714363998,3600,0.3530672151605193,3.1692647606142645,0.1,0.1
142,1714363998,1714367598,3600,0.20672911125532978,3.0474889533385174,0.1,0.1
143,1714367598,1714371198,3600,0.1665670014275435,3.184049739572521,0.1,0.1
144,1714371198,1714374798,3600,0.490227936220646,3.1154881866376245,0.1,0.1
145,1714374798,1714376000,1202,1.2709140215014403,3.997785268884877,0.9435225121697202,0.8253981425009617
146,1714378398,1714378570,172,0.732852708827207,3.350833856478213,0.4577283227809562,0.37679479411331307
147,1714381998,1714384126,2128,2.4398990896012673,4.5683348155265495,0.719727242046246,0.8597589581191367
148,1714385598,1714387620,2022,1.61041067687963,4.5538488724784045,0.15204070492016056,0.7887985579932058
149,1714389198,1714391038,1840,2.438409676091616,4.568759830692242,0.9757042632287094,0.3578881242067573
150,1714392798,1714396398,3600,0.2819405841337058,3.0748126120225185,0.1,0.1
151,1714396398,1714399998,3600,0.3129567343377543,3.0976375418475053,0.1,0.1
152,1714399998,1714400559,561,0.7870196790525665,3.565497711386584,0.7108310279906991,0.8401398390026846
153,1714403598,1714407184,3586,2.2105849763310936,4.386129584233089,0.9705556632047113,0.7478054642844992
154,1714407198,1714410798,3600,0.29115503868598036,3.0985393278356925,0.1,0.1
155,1714410798,1714414398,3600,0.4403474163233535,3.1597363945935193,0.1,0.1
156,1714414398,1714417998,3600,0.27539619775306684,3.0340922841902254,0.1,0.1
157,1714417998,1714421598,3600,0.27188399180416467,3.182122211509279,0.1,0.1
158,1714421598,1714424251,2653,1.8250741373121837,4.622040432718022,0.4907898206976731,0.1560340995745304
159,1714425198,1714428094,2896,1.6202125575816049,4.39420689401601,0.3952704923212289,0.18640618269386766
160,1714428798,1714430857,2059,2.0006141299356743,4.621257596355026,0.3704954072602935,0.6866065228559821
161,1714432398,1714433676,1278,1.3594301593261657,4.18243448815143,0.43357671472520987,0.47303799559507065
162,1714435998,1714436984,986,1.4335457547634902,4.0807782562356225,0.4135360456303321,0.4758141100903579
163,1714439598,1714442991,3393,2.384408629312269,4.3835048884671695,0.1507499309665584,0.2613991732400247
164,1714443198,1714444217,1019,1.2081265809996318,3.939532447895777,0.7067065807443572,0.6819529268003267
165,1714446798,1714450398,3600,0.14542613874290025,3.0480398332425076,0.1,0.1
166,1714450398,1714452994,2596,2.0913019525083403,4.307752760780632,0.7921693557559107,0.3415967641407335
167,1714453998,1714454387,389,0.8555444540115571,3.347740656298212,0.1539132050511089,0.8526140948546364
168,1714457598,1714458892,1294,1.3888715648847159,4.0015542339992365,0.5614385691544157,0.9840673130843824
169,1714461198,1714464430,3232,1.5420584369686359,4.641051554086617,0.8633961817496998,0.5354937898124583
170,1714464798,1714464859,61,0.7558867131388924,3.593317008176721,0.533088804727189,0.22783223404763742
171,1714468398,1714471998,3600,0.4843383405119598,3.0722331807631664,0.1,0.1
172,1714471998,1714473798,1800,1.676829133269922,4.684789791224944,0.7272713459993917,0.5860013878450931
173,1714475598,1714479198,3600,0.20361811901708549,3.14586631826014,0.1,0.1
174,1714479198,1714480678,1480,1.3153747285996102,4.057398974059359,0.5982794593236498,0.9303473092172814
175,1714482798,1714486398,3600,0.21429407088260033,3.172448354303608,0.1,0.1
176,1714486398,1714489998,3600,0.48378770156777107,3.1425548347606,0.1,0.1
177,1714489998,1714492939,2941,1.7273033859276201,4.460464735218269,0.21576998803978342,0.44799164838910954
178,1714493598,1714494755,1157,1.0838040223400378,4.184074874656186,0.6665445755357199,0.8545982464611835
179,1714497198,1714500798,3600,0.36808001062757356,3.151421640372194,0.1,0.1
180,1714500798,1714504398,3600,0.2810179213442907,3.122382768676526,0.1,0.1
181,1714504398,1714507998,3600,0.3498685919901622,3.0887043614168963,0.1,0.1
182,1714507998,1714511598,3600,0.2666848616510108,3.0466592086286477,0.1,0.1
183,1714511598,1714515198,3600,0.22768543465487612,3.031652845518193,0.1,0.1
184,1714515198,1714518798,3600,0.17592520522368013,3.002187378178219,0.1,0.1
185,1714518798,1714520741,1943,2.410435425415464,4.555591606097712,0.30881761510161454,0.957113791151137
186,1714522398,1714525998,3600,0.41296053371514185,3.193377534351541,0.1,0.1
187,1714525998,1714528128,2130,1.7078824410279152,4.547905244974175,0.14653158858195056,0.18572070872944574
188,1714529598,1714533198,3600,0.1245261439144751,3.0758750016042837,0.1,0.1
189,1714533198,1714536798,3600,0.44137457369957533,3.1469149351175885,0.1,0.1
190,1714536798,1714540398,3600,0.22984253650716854,3.1051771329922775,0.1,0.1
191,1714540398,1714541792,1394,1.0846227147417777,3.9929919380977696,0.6244695086632728,0.7604371812181678
192,1714543998,1714547598,3600,0.16520308650794902,3.0470315450029175,0.1,0.1
193,1714547598,1714551198,3600,0.41707258631491095,3.0694822866280655,0.1,0.1
194,1714551198,1714554798,3600,0.45833388934398056,3.0260994090812523,0.1,0.1
195,1714554798,1714558398,3600,0.17450171569799533,3.1151196236841874,0.1,0.1
196,1714558398,1714560016,1618,1.4381162813291561,3.8958101974980055,0.6015682037538406,0.6680498009161566
197,1714561998,1714562595,597,0.8011566306518434,3.367632779050474,0.9621020700259856,0.8587540407285934
198,1714565598,1714568197,2599,2.457836439050904,4.510454839362203,0.22726181437558596,0.6638885962122688
199,1714569198,1714572798,3600,0.17585516620018696,3.1891830571297666,0.1,0.1
200,1714572798,1714573704,906,1.4874244449343061,4.194674724191769,0.8083298915637859,0.11053906739633532
201,1714576398,1714579998,3600,0.2665250995960111,3.147339382979456,0.1,0.1
202,1714579998,1714580806,808,1.1129758771205636,4.191170437906135,0.8275775178149758,0.4250635557775706
203,1714583598,1714587110,3512,2.49926471716091,4.55773006521417,0.8557476343617753,0.7202506530083687
204,1714587198,1714587269,71,0.7131886721695081,3.616004163201111,0.5293515790929423,0.44048051009860845
205,1714590798,1714594398,3600,0.173873081183937,3.1721344689131654,0.1,0.1
206,1714594398,1714597976,3578,1.762266779735619,4.5364673119161,0.43603716912120183,0.7807505204659978
207,1714597998,1714598450,452,0.9635664415440436,3.6475677006129437,0.8269438826970575,0.3349322812732828
208,1714601598,1714601858,260,0.6164506092819229,3.389024817627135,0.903645947395693,0.9642173699704919
209,1714605198,1714607462,2264,2.0319026886292093,4.412962279014502,0.8700992833338977,0.7238242171991255
210,1714608798,1714612398,3600,0.11194952722620606,3.066519346576425,0.1,0.1
211,1714612398,1714614555,2157,1.7331664077764257,4.311876323987653,0.5453740474021577,0.5645512898294889
212,1714615998,1714619598,3600,0.4007116993996461,3.0060725611856944,0.1,0.1
213,1714619598,1714623198,3600,0.31381960755743493,3.0483813441713976,0.1,0.1
214,1714623198,1714626798,3600,0.18164009073925005,3.11342182699903,0.1,0.1
215,1714626798,1714629953,3155,1.9643327657198864,4.656929396668118,0.24763048991495246,0.5083046020867668
216,1714630398,1714632434,2036,1.6548118776689018,4.617929902799004,0.7164859458759939,0.5393400601345257
217,1714633998,1714637598,3600,0.2365305091122553,3.1907320517586713,0.1,0.1
218,1714637598,1714638907,1309,1.0220983975412061,3.9366414279717303,0.1777149973596608,0.15141722189330706
219,1714641198,1714644798,3600,0.20533202748361204,3.0607310361437765,0.1,0.1
220,1714644798,1714647563,2765,1.5526747586582235,4.6492210642976595,0.1778627659039151,0.5354538463565912
221,1714648398,1714651335,2937,1.5552452029782895,4.66497257175732,0.40240231509766033,0.9760356697382692
222,1714651998,1714655598,3600,0.35049591855914,3.078191157699672,0.1,0.1
223,1714655598,1714658404,2806,1.7601573439539124,4.560090063922156,0.23833698271806142,0.3449338688310933
224,1714659198,1714662798,3600,0.11963813117399202,3.0703368167672553,0.1,0.1
225,1714662798,1714665206,2408,1.6340525220571724,4.335835177782365,0.4456882357572103,0.5818629705377787
226,1714666398,1714669998,3600,0.41594526755001304,3.0709697696885714,0.1,0.1
227,1714669998,1714673598,3600,0.37170421443526824,3.0511597228741874,0.1,0.1
228,1714673598,1714677198,3600,0.10194434506269574,3.023062885200497,0.1,0.1
229,1714677198,1714680798,3600,0.12452103353285603,3.001974417338235,0.1,0.1
230,1714680798,1714684398,3600,0.13769859026783685,3.0511158532317495,0.1,0.1
231,1714684398,1714685811,1413,1.2239862679118887,3.982116378276799,0.4783683895946629,0.5448370555237225
232,1714687998,1714691598,3600,0.41021348373402733,3.0383743168287194,0.1,0.1
233,1714691598,1714693718,2120,2.1366015621246035,4.504950157310839,0.44121734466381424,0.9925543464678122
234,1714695198,1714698798,3600,0.2362492719573524,3.0772287472218394,0.1,0.1
235,1714698798,1714702398,3600,0.14147820292818364,3.136170797512356,0.1,0.1
236,1714702398,1714705998,3600,0.11850181424465536,3.109615012191807,0.1,0.1
237,1714705998,1714707559,1561,1.354325732273905,3.872720326067333,0.8810368412577939,0.5066340191974972
238,1714709598,1714713198,3600,0.3372294742272639,3.077913723636797,0.1,0.1
239,1714713198,1714716798,3600,0.4090571560168105,3.1487094881883424,0.1,0.1
240,1714716798,1714719153,2355,1.5166635103914041,4.679062437276739,0.16944917306128665,0.21789013235081245
241,1714720398,1714722885,2487,2.3043232779758696,4.683943395354433,0.6268449299955074,0.7007864216892195
242,1714723998,1714725976,1978,1.579400357640478,4.68471652822613,0.18655489121185193,0.2733657803486803
243,1714727598,1714730111,2513,1.6371046659635415,4.30675768716018,0.8341651720384208,0.9692376031591551
244,1714731198,1714734798,3600,0.4805870073246882,3.061445162515765,0.1,0.1
245,1714734798,1714738398,3600,0.18640671670228046,3.0478698153936628,0.1,0.1
246,1714738398,1714738610,212,0.568119125622091,3.3422700988335055,0.7011624165404838,0.7024018266048848
247,1714741998,1714745598,3600,0.12378624830601966,3.117767092848855,0.1,0.1
248,1714745598,1714749198,3600,0.25521085087867945,3.171477442088433,0.1,0.1
249,1714749198,1714752798,3600,0.24313824634306822,3.1035304687499594,0.1,0.1
250,1714752798,1714756398,3600,0.29164321861027576,3.0586650168019704,0.1,0.1
251,1714756398,1714757342,944,1.097401882856879,3.8764172242442503,0.6569532953101197,0.9549608398698968
252,1714759998,1714761864,1866,2.1326236986818787,4.452397734894622,0.5428382434554941,0.2675747155625263
253,1714763598,1714763700,102,0.5853837380654277,3.401977890963373,0.6712474144733506,0.7536114064963787
254,1714767198,1714770798,3600,0.29813136968412124,3.1929010533496895,0.1,0.1
255,1714770798,1714774398,3600,0.29969081847806295,3.169577055021075,0.1,0.1
256,1714774398,1714774695,297,0.6963001312203828,3.65733702898466,0.8273999403721064,0.604315230944059
257,1714777998,1714781502,3504,1.7488201469738687,4.512260178968078,0.2436302353121007,0.10085731878843457
258,1714781598,1714784424,2826,1.699311956319809,4.615765127303913,0.3803116168681522,0.228753022243624
259,1714785198,1714785864,666,1.186453220094943,4.181373294126961,0.48490320840908685,0.9564777853706242
260,1714788798,1714791767,2969,1.8846084791834437,4.394336536853015,0.7728166769713262,0.3403122376150325
261,1714792398,1714795998,3600,0.39559478840186535,3.155648000167207,0.1,0.1
262,1714795998,1714799598,3600,0.4719812502670687,3.0814852913063264,0.1,0.1
263,1714799598,1714803125,3527,2.062972129947378,4.5269802826495456,0.480814926712648,0.22892243560038414
264,1714803198,1714806798,3600,0.29518736231382925,3.1686687063772134,0.1,0.1
265,1714806798,1714810270,3472,2.435501384741429,4.5967561917345305,0.20603649290488601,0.7127074560497298
266,1714810398,1714813998,3600,0.2522518770656196,3.0247487274833422,0.1,0.1
267,1714813998,1714815072,1074,1.3214132897170336,4.175113455144483,0.2694339643590431,0.7092286278784146
268,1714817598,1714820028,2430,2.076715401815568,4.646378253254167,0.3424600824341477,0.9052099854385958
269,1714821198,1714824608,3410,2.1590825568520082,4.320101545075129,0.3609306738078115,0.7772028636531197
270,1714824798,1714828398,3600,0.4940362528039949,3.1302488500706773,0.1,0.1
271,1714828398,1714830070,1672,1.0934288330138342,3.809160736638234,0.6790185459100616,0.4237528105946079
272,1714831998,1714835483,3485,2.217224373259282,4.374331947846393,0.7151402428251866,0.1758672915245862
273,1714835598,1714837865,2267,2.425615351308469,4.6897928137123435,0.5543768225635476,0.623073510876068
274,1714839198,1714842798,3600,0.23378634154465305,3.1344284385073857,0.1,0.1
275,1714842798,1714846398,3600,0.3920653363127613,3.0056499168803312,0.1,0.1
276,1714846398,1714849998,3600,0.40803707135138534,3.1430393563747665,0.1,0.1
277,1714849998,1714851594,1596,1.4046052892783405,4.014876099104463,0.29836930636728853,0.8382292129546745
278,1714853598,1714857198,3600,0.44843173713853124,3.0463816937452384,0.1,0.1
279,1714857198,1714860798,3600,0.4748129418091117,3.017229618535917,0.1,0.1
280,1714860798,1714864398,3600,0.3371683344947093,3.139843323280665,0.1,0.1
281,1714864398,1714867218,2820,2.4558409168649264,4.383579159855305,0.4437535533875758,0.16501340803050862
282,1714867998,1714871598,3600,0.3739425416707721,3.042746347796498,0.1,0.1
283,1714871598,1714874710,3112,2.004638183006038,4.568862923956248,0.45432801616774454,0.888438945619787
284,1714875198,1714878798,3600,0.3230167126468069,3.174245071523581,0.1,0.1
285,1714878798,1714882398,3600,0.35634265622592554,3.1639981760856974,0.1,0.1
286,1714882398,1714885998,3600,0.25585588551063365,3.06801216023472,0.1,0.1
287,1714885998,1714889598,3600,0.1741046098199412,3.1967363327170717,0.1,0.1
288,1714889598,1714890706,1108,1.2343635402674074,3.9624117008102187,0.3089224262796766,0.735546156851768
289,1714893198,1714895023,1825,2.153744183353034,4.455519144055791,0.9847424862757221,0.9106215389610113
290,1714896798,1714899237,2439,2.220457696452386,4.65134740599003,0.707088401538089,0.7351549160732901
291,1714900398,1714903998,3600,0.3423919126933348,3.0175430782036217,0.1,0.1
292,1714903998,1714907598,3600,0.2595573229111138,3.083800881351973,0.1,0.1
293,1714907598,1714908018,420,0.9708797079780989,3.683260244028884,0.5094490815811167,0.8582708027126376
294,1714911198,1714913207,2009,1.7621632131750564,4.537517209421817,0.6375771511993585,0.579985677785958
295,1714914798,1714918398,3600,0.14754154150751406,3.149785306090457,0.1,0.1
296,1714918398,1714921998,3600,0.4366761141017803,3.018891916852444,0.1,0.1
297,1714921998,1714925598,3600,0.34584588217659806,3.016001687166065,0.1,0.1
298,1714925598,1714929198,3600,0.2689276498608469,3.171027321608479,0.1,0.1
299,1714929198,1714932798,3600,0.1666327122604231,3.19232199614168,0.1,0.1
300,1714932798,1714936398,3600,0.44598662246611676,3.181123857984971,0.1,0.1
301,1714936398,1714939998,3600,0.12369557038354602,3.0035718657840476,0.1,0.1
302,1714939998,1714943598,3600,0.24075465740192323,3.014879029864195,0.1,0.1
303,1714943598,1714944623,1025,1.14307559253411,3.8926677069074223,0.7363262426136394,0.13174040737060316
304,1714947198,1714948286,1088,1.0235729452233198,3.838585225741012,0.15224996891236572,0.16018115100818614
305,1714950798,1714950992,194,0.619865355392516,3.5915176718613355,0.654214552981901,0.2770807530594595
306,1714954398,1714957998,3600,0.3914594693305462,3.0136148807060827,0.1,0.1
307,1714957998,1714959428,1430,1.2800080350821803,4.054935222549547,0.9139359027489585,0.9824798505261999
308,1714961598,1714962474,876,1.2883367078296029,3.84347449470346,0.9575664232834278,0.8838991182900993
309,1714965198,1714965290,92,0.8552368359743643,3.3573382328871095,0.6670966086370543,0.6274007289269823
310,1714968798,1714970948,2150,1.9619449414881842,4.322905018329981,0.9007326288010822,0.12421050974641851
311,1714972398,1714974953,2555,1.94191583909291,4.4333087751340505,0.6522929825124671,0.8187124464318357
312,1714975998,1714979598,3600,0.44622302502276623,3.15926291098183,0.1,0.1
313,1714979598,1714980526,928,1.4093908935461092,4.090891234513676,0.15373615440294616,0.6565490803208252
314,1714983198,1714983618,420,0.5982056244455924,3.5635184061336886,0.3136383227583004,0.7031602770193263
315,1714986798,1714990398,3600,0.352970516314566,3.1985496586116997,0.1,0.1
316,1714990398,1714991615,1217,1.086854034534038,3.877224064287371,0.9339993899667851,0.9495052344676657
317,1714993998,1714997598,3600,0.2914922057040695,3.09766775777903,0.1,0.1
318,1714997598,1715000216,2618,1.8577016706130254,4.589604298824074,0.5908850188011453,0.4604702209573517
319,1715001198,1715003288,2090,2.0866636779809387,4.421890460374881,0.3376803786788183,0.6165380658287912
320,1715004798,1715008398,3600,0.3934804320298486,3.0335117038337183,0.1,0.1
321,1715008398,1715011998,3600,0.1695633957864074,3.122443931344317,0.1,0.1
322,1715011998,1715014386,2388,2.139506270421926,4.6045466050548445,0.6187157066075666,0.7707496094971211
323,1715015598,1715016848,1250,1.480000231005913,4.086771883188255,0.7979860472486837,0.5563963835727196
324,1715019198,1715019820,622,1.1052208322305965,3.822382549190617,0.10247625025788876,0.7643370571531195
325,1715022798,1715026398,3600,0.10855811192012883,3.1423604660020406,0.1,0.1
326,1715026398,1715029998,3600,0.28437304657145945,3.1847925990782002,0.1,0.1
327,1715029998,1715033598,3600,0.20981035378750748,3.163168860689513,0.1,0.1
328,1715033598,1715036620,3022,2.484971079750596,4.653310614095453,0.5947775309330507,0.8570271335006532
329,1715037198,1715040798,3600,0.3245132758959109,3.1247248123726363,0.1,0.1
330,1715040798,1715042299,1501,1.0488247633935552,3.97644274632249,0.44609142004518054,0.8146230748217484
331,1715044398,1715047998,3600,0.42567035305750534,3.189962884146499,0.1,0.1
332,1715047998,1715051598,3600,0.27150625841266357,3.1454444706262943,0.1,0.1
333,1715051598,1715054655,3057,2.1755931511293394,4.322205223584366,0.672210129322921,0.6050420368774925
334,1715055198,1715055374,176,0.6164160951784228,3.6929395532386775,0.4049107216917781,0.8145885290282614
335,1715058798,1715062398,3600,0.3882302114906566,3.15995322882098,0.1,0.1
336,1715062398,1715065998,3600,0.47991156220851205,3.0577505099975193,0.1,0.1
337,1715065998,1715068080,2082,2.4903264846940623,4.45680288524887,0.2967933083276183,0.8485292537679963
338,1715069598,1715069756,158,0.5162033056893331,3.631619099654423,0.13746134072259805,0.5480952705923646
339,1715073198,1715076079,2881,2.2676758048722987,4.541857606021954,0.7772128778548153,0.4962413160877056
340,1715076798,1715080398,3600,0.31240252282725295,3.009599320059493,0.1,0.1
341,1715080398,1715083075,2677,2.478616899521138,4.340484199667994,0.6300211431385591,0.2004016924685068
342,1715083998,1715087598,3600,0.12452815575454027,3.172013802474502,0.1,0.1
343,1715087598,1715091198,3600,0.4135322876202491,3.169089736080675,0.1,0.1
344,1715091198,1715093471,2273,2.3657996730200814,4.5128505340506155,0.9358519167604991,0.7769535060369158
345,1715094798,1715098398,3600,0.4736210637436906,3.037985820974078,0.1,0.1
346,1715098398,1715101998,3600,0.46434875770966966,3.0377245810691074,0.1,0.1
347,1715101998,1715104885,2887,2.2418585352459854,4.306849147180373,0.35236647227984774,0.766426727933246
348,1715105598,1715109198,3600,0.37967073074124813,3.1092801637124965,0.1,0.1
349,1715109198,1715112378,3180,2.1785052677419596,4.47188493103975,0.29709830289772876,0.41797564530857645
350,1715112798,1715116398,3600,0.3467435848716126,3.1445129715011086,0.1,0.1
351,1715116398,1715117972,1574,1.47261629418916,4.111323816929277,0.7074993696916062,0.1357619699717457
352,1715119998,1715123366,3368,2.2672924585229373,4.5914659515120215,0.4880189293632968,0.15407875499028537
353,1715123598,1715124976,1378,1.258249127974833,4.108762439285745,0.28136665457109006,0.8806806336552482
354,1715127198,1715128461,1263,1.071095029460012,3.829696088751827,0.7899971493854507,0.30192478105415016
355,1715130798,1715134398,3600,0.3870790706248105,3.086753440272581,0.1,0.1
356,1715134398,1715135366,968,1.0793471883216617,3.9448433445820337,0.9596069440596661,0.14447642083179893
357,1715137998,1715141598,3600,0.31399374286363313,3.0606741816319447,0.1,0.1
358,1715141598,1715145198,3600,0.42508591456602496,3.101020910769057,0.1,0.1
359,1715145198,1715148798,3600,0.311658945645771,3.033119714633729,0.1,0.1
360,1715148798,1715151559,2761,1.6101420767837484,4.437891417037655,0.5491645903821366,0.7090602531393249
361,1715152398,1715155898,3500,1.5278811389754456,4.418767752046818,0.8933916749410895,0.8800326820308852
362,1715155998,1715159598,3600,0.1022275125781627,3.1557054442218804,0.1,0.1
363,1715159598,1715159858,260,0.7611541265479966,3.61988383693,0.39610315331455825,0.3688593465106823
364,1715163198,1715166798,3600,0.3486185583002196,3.1380264931545487,0.1,0.1
365,1715166798,1715169210,2412,2.210545158133875,4.57992593207746,0.8509396246675272,0.4073518613431619
366,1715170398,1715172539,2141,1.9159235669574066,4.576437011322382,0.8862849705650667,0.6352950570820084
367,1715173998,1715176731,2733,1.9765016016535248,4.69651508158342,0.31876994418735594,0.2624192749173117
368,1715177598,1715177752,154,0.7725389618484676,3.6449764502240107,0.3308358666106409,0.6665322603442341
369,1715181198,1715184798,3600,0.2784821693217797,3.1673629701056996,0.1,0.1
370,1715184798,1715186755,1957,2.005150540876927,4.580350887076575,0.23910703949537893,0.7917500576410796
371,1715188398,1715191998,3600,0.19173040072141562,3.1405250717820303,0.1,0.1
372,1715191998,1715194940,2942,2.051351269729869,4.3811607587565415,0.72261090573072,0.45059713519020683
373,1715195598,1715196774,1176,1.1017195736863026,4.194840234759181,0.3230788203175616,0.3531800378252439
374,1715199198,1715201235,2037,2.389221657575545,4.420212782023246,0.5329411529218577,0.2827603530250137
375,1715202798,1715204816,2018,2.4758329944144304,4.509808383615367,0.660898190949852,0.19176656868805853
376,1715206398,1715208879,2481,1.860944398215453,4.478734674389911,0.6789640126145039,0.7126416867620141
377,1715209998,1715211063,1065,1.2206950121952351,3.8653022498319514,0.7731604648909435,0.20216503565852217
378,1715213598,1715217198,3600,0.290410233210492,3.0053674332166715,0.1,0.1
379,1715217198,1715220798,3600,0.41855714829497936,3.1856680728334017,0.1,0.1
380,1715220798,1715224398,3600,0.43799348640027014,3.1292820735483367,0.1,0.1
381,1715224398,1715224738,340,0.7069899829600476,3.306617299081999,0.7269127232418867,0.5366893944657453
382,1715227998,1715229660,1662,1.041021902860992,4.027641405800871,0.6615715014843115,0.5465126611514495
383,1715231598,1715232604,1006,1.1199795256999874,4.0016761841364366,0.616809039256614,0.6794858732700871
384,1715235198,1715236772,1574,1.173595241461494,3.892306794955026,0.962252067112906,0.4744106874176808
385,1715238798,1715241292,2494,2.181227277902366,4.442059651145739,0.36906237575198386,0.6975624074096757
386,1715242398,1715243671,1273,1.052748684393425,4.005718735233222,0.16471031571498235,0.989609182097677
387,1715245998,1715247021,1023,1.0643759360670217,3.8253740980880977,0.5925262837737943,0.2895132456635977
388,1715249598,1715253198,3600,0.122947371942601,3.196706953527318,0.1,0.1
389,1715253198,1715253806,608,1.0054958718840163,3.811127783536171,0.31778427847076995,0.7637100989798006
390,1715256798,1715260398,3600,0.30763901520801334,3.1504283277866127,0.1,0.1
391,1715260398,1715263998,3600,0.1614687355075288,3.1679785749984584,0.1,0.1
392,1715263998,1715264790,792,1.2337491885792078,4.198100381700862,0.1336033292266101,0.9413382032146493
393,1715267598,1715271198,3600,0.4572367637539143,3.1553439339662765,0.1,0.1
394,1715271198,1715271492,294,0.962151706365455,3.3718801963455642,0.17417262364178043,0.4265228020611158
395,1715274798,1715277771,2973,1.5910325663943863,4.620367226381114,0.448714352289487,0.7878719229238248
396,1715278398,1715280069,1671,1.140040089134664,3.833844662761435,0.7958253218148302,0.32310856911831837
397,1715281998,1715285598,3600,0.4961842098189181,3.1587966863026025,0.1,0.1
398,1715285598,1715288695,3097,2.1922272208475713,4.449556240996009,0.9693732948034467,0.5904532119708301
399,1715289198,1715292798,3600,0.458929524890589,3.000287858676855,0.1,0.1
400,1715292798,1715295101,2303,2.1005032962614307,4.402424464050297,0.9003412417050688,0.16330306558509572
401,1715296398,1715296655,257,0.6503240350380863,3.406166221588125,0.8784005230628742,0.8794318791018539
402,1715299998,1715302612,2614,2.088022128947743,4.524550303643561,0.3476022034150913,0.36605521895096815
403,1715303598,1715303707,109,0.7668208475495102,3.614441901646405,0.792134043019131,0.29817594714600976
404,1715307198,1715310798,3600,0.31905167670642964,3.0465972212419774,0.1,0.1
405,1715310798,1715313488,2690,2.46972323621453,4.367528568778131,0.9665104587239396,0.7691433672961442
406,1715314398,1715317998,3600,0.29343737313043583,3.0609250174932296,0.1,0.1
407,1715317998,1715321598,3600,0.4227559573577071,3.0273081044854253,0.1,0.1
408,1715321598,1715323613,2015,2.4465819119091234,4.3510689874366655,0.5501512965031166,0.25859024178421164
409,1715325198,1715328798,3600,0.16490285374428054,3.079447125977594,0.1,0.1
410,1715328798,1715331259,2461,1.5534218259930748,4.373237709140756,0.9817242181499078,0.6320890579081784
411,1715332398,1715335998,3600,0.3880414210743325,3.0403562625308305,0.1,0.1
412,1715335998,1715339598,3600,0.2348966630424644,3.170848518477808,0.1,0.1
413,1715339598,1715343198,3600,0.28094045822418334,3.027091649682741,0.1,0.1
414,1715343198,1715346404,3206,2.1951755950896112,4.382807491481462,0.2319075283176081,0.2350190675297152
415,1715346798,1715348674,1876,2.0121764306795984,4.343279046098118,0.6654170364408315,0.5587793588015861
416,1715350398,1715353998,3600,0.23815680711314427,3.178978402426174,0.1,0.1
417,1715353998,1715355978,1980,1.6292639775681974,4.476551614902807,0.4873324789437251,0.5468646707811629
418,1715357598,1715360901,3303,2.259149859750589,4.5179630028200375,0.19230317691148713,0.13617731059471236
419,1715361198,1715364798,3600,0.4835614868021856,3.047610048276277,0.1,0.1
420,1715364798,1715367637,2839,2.186666548193727,4.483377618933323,0.4998932084434746,0.8020381616960555
421,1715368398,1715370730,2332,1.7002191422057655,4.321230941945942,0.6247975771519149,0.7738711077290353
422,1715371998,1715374900,2902,2.0819143634609767,4.527123840416709,0.18089771579358832,0.9204393590103545
423,1715375598,1715379198,3600,0.10010320621871993,3.1304765608098006,0.1,0.1
424,1715379198,1715382798,3600,0.1919372553092794,3.1822328184940636,0.1,0.1
425,1715382798,1715385955,3157,1.7569103231651777,4.523327685247493,0.6674464514349896,0.3003358958903883
426,1715386398,1715389998,3600,0.12355780850285161,3.0022368967249586,0.1,0.1
427,1715389998,1715393598,3600,0.4241157426850449,3.1169953845124674,0.1,0.1
428,1715393598,1715397198,3600,0.4826842443134276,3.1308064318981117,0.1,0.1
429,1715397198,1715400798,3600,0.3782469587502627,3.1185731838437536,0.1,0.1
430,1715400798,1715404070,3272,1.7067758294613866,4.514870997258683,0.8052753630687711,0.28887951649129484
431,1715404398,1715407998,3600,0.4966309670663307,3.1755213121522985,0.1,0.1
432,1715407998,1715411598,3600,0.4850500116547367,3.0032063764631336,0.1,0.1
433,1715411598,1715411855,257,0.8172071006942342,3.5029742446621537,0.39917534001201016,0.17193284938978615
434,1715415198,1715417688,2490,1.6909253088178366,4.462277958505646,0.6162052325625303,0.8779490069556213
435,1715418798,1715422398,3600,0.2862020394709196,3.196005050820091,0.1,0.1
436,1715422398,1715425998,3600,0.22891539870217714,3.015316211684306,0.1,0.1
437,1715425998,1715429051,3053,2.021801260681748,4.551171181363498,0.8996241068448413,0.2027801244839999
438,1715429598,1715432532,2934,1.798065434993699,4.6311162399948245,0.8381501352427283,0.3826186951796233
439,1715433198,1715433688,490,0.9277941776120721,3.3163862501616954,0.267312974928727,0.8347317186315739
440,1715436798,1715439299,2501,1.9317320860959422,4.58500384608074,0.7758908599021439,0.840319399346042
441,1715440398,1715442281,1883,1.7176734728488605,4.301084081798685,0.5728121540566772,0.8913681396818898
442,1715443998,1715447598,3600,0.2840232757666932,3.014031418500499,0.1,0.1
443,1715447598,1715451198,3600,0.13197718144695958,3.0036349565155156,0.1,0.1
444,1715451198,1715452864,1666,1.3793944927144222,4.059594046454239,0.7552598568341432,0.443427043118938
445,1715454798,1715458398,3600,0.38292091421690866,3.1570513992564164,0.1,0.1
446,1715458398,1715461998,3600,0.4540253344237821,3.160657464279825,0.1,0.1
447,1715461998,1715465598,3600,0.3880956630778897,3.1635485632684106,0.1,0.1
448,1715465598,1715469198,3600,0.29854154040891656,3.0627471232557344,0.1,0.1
449,1715469198,1715471357,2159,2.240798308354769,4.634242836367723,0.2868581735039885,0.8602465995806601
450,1715472798,1715476398,3600,0.25310868524891694,3.1304947371352196,0.1,0.1
451,1715476398,1715479998,3600,0.48702917241508936,3.156099562859806,0.1,0.1
452,1715479998,1715481418,1420,1.3524469300486475,3.9290213038118247,0.9846569369981477,0.35405976143585827
453,1715483598,1715487198,3600,0.27044048003204624,3.0614964462384107,0.1,0.1
454,1715487198,1715488518,1320,1.3800575966451905,3.9365163722808245,0.9395680778173922,0.3166093688304016
455,1715490798,1715494398,3600,0.33016098322372156,3.095678313948561,0.1,0.1
456,1715494398,1715497998,3600,0.4078436837077629,3.0232898850986536,0.1,0.1
457,1715497998,1715499761,1763,1.3945847447842556,4.12912446839259,0.3835584274674957,0.9537697175162339
458,1715501598,1715501666,68,0.8631370234211415,3.5989640831848373,0.6372121894324873,0.7518682308550744
459,1715505198,1715506979,1781,1.4704248140003298,3.8583409868019687,0.6387716018121158,0.15815325731951388
460,1715508798,1715512398,3600,0.13495608218662136,3.1639643445842545,0.1,0.1
461,1715512398,1715515998,3600,0.49088974667951757,3.0239277903931416,0.1,0.1
462,1715515998,1715517057,1059,1.2382478799463579,3.8665357564879104,0.14074375002275913,0.6289388161429739
463,1715519598,1715523198,3600,0.4670899916843597,3.1152165000126635,0.1,0.1
464,1715523198,1715523978,780,1.3100860955091864,3.9700035984929882,0.1392109398753831,0.5537246446230801
465,1715526798,1715530398,3600,0.16808685115174926,3.002212028799887,0.1,0.1
466,1715530398,1715530975,577,0.8822420430451099,3.472591689703437,0.9996514452998377,0.45306149933107986
467,1715533998,1715536638,2640,2.3730656885911428,4.634980552176527,0.7396018536366156,0.9190701164157118
468,1715537598,1715541198,3600,0.4590687063523078,3.0201521753308853,0.1,0.1
469,1715541198,1715541869,671,1.45396354863724,3.80580992486691,0.6158326120619124,0.13776050514218047
470,1715544798,1715548398,3600,0.18605702216331102,3.0965244560123715,0.1,0.1
471,1715548398,1715549010,612,1.4782527843693667,3.969824713216894,0.840046974076767,0.2925079749043775
472,1715551998,1715554669,2671,2.4078147890975816,4.618006022633171,0.9787937566291472,0.6093914973041432
473,1715555598,1715559128,3530,2.077626441267957,4.648825979119527,0.5675852121616558,0.9928562740240968
474,1715559198,1715559327,129,0.7725625411865267,3.395558250543731,0.32852382443500894,0.811980606576057
475,1715562798,1715566398,3600,0.3695563357348649,3.107503975710782,0.1,0.1
476,1715566398,1715569998,3600,0.29090689224986754,3.099196026014799,0.1,0.1
477,1715569998,1715570957,959,1.2664074591353405,4.161639214291491,0.42740768971047793,0.7008442490489604
478,1715573598,1715574777,1179,1.2024201222982582,3.9851898714340606,0.8715621398548788,0.7712731771257646
479,1715577198,1715579649,2451,2.255720142248676,4.390738521214553,0.46163319413672677,0.36809397809342026
480,1715580798,1715584398,3600,0.18940376929972122,3.043992079695087,0.1,0.1
481,1715584398,1715585658,1260,1.0556219286369928,4.177950469449369,0.7218097380329604,0.6705583103175721
482,1715587998,1715591598,3600,0.2423363519821513,3.0497724075347548,0.1,0.1
483,1715591598,1715592392,794,1.3457818322285688,4.097811240004389,0.4621396763978376,0.8244614220947303
484,1715595198,1715598508,3310,2.4823027391726447,4.4729868874417305,0.10579879593333026,0.3329662339316952
485,1715598798,1715602398,3600,0.25579900964016444,3.024708834289763,0.1,0.1
486,1715602398,1715603045,647,1.19251925604127,4.156019392782561,0.6099351361780374,0.6021574357034769
487,1715605998,1715608599,2601,2.2352720130204036,4.574211650133988,0.9512872953870498,0.9430291134968627
488,1715609598,1715613198,3600,0.49092587019259015,3.1505530092839398,0.1,0.1
489,1715613198,1715616798,3600,0.27097483687700685,3.125288479150345,0.1,0.1
490,1715616798,1715620398,3600,0.30828712237404987,3.1704417379619856,0.1,0.1
491,1715620398,1715623998,3600,0.4345046140859189,3.008172135944858,0.1,0.1
492,1715623998,1715626142,2144,1.6895983029458712,4.395128957424275,0.9601039205709407,0.16892333271277804
493,1715627598,1715630116,2518,2.3901276883218516,4.529354992933691,0.4372952497708835,0.2444044868298779
494,1715631198,1715634798,3600,0.1931262730723837,3.0562896570069613,0.1,0.1
495,1715634798,1715635592,794,1.3659306065135066,4.081341239838866,0.5237891588071426,0.6975574883106315
496,1715638398,1715641998,3600,0.10019650678422432,3.184174181304188,0.1,0.1
497,1715641998,1715643116,1118,1.3122889957282862,3.879177603369625,0.9505695977832429,0.568864043282408
498,1715645598,1715649198,3600,0.1424048673210955,3.0618180170034974,0.1,0.1
499,1715649198,1715652798,3600,0.43838837907725303,3.037830679673742,0.1,0.1
500,1715652798,1715656398,3600,0.4743523269740696,3.029087840171868,0.1,0.1
501,1715656398,1715659998,3600,0.2816291664717625,3.180390275844995,0.1,0.1
502,1715659998,1715663598,3600,0.13902354794661662,3.199054826998343,0.1,0.1
503,1715663598,1715667198,3600,0.10507254696348706,3.1094666806205034,0.1,0.1
504,1715667198,1715670798,3600,0.4458254299085471,3.1419002378685694,0.1,0.1
505,1715670798,1715674398,3600,0.3195241414020037,3.1082741308740007,0.1,0.1
506,1715674398,1715677998,3600,0.2472749939396943,3.021091357171259,0.1,0.1
507,1715677998,1715681598,3600,0.2657298786661516,3.090505774109969,0.1,0.1
508,1715681598,1715684815,3217,2.0913834830943236,4.403986133639962,0.7175018715690672,0.12936692466270294
509,1715685198,1715688798,3600,0.39200770447531785,3.1094546329686885,0.1,0.1
510,1715688798,1715692398,3600,0.12812088216041975,3.152948467290905,0.1,0.1
511,1715692398,1715695998,3600,0.18629388930599658,3.051139915649104,0.1,0.1
512,1715695998,1715696359,361,0.8190498941315071,3.4921532068668597,0.655805560973215,0.8735434533944667
513,1715699598,1715703198,3600,0.12112147964251957,3.0590147721560763,0.1,0.1
514,1715703198,1715706798,3600,0.4251493413761528,3.048738597339105,0.1,0.1
515,1715706798,1715709545,2747,1.9990446883030206,4.600656239529782,0.23339893139092482,0.278120961136749
516,1715710398,1715713998,3600,0.3733952373174869,3.0150604667729652,0.1,0.1
517,1715713998,1715714663,665,1.3057060373321037,3.9087346773437655,0.7818061049383217,0.6791189528878301
518,1715717598,1715719669,2071,1.5961180898561458,4.563378391320856,0.4788418971232842,0.44020998713929727
519,1715721198,1715722001,803,1.154804677007035,4.096031966579581,0.7402307137628561,0.2613859608910768
520,1715724798,1715728398,3600,0.32981457891326216,3.1348457663349363,0.1,0.1
521,1715728398,1715731985,3587,2.0696997847184995,4.646059050227957,0.17230886756090902,0.5799559454363853
522,1715731998,1715735144,3146,2.1768210503376584,4.653853111838151,0.7910543153029392,0.731611071568867
523,1715735598,1715739198,3600,0.40703610057080797,3.0541579606952682,0.1,0.1
524,1715739198,1715739789,591,0.5114507418307819,3.6762254776194396,0.4691030016005132,0.3249029461887638
525,1715742798,1715746398,3600,0.4277999962019505,3.181988965415074,0.1,0.1
526,1715746398,1715746691,293,0.7047588131762786,3.509943942754066,0.6096594689153939,0.7579661254626903
527,1715749998,1715751584,1586,1.1909700562296286,4.030664736854412,0.4927668376460542,0.3243396811095344
528,1715753598,1715757198,3600,0.4172998125277195,3.1332300136845483,0.1,0.1
529,1715757198,1715760798,3600,0.201096652130554,3.1661198339670986,0.1,0.1
530,1715760798,1715764398,3600,0.16195890253885403,3.0503992830533373,0.1,0.1
531,1715764398,1715764627,229,0.9556766854604194,3.60545319619331,0.3714716441492326,0.2813093247877066
532,1715767998,1715770778,2780,2.497792339071984,4.342325230601866,0.22233434514184358,0.5369379087522057
533,1715771598,1715775198,3600,0.1854933734053316,3.0423774375243884,0.1,0.1
534,1715775198,1715778798,3600,0.31578472110872013,3.0046111252947707,0.1,0.1
535,1715778798,1715782398,3600,0.4202415215236136,3.1431818575659602,0.1,0.1
536,1715782398,1715783789,1391,1.2633489310668107,4.064976896962026,0.8654903239311624,0.9983197923313013
537,1715785998,1715787475,1477,1.0877995243856906,3.969500847559776,0.7798493024262347,0.1325255898337595
538,1715789598,1715793198,3600,0.1065073553904036,3.1266195529553187,0.1,0.1
539,1715793198,1715795354,2156,1.679395590737951,4.39019853271558,0.9168933731833576,0.6449424125743578
540,1715796798,1715799793,2995,2.05478584553822,4.466817300708692,0.39726489359139716,0.14861151522979396
541,1715800398,1715801746,1348,1.2679865455076178,4.111961286972478,0.8856822339109316,0.9127321774945083
542,1715803998,1715807598,3600,0.33101948493177347,3.1618514776644946,0.1,0.1
543,1715807598,1715811198,3600,0.44783053922304705,3.0279019061776484,0.1,0.1
544,1715811198,1715814798,3600,0.1592488186745579,3.0621015809504284,0.1,0.1
545,1715814798,1715818398,3600,0.12953229885480672,3.1855116490536832,0.1,0.1
546,1715818398,1715820820,2422,1.5354488124613086,4.344801523384778,0.654482881406542,0.7958177310002279
547,1715821998,1715825598,3600,0.13039358124804515,3.0676085498643135,0.1,0.1
548,1715825598,1715826770,1172,1.1759886777171222,4.100344007440836,0.4313109093469544,0.6461597431258923
549,1715829198,1715832074,2876,1.7419030422140631,4.564666124988451,0.2004190325331076,0.6910867045557446
550,1715832798,1715836398,3600,0.24400847945103182,3.0819746208956076,0.1,0.1
551,1715836398,1715838744,2346,1.7829517723216977,4.480908690270133,0.39186728277247296,0.5313764949765674
552,1715839998,1715840556,558,0.6900713926948743,3.6958962479051354,0.7857034729886886,0.3593357235401192
553,1715843598,1715847198,3600,0.10269091590007284,3.171449012451548,0.1,0.1
554,1715847198,1715850026,2828,2.0025307335473888,4.69079054368398,0.339736030168338,0.6124176485592616
555,1715850798,1715854017,3219,2.3772869746228613,4.581917896319645,0.9974100630817722,0.5172212440555082
556,1715854398,1715857998,3600,0.40357110035170374,3.095345554177039,0.1,0.1
557,1715857998,1715861598,3600,0.3013273716703532,3.0247178632851135,0.1,0.1
558,1715861598,1715863206,1608,1.2599547232180113,4.061288653768602,0.6868318204827661,0.6524006188051262
559,1715865198,1715868345,3147,2.400297455164849,4.352761024195897,0.3993459215018442,0.7172698407405418
560,1715868798,1715872398,3600,0.41992141483560974,3.1831523083625766,0.1,0.1
561,1715872398,1715875998,3600,0.1084781508244832,3.191404160990232,0.1,0.1
562,1715875998,1715877096,1098,1.1842137505020305,4.10174690306044,0.6389495311814705,0.29310648346993895
563,1715879598,1715883198,3600,0.32128790696694076,3.119744655153666,0.1,0.1
564,1715883198,1715885570,2372,2.4029325754164983,4.5404797831996815,0.29768592808915684,0.8913173567875141
565,1715886798,1715887337,539,0.701214340305464,3.301160420808866,0.669284739463723,0.9303066027063726
566,1715890398,1715893998,3600,0.13254062284490536,3.0468146077553184,0.1,0.1
567,1715893998,1715896702,2704,1.6517889469210203,4.606691984803655,0.5772279170284764,0.5355629252364157
568,1715897598,1715900876,3278,1.7076715288477802,4.459713031585341,0.6363772423870242,0.7660898265942214
569,1715901198,1715903272,2074,2.433714709018297,4.5474067428039575,0.5454892327955998,0.788578348057658
570,1715904798,1715905873,1075,1.304831611206067,4.003876632020189,0.3204332062140285,0.7636654026199774
571,1715908398,1715911998,3600,0.4947537693894457,3.1022735047728838,0.1,0.1
572,1715911998,1715915598,3600,0.17697952382015988,3.1495849558191678,0.1,0.1
573,1715915598,1715919198,3600,0.48607523660540297,3.0134327177235565,0.1,0.1
574,1715919198,1715922798,3600,0.28921630557952965,3.0080664838112123,0.1,0.1
575,1715922798,1715923182,384,0.8264170110128377,3.3970449051709792,0.2618062415277814,0.7888782018173944
576,1715926398,1715928529,2131,1.71987548884139,4.340152242223699,0.921019295561572,0.2676136655323169
577,1715929998,1715933598,3600,0.42909685321009194,3.019101905602432,0.1,0.1
578,1715933598,1715937198,3600,0.2243446595023825,3.134660047641414,0.1,0.1
579,1715937198,1715940094,2896,2.1193830770197257,4.5131637542534335,0.9601186658988364,0.24839559480571374
580,1715940798,1715942672,1874,1.8937907341518274,4.391363155492538,0.688794947018044,0.4891956487421436
581,1715944398,1715947998,3600,0.46467569709160306,3.0960501695734735,0.1,0.1
582,1715947998,1715951598,3600,0.48389301023309017,3.159505248655938,0.1,0.1
583,1715951598,1715953319,1721,1.4184630430625371,4.065450085881208,0.8608841824748498,0.8207450987942209
584,1715955198,1715958798,3600,0.3217444695923798,3.089408083859239,0.1,0.1
585,1715958798,1715960927,2129,2.429438961044248,4.583079908104157,0.36961599899106024,0.7368892624498345
586,1715962398,1715965180,2782,1.8726335549124944,4.699990979225424,0.1636862386255185,0.9041815245492536
587,1715965998,1715967396,1398,1.0022615410157574,3.9027424724199737,0.28543142651929854,0.6631527220963599
588,1715969598,1715973198,3600,0.43901834893223945,3.120707636332967,0.1,0.1
589,1715973198,1715976798,3600,0.1966278675911046,3.1244897708147845,0.1,0.1
590,1715976798,1715979329,2531,2.2310795638453054,4.358944037178427,0.9407446847469343,0.8927855488653976
591,1715980398,1715983998,3600,0.27459054893260837,3.0521740919523888,0.1,0.1
592,1715983998,1715984187,189,0.7553003025162012,3.6729473451275814,0.48671965355004865,0.40145948790537056
593,1715987598,1715991198,3600,0.14147545395361538,3.074485648709983,0.1,0.1
594,1715991198,1715992081,883,1.0694723772566763,4.044913457032054,0.9892396093353073,0.29500157126420223
595,1715994798,1715998398,3600,0.4210471836198456,3.0059479313456023,0.1,0.1
596,1715998398,1716001998,3600,0.3588882489473221,3.004522802895071,0.1,0.1
597,1716001998,1716005598,3600,0.28752253436678804,3.087735939216267,0.1,0.1
598,1716005598,1716009198,3600,0.21447265752343184,3.1556604691047045,0.1,0.1
599,1716009198,1716012798,3600,0.23402887203728204,3.1630500246611093,0.1,0.1
600,1716012798,1716013985,1187,1.207677509688394,4.088911215336608,0.7752263604905011,0.7657361272216575
601,1716016398,1716019998,3600,0.42182466609856284,3.1001808244376488,0.1,0.1
602,1716019998,1716023598,3600,0.20891432418538405,3.0067668565175607,0.1,0.1
603,1716023598,1716027198,3600,0.31865836145674575,3.1101276835976184,0.1,0.1
604,1716027198,1716030258,3060,2.1202670235527004,4.501575758624018,0.20320374704302857,0.12920751539354744
605,1716030798,1716032540,1742,1.4420119083957466,4.176889231679207,0.31979058682970957,0.7453350290982069
606,1716034398,1716037998,3600,0.14058203418060178,3.175651493721767,0.1,0.1
607,1716037998,1716041598,3600,0.2067330635835279,3.076498745080867,0.1,0.1
608,1716041598,1716045198,3600,0.21831235613937439,3.0459881984955204,0.1,0.1
609,1716045198,1716047435,2237,2.392100632479924,4.358803458219658,0.13751945363965515,0.18995772883940704
610,1716048798,1716052398,3600,0.3045998302953249,3.025549298547009,0.1,0.1
611,1716052398,1716055260,2862,1.6680127256754713,4.4593150632403535,0.24942155433624108,0.7461573558636561
612,1716055998,1716057918,1920,2.4384830419956796,4.534878659931563,0.2616474876784891,0.6395965698193969
613,1716059598,1716063198,3600,0.43811198443609356,3.104350219177102,0.1,0.1
614,1716063198,1716064856,1658,1.0529960893325494,3.912829181558514,0.8472364297845316,0.15454822161686432
615,1716066798,1716070398,3600,0.43291404558796776,3.115973003025583,0.1,0.1
616,1716070398,1716072987,2589,1.9792802385563737,4.582952423603014,0.4917103713613372,0.4265165274588133
617,1716073998,1716076149,2151,1.642708340613353,4.64308686624865,0.6260986862675271,0.9855180765305172
618,1716077598,1716079629,2031,2.1204205199503834,4.425027775426272,0.8942996937950051,0.9601466179752025
619,1716081198,1716084798,3600,0.23769180201949822,3.0926539486942515,0.1,0.1
620,1716084798,1716088398,3600,0.11457849710979945,3.006080898288717,0.1,0.1
621,1716088398,1716090529,2131,1.7738681318820655,4.594656162575107,0.24648156378655234,0.14124677321526147
622,1716091998,1716092064,66,0.8476657801151553,3.6881919995663703,0.5579830128661889,0.5993530611055745
623,1716095598,1716099198,3600,0.32378864252041306,3.1471388478639764,0.1,0.1
624,1716099198,1716102798,3600,0.48835114850483197,3.128137461872352,0.1,0.1
625,1716102798,1716105078,2280,2.3191235338688787,4.309731373379648,0.883364756676998,0.22915170929294076
626,1716106398,1716108516,2118,1.8226119896424882,4.690665452777198,0.6852937673801962,0.6331456383625862
627,1716109998,1716113598,3600,0.3393626006112134,3.085066696626227,0.1,0.1
628,1716113598,1716113771,173,0.9047498462293289,3.319895409830406,0.7977160201725534,0.2845968369334894
629,1716117198,1716120798,3600,0.14417710209711482,3.1930637957120824,0.1,0.1
630,1716120798,1716124398,3600,0.18596348564641463,3.1666002375860494,0.1,0.1
631,1716124398,1716126328,1930,2.1725601837444257,4.536509222335417,0.4279503558273412,0.7918266843996579
632,1716127998,1716131598,3600,0.13455348515509555,3.1810200403802122,0.1,0.1
633,1716131598,1716135198,3600,0.15908563924312336,3.054592112339297,0.1,0.1
634,1716135198,1716138798,3600,0.3082658097688933,3.169236546954574,0.1,0.1
635,1716138798,1716142398,3600,0.26567020467424174,3.1635413246113147,0.1,0.1
636,1716142398,1716145998,3600,0.13233863247806343,3.141643152878544,0.1,0.1
637,1716145998,1716148738,2740,1.847349112802065,4.390736057274674,0.6611794437047371,0.6529592334362833
638,1716149598,1716151643,2045,2.0850363394665026,4.631272753039875,0.8176898961546291,0.28741019531920037
639,1716153198,1716155452,2254,2.30941794982619,4.369929946348982,0.45420763140126186,0.2638374210475473
640,1716156798,1716160398,3600,0.17155826940114843,3.166095833555375,0.1,0.1
641,1716160398,1716163998,3600,0.37750705315484634,3.0657970706063433,0.1,0.1
642,1716163998,1716167598,3600,0.23024478853584152,3.030985451365208,0.1,0.1
643,1716167598,1716168644,1046,1.106823991097107,3.852783613352589,0.7706155775992904,0.9835999171883578
644,1716171198,1716172776,1578,1.1996033256501353,3.9090972605861416,0.2820743243540194,0.18100282180136734
645,1716174798,1716178398,3600,0.3671469615336095,3.099445816868677,0.1,0.1
646,1716178398,1716179795,1397,1.4254210328572117,4.031664033505842,0.6860222733311194,0.9227976140559058
647,1716181998,1716185598,3600,0.24304700093730702,3.0890221996620255,0.1,0.1
648,1716185598,1716186545,947,1.2080573989439003,3.9531951535363903,0.19493129142898707,0.3850626746073207
649,1716189198,1716191013,1815,2.228613270231074,4.467201673381883,0.3037983039256879,0.765095311093524
650,1716192798,1716195704,2906,2.4811973573179933,4.690017312230139,0.4509777269746005,0.8204467188910511
651,1716196398,1716199998,3600,0.4866050560534687,3.045241895627842,0.1,0.1
652,1716199998,1716203598,3600,0.2751347009176702,3.173954288453256,0.1,0.1
653,1716203598,1716206430,2832,2.3422010426666793,4.410786305085205,0.7873213593413736,0.772097307874999
654,1716207198,1716210798,3600,0.2947335377465802,3.1481664935834157,0.1,0.1
655,1716210798,1716214398,3600,0.10865063266680197,3.0653532277652498,0.1,0.1
656,1716214398,1716217998,3600,0.4523047087653943,3.048436508927887,0.1,0.1
657,1716217998,1716221598,3600,0.4860409467750123,3.145555709525011,0.1,0.1
658,1716221598,1716224784,3186,1.9933237282217768,4.441973165994433,0.1590906632921974,0.32314377606929906
659,1716225198,1716227356,2158,1.9711398381609604,4.675001374095712,0.618682031094127,0.4077838293370468
660,1716228798,1716232398,3600,0.3217442312502209,3.083184217737652,0.1,0.1
661,1716232398,1716235998,3600,0.20098620754622987,3.0804888929430283,0.1,0.1
662,1716235998,1716238585,2587,1.5374896942830207,4.559356896252613,0.8882857231078906,0.5058196879303655
663,1716239598,1716240145,547,0.6034817346441843,3.6978986906269475,0.4179267128259764,0.4919658092346114
664,1716243198,1716243318,120,0.9459789152529026,3.6239673591557136,0.4268767937296234,0.6739007230097482
665,1716246798,1716249543,2745,2.0612325332962027,4.531704677874178,0.4460428138489403,0.7610810248078865
666,1716250398,1716253339,2941,2.1741203051133215,4.617932066072409,0.9763700548796174,0.5860771891812254
667,1716253998,1716257598,3600,0.23108880537412554,3.0808209697305955,0.1,0.1
668,1716257598,1716261198,3600,0.3576527128927286,3.1821199142643866,0.1,0.1
669,1716261198,1716264798,3600,0.20541381933479547,3.0606178039597625,0.1,0.1
670,1716264798,1716268398,3600,0.4523507072437888,3.1277939659794827,0.1,0.1
671,1716268398,1716271909,3511,1.6457598149638706,4.609272192118927,0.5877990730165946,0.7162571346897064
672,1716271998,1716275598,3600,0.13754546186000002,3.1596120059530466,0.1,0.1
673,1716275598,1716279198,3600,0.26328038570564416,3.1175502506052726,0.1,0.1
674,1716279198,1716282798,3600,0.3587628750566233,3.1518991542016326,0.1,0.1
675,1716282798,1716286398,3600,0.33031110249314743,3.004174426465247,0.1,0.1
676,1716286398,1716288554,2156,1.5426450441588575,4.5824438546045085,0.6905823877993289,0.7511052172642938
677,1716289998,1716293598,3600,0.15793424676777534,3.043106350873381,0.1,0.1
678,1716293598,1716295521,1923,2.199451566642971,4.403938799281429,0.5082644316003211,0.1478812313413705
679,1716297198,1716299241,2043,2.0186661739127674,4.615906800762298,0.3822923006795542,0.1547998561659989
680,1716300798,1716304398,3600,0.3056075521092949,3.0825115406311956,0.1,0.1
681,1716304398,1716306966,2568,2.3756270021775876,4.342506344506768,0.46659442683678154,0.693769427043257
682,1716307998,1716311598,3600,0.40798083705319,3.061271296994651,0.1,0.1
683,1716311598,1716315198,3600,0.4346519052022487,3.0691357724257333,0.1,0.1
684,1716315198,1716318798,3600,0.3514996630421624,3.0552888475301145,0.1,0.1
685,1716318798,1716322216,3418,1.540182083508518,4.493311521979067,0.9839568302755888,0.715405655327446
686,1716322398,1716325998,3600,0.3889204932679986,3.145628122304405,0.1,0.1
687,1716325998,1716329598,3600,0.2967537974861423,3.126820824382559,0.1,0.1
688,1716329598,1716333198,3600,0.18284475689298774,3.156936110420888,0.1,0.1
689,1716333198,1716335114,1916,2.0360556185765577,4.641785606883533,0.47541230145848057,0.7789680595178163
690,1716336798,1716338729,1931,1.830123554525236,4.592034403844398,0.7908457971048127,0.4174700001297731
691,1716340398,1716340493,95,0.8427666215349507,3.685053824245514,0.3195058964048225,0.34944393069686913
692,1716343998,1716344684,686,1.40674291158581,3.8954410463060647,0.13241381418796888,0.4594674193189119
693,1716347598,1716349484,1886,2.0940481399881774,4.477943547727352,0.43517901767609035,0.6226137818845137
694,1716351198,1716354176,2978,1.6519186842421445,4.590645954239721,0.5990513641617309,0.20520330815743532
695,1716354798,1716358398,3600,0.44700035316269326,3.082103384912848,0.1,0.1
696,1716358398,1716361998,3600,0.42527226277436403,3.097006453267113,0.1,0.1
697,1716361998,1716364774,2776,2.477519895975323,4.458184079580514,0.8033384337810595,0.9506820586684765
698,1716365598,1716369198,3600,0.19697782348984566,3.149986270085196,0.1,0.1
699,1716369198,1716372798,3600,0.15355624656673192,3.049590207374167,0.1,0.1
700,1716372798,1716374543,1745,1.1975205992354117,4.142030167254976,0.6468683586202031,0.28487573253943216
701,1716376398,1716378113,1715,1.1887749016025255,4.104502073574175,0.48796760842145936,0.6509705055892435
702,1716379998,1716383383,3385,1.7619435402250043,4.600308630616,0.9286883902801317,0.4019332803224569
703,1716383598,1716387198,3600,0.4926220624890302,3.1256877649857575,0.1,0.1
704,1716387198,1716390022,2824,1.8180168413479738,4.4471284964816675,0.8486527655214576,0.3637260028732672
705,1716390798,1716392094,1296,1.2249182623451884,4.115707475657146,0.47425798693198096,0.7559749578633111
706,1716394398,1716397998,3600,0.3823728083840163,3.1886369424518413,0.1,0.1
707,1716397998,1716401598,3600,0.43823825413119466,3.050887423263054,0.1,0.1
708,1716401598,1716405198,3600,0.42945903245460326,3.0765659003767736,0.1,0.1
709,1716405198,1716406598,1400,1.1604770521055916,3.8406196407284647,0.11522800008558089,0.45710890622273925
710,1716408798,1716411191,2393,2.1217262648483923,4.302313984293701,0.7404797922819658,0.3044854236488359
711,1716412398,1716413009,611,1.030474208630355,3.94895185303439,0.18419565028528015,0.8908704689891394
712,1716415998,1716418457,2459,1.7426567711593526,4.418464259798424,0.2771663752554937,0.6302625401822067
713,1716419598,1716423198,3600,0.42198454464447677,3.083916188500482,0.1,0.1
714,1716423198,1716424841,1643,1.1506350126673563,4.031351168661466,0.21496744296360887,0.9313904334857801
715,1716426798,1716430398,3600,0.3591467309382955,3.1932732067998866,0.1,0.1
716,1716430398,1716433998,3600,0.42128840296150893,3.1377426637718346,0.1,0.1
717,1716433998,1716437598,3600,0.19047715022550823,3.1406381524724476,0.1,0.1
718,1716437598,1716437687,89,0.9472625904223926,3.686524344727175,0.4050923808016933,0.8026500055391714
719,1716441198,1716443029,1831,2.126625439105378,4.654067365923507,0.6543473698081388,0.8861744196198797
720,1716444798,1716448398,3600,0.20658116519632694,3.1240740309819843,0.1,0.1
721,1716448398,1716451998,3600,0.4216729932600072,3.1238337961667586,0.1,0.1
722,1716451998,1716455598,3600,0.3966772717543562,3.073862540723659,0.1,0.1
723,1716455598,1716459150,3552,1.6593100814532324,4.387899780495697,0.4264084608450316,0.5453485504337925
724,1716459198,1716460520,1322,1.4294235971698193,3.9228324763489955,0.837767358469892,0.31723536871130975
725,1716462798,1716465271,2473,2.2721637755110637,4.3410694062484,0.8503417856071145,0.8070999384513645
726,1716466398,1716469248,2850,2.4251138356139497,4.462512207008705,0.7519619270847839,0.24821018998067343
727,1716469998,1716473598,3600,0.4095047467588935,3.1643968805753557,0.1,0.1
728,1716473598,1716477198,3600,0.38698791871591154,3.004382944457786,0.1,0.1
729,1716477198,1716480798,3600,0.15604287800444291,3.0200089927459777,0.1,0.1
730,1716480798,1716483677,2879,2.3423952579573664,4.430476402507462,0.2720471417795901,0.575160253257937
731,1716484398,1716485677,1279,1.4504252734296217,4.121642600514898,0.2581064992913259,0.503212331574832
732,1716487998,1716489535,1537,1.0652485023432665,3.986564945258633,0.603655947240533,0.9740377989442606
733,1716491598,1716492039,441,0.8504116115659429,3.43565109895933,0.8590129993966216,0.1504357631422495
734,1716495198,1716496908,1710,1.363070125193432,3.873364844648192,0.19198865807867077,0.2528595472820699
735,1716498798,1716502398,3600,0.17407480365591624,3.0692176425679207,0.1,0.1
736,1716502398,1716502906,508,0.8591414782175842,3.5173820462473757,0.7992633344932248,0.7858054406170046
737,1716505998,1716509048,3050,2.3710943498768926,4.65645240538311,0.27549254755310515,0.6134358805164549
738,1716509598,1716513198,3600,0.3960121802387594,3.0912609675790743,0.1,0.1
739,1716513198,1716514388,1190,1.4698100870082609,4.027430836513772,0.9712571324907081,0.19344735651479789
740,1716516798,1716520398,3600,0.21318338439746054,3.152600353674881,0.1,0.1
741,1716520398,1716523327,2929,2.45099796887147,4.503196246241376,0.4051969980216503,0.6095439022457281
742,1716523998,1716524969,971,1.115297295207974,3.935767482345,0.18057407599918052,0.5886198141906186
743,1716527598,1716531198,3600,0.4629224948903716,3.0577309440418183,0.1,0.1
744,1716531198,1716534798,3600,0.23964251925183586,3.063892530464423,0.1,0.1
745,1716534798,1716538398,3600,0.2249150693710593,3.1097608597669293,0.1,0.1
746,1716538398,1716541026,2628,2.347546197220324,4.676096265987129,0.5300501424045267,0.3106189959346751
747,1716541998,1716545200,3202,1.6197765515591152,4.507824762325255,0.6625864636070784,0.23419444357355423
748,1716545598,1716549198,3600,0.3329205269155999,3.139373746184018,0.1,0.1
749,1716549198,1716551663,2465,1.706560117262301,4.603023495910121,0.5105070311464136,0.5532252448288704
750,1716552798,1716553880,1082,1.1355040981991347,3.8072527266715515,0.904515035722653,0.19237032936694703
751,1716556398,1716559998,3600,0.4047402448074051,3.18339575212775,0.1,0.1
752,1716559998,1716562581,2583,1.8830535986989676,4.522203280685626,0.8963702341151802,0.31069575545074035
753,1716563598,1716567198,3600,0.17792351827257097,3.1576907213391,0.1,0.1
754,1716567198,1716570798,3600,0.2508901555064845,3.114298189425803,0.1,0.1
755,1716570798,1716574398,3600,0.4419044412829435,3.006297072780195,0.1,0.1
756,1716574398,1716577998,3600,0.13149143665778157,3.093156799527542,0.1,0.1
757,1716577998,1716581598,3600,0.43842222801755104,3.125996557425807,0.1,0.1
758,1716581598,1716584011,2413,2.1518572228365187,4.435063021429525,0.9540715238174781,0.704019079578867
759,1716585198,1716588798,3600,0.18718470310425991,3.0625096594982546,0.1,0.1
760,1716588798,1716591739,2941,2.475121798640621,4.408430074422267,0.3797755758510213,0.5009213673272517
761,1716592398,1716593203,805,1.3464620620211236,3.8613325779879264,0.3948706074642172,0.5047132963321316
762,1716595998,1716597477,1479,1.2560249870804987,4.023085008895817,0.46896743083927195,0.8462389111735944
763,1716599598,1716603198,3600,0.43142700819766133,3.193491865071533,0.1,0.1
764,1716603198,1716604534,1336,1.4219768841110332,4.1363642063354495,0.3713014850915892,0.5969900783910667
765,1716606798,1716609266,2468,2.3227660505698635,4.370099839379679,0.14777537881560174,0.7283715801949603
766,1716610398,1716613579,3181,1.64770720394003,4.564787178433806,0.7561846265526059,0.14297037406420496
767,1716613998,1716616263,2265,2.2450701994003106,4.32169858763652,0.6144568308157863,0.7597571820605975
768,1716617598,1716617928,330,0.5015740599130254,3.5547057337571237,0.22650152667575021,0.569337179305862
769,1716621198,1716621525,327,0.7155116586055354,3.3900351141283327,0.1026862200789279,0.49805685412601675
770,1716624798,1716627750,2952,1.6145163419523954,4.668573943218863,0.8121629624841967,0.5714643512329016
771,1716628398,1716631998,3600,0.18259379447476498,3.1164903330149643,0.1,0.1
772,1716631998,1716634516,2518,2.341429387510911,4.612199403172691,0.9904769734612333,0.676891817010535
773,1716635598,1716638593,2995,2.2410799677345565,4.50755813630801,0.5667520129677678,0.9478116813234823
774,1716639198,1716639895,697,1.3246827210799226,4.1789982985056255,0.15589267560492936,0.7114514700176285
775,1716642798,1716646398,3600,0.35141727924525057,3.1728663927515433,0.1,0.1
776,1716646398,1716649998,3600,0.4549346146852702,3.0652440163650536,0.1,0.1
777,1716649998,1716653598,3600,0.331688203521429,3.07571249089874,0.1,0.1
778,1716653598,1716657198,3600,0.4166571850169688,3.1907917757089184,0.1,0.1
779,1716657198,1716660798,3600,0.4736983008846022,3.0582932342806863,0.1,0.1
780,1716660798,1716664398,3600,0.35959461456431374,3.1649337388357117,0.1,0.1
781,1716664398,1716665114,716,1.3585468851243008,3.8853785832056085,0.4575888041316212,0.49585093655944423
782,1716667998,1716668728,730,1.1144116016388292,3.81803097759139,0.15857922777264652,0.4058056801715486
783,1716671598,1716675071,3473,2.2144112101244056,4.583334369539599,0.45502748661453907,0.8485434374374607
784,1716675198,1716678798,3600,0.30708397703090556,3.108574226869058,0.1,0.1
785,1716678798,1716680390,1592,1.062925145148009,3.85789367371508,0.9862544754220222,0.12507490595209134
786,1716682398,1716685998,3600,0.17122296673022802,3.078467607731828,0.1,0.1
787,1716685998,1716689598,3600,0.2515351590086044,3.0272839072539237,0.1,0.1
788,1716689598,1716691193,1595,1.0757387335034247,3.9228752771021727,0.8887263880329325,0.4294787564767075
789,1716693198,1716694616,1418,1.0414234882404887,4.199880816143477,0.4428158651749372,0.18053330632564896
790,1716696798,1716700398,3600,0.2810621812444723,3.0233161191865925,0.1,0.1
791,1716700398,1716701422,1024,1.3927754051354084,3.8974582001796203,0.9583407924271353,0.30634652757204117
792,1716703998,1716707598,3600,0.36346874259435336,3.075171949475373,0.1,0.1
793,1716707598,1716711198,3600,0.3771236830677367,3.020342600964834,0.1,0.1
794,1716711198,1716711641,443,0.5256538728526627,3.4533768164607386,0.9773349543541712,0.3729197734636608
795,1716714798,1716717694,2896,1.8563127680600668,4.317341616004515,0.9223734109418615,0.6024525568640703
796,1716718398,1716721998,3600,0.2712623050202154,3.1825888468544883,0.1,0.1
797,1716721998,1716725598,3600,0.2758771218393601,3.069419295428492,0.1,0.1
798,1716725598,1716729198,3600,0.16060127478051578,3.098683431336091,0.1,0.1
799,1716729198,1716729319,121,0.8850156954335868,3.3896914735108457,0.4413485478315702,0.6445977684149908
800,1716732798,1716733257,459,0.769878895681702,3.3779800049235282,0.27259698478580713,0.3716348882395647
801,1716736398,1716739035,2637,1.9536259837305656,4.5500470836459215,0.3380502313329191,0.3050162337832387
802,1716739998,1716743598,3600,0.4406849748506031,3.0398720362701823,0.1,0.1
803,1716743598,1716745603,2005,1.6068016395655094,4.478948984629702,0.8089497161061737,0.367444872400452
804,1716747198,1716748014,816,1.2803321348850534,4.168396225449829,0.8786506222933324,0.7699697661900975
805,1716750798,1716754158,3360,2.421221192366997,4.491395856182604,0.44210030170182735,0.6754949254072266
806,1716754398,1716757998,3600,0.26407005832179964,3.0065103070468715,0.1,0.1
807,1716757998,1716759691,1693,1.1887039672291406,4.125149137718324,0.5384779441860715,0.4644637669948932
808,1716761598,1716765198,3600,0.1350828885559473,3.1891678363209732,0.1,0.1
809,1716765198,1716768798,3600,0.13968496233128486,3.1921592448372524,0.1,0.1
810,1716768798,1716772398,3600,0.13230049831931195,3.0165935668226207,0.1,0.1
811,1716772398,1716775998,3600,0.22558812401774264,3.0268558023752514,0.1,0.1
812,1716775998,1716779598,3600,0.1355216056637911,3.1175598309612855,0.1,0.1
813,1716779598,1716780256,658,1.0721984338972308,4.001514718082632,0.8976939814647966,0.31531487172005246
814,1716783198,1716786798,3600,0.13563340981957125,3.185670675495384,0.1,0.1
815,1716786798,1716790398,3600,0.48159524464625625,3.0449389961854996,0.1,0.1
816,1716790398,1716793713,3315,1.6549481503074286,4.636278443639554,0.7589276102671034,0.9357666023451061
817,1716793998,1716797430,3432,1.6923759386736328,4.301721143115723,0.44965536047372623,0.1725433157300567
818,1716797598,1716799094,1496,1.2467388960085493,3.9696692281104538,0.7312876104747507,0.5491372513523751
819,1716801198,1716804798,3600,0.16411654500223655,3.172922637448343,0.1,0.1
820,1716804798,1716807390,2592,1.9581832213539239,4.435034922783386,0.427769324666597,0.3377862144892215
821,1716808398,1716811998,3600,0.39480143935575696,3.0792956586216644,0.1,0.1
822,1716811998,1716814049,2051,2.3185149053160012,4.554914944180815,0.24193700600499302,0.41722458990674127
823,1716815598,1716819198,3600,0.4579260979682369,3.0307096156477145,0.1,0.1
824,1716819198,1716822798,3600,0.24681905696377882,3.0606361203784878,0.1,0.1
825,1716822798,1716826398,3600,0.13680309765823445,3.1861089490484806,0.1,0.1
826,1716826398,1716828443,2045,1.7162820136584465,4.6079981100218355,0.5356002600272555,0.4454827772866963
827,1716829998,1716833598,3600,0.39788421347222436,3.0274841445785943,0.1,0.1
828,1716833598,1716837198,3600,0.3937845627880451,3.0175575544091244,0.1,0.1
829,1716837198,1716839753,2555,1.5984079301721301,4.452134211944529,0.6741123161788122,0.6891869591308672
830,1716840798,1716844398,3600,0.16024618115896422,3.0973270971833218,0.1,0.1
831,1716844398,1716846138,1740,1.0457185980352741,3.8231004011694627,0.5211760869644837,0.5935531336860256
832,1716847998,1716850260,2262,1.624794503474428,4.413702508601254,0.810712640385047,0.6917249830292769
833,1716851598,1716855198,3600,0.37528871488839266,3.065279447887231,0.1,0.1
834,1716855198,1716858798,3600,0.44478300641100466,3.084083873012392,0.1,0.1
835,1716858798,1716861831,3033,1.611635604763487,4.4950678255716765,0.6420966230467425,0.9207563519791295
836,1716862398,1716865476,3078,1.728010184003919,4.462147552468632,0.9100577607758162,0.4805413453069126
837,1716865998,1716869598,3600,0.4653383755252549,3.102829439741887,0.1,0.1
838,1716869598,1716870397,799,1.0364635373367528,3.9621887553858643,0.34890034884596743,0.3278977631765917
839,1716873198,1716876498,3300,1.5256693260554046,4.397055092435304,0.7233745617923566,0.5149004530184582
840,1716876798,1716880398,3600,0.15817309242360636,3.1984144508355326,0.1,0.1
841,1716880398,1716883998,3600,0.49768445699621666,3.0192557095517145,0.1,0.1
842,1716883998,1716886688,2690,1.742388190143151,4.5554302413526875,0.28273131379119554,0.6284254636952055
843,1716887598,1716888071,473,0.9045364566370557,3.5200653259383703,0.35241752711457164,0.33412891453002685
844,1716891198,1716894798,3600,0.1714776104083832,3.136215681593077,0.1,0.1
845,1716894798,1716896866,2068,1.9794797761979295,4.649407556060749,0.48109056104766523,0.1971534063924071
846,1716898398,1716899240,842,1.1272125827778936,3.83739484204454,0.42902334543873577,0.7222257199691993
847,1716901998,1716904377,2379,1.8098279096850969,4.5939950082834216,0.964656851440532,0.5193892654058211
848,1716905598,1716909198,3600,0.44172771940139044,3.0398505568789047,0.1,0.1
849,1716909198,1716912798,3600,0.23123889780702803,3.1993311308980443,0.1,0.1
850,1716912798,1716916398,3600,0.3892789485075572,3.0048361619625714,0.1,0.1
851,1716916398,1716919277,2879,2.3554310904133082,4.643531445380919,0.8800030169592542,0.8143308043598924
852,1716919998,1716923598,3600,0.4236611542665166,3.1976262443273624,0.1,0.1
853,1716923598,1716925961,2363,1.7440712834091405,4.583684694896964,0.8377279212776971,0.7002305961862757
854,1716927198,1716929650,2452,2.1379545525059647,4.5498811136243855,0.4856715785803247,0.7842333644434519
855,1716930798,1716934398,3600,0.19628635012808773,3.186191517249252,0.1,0.1
856,1716934398,1716937998,3600,0.14004546284629749,3.1609850913860584,0.1,0.1
857,1716937998,1716940468,2470,1.9754944862058186,4.612058098277754,0.6648505887554547,0.9252193608438471
858,1716941598,1716942872,1274,1.2289349010053274,4.000881707901986,0.3798981077094691,0.19877433746912915
859,1716945198,1716948798,3600,0.2909137978592883,3.023081138167424,0.1,0.1
860,1716948798,1716952398,3600,0.33815568694213927,3.016236851268753,0.1,0.1
861,1716952398,1716955998,3600,0.46646171770960554,3.03447357291571,0.1,0.1
862,1716955998,1716959598,3600,0.3585657571753462,3.129155642560788,0.1,0.1
863,1716959598,1716963198,3600,0.2978433699167405,3.0016113808876206,0.1,0.1
864,1716963198,1716965490,2292,1.9664440238585206,4.428938435799142,0.9426292252985942,0.6423089090242875
865,1716966798,1716970398,3600,0.17702121515783933,3.158297099304866,0.1,0.1
866,1716970398,1716973998,3600,0.41445309948807163,3.160810579490317,0.1,0.1
867,1716973998,1716977598,3600,0.3181700944466308,3.0538358542136272,0.1,0.1
868,1716977598,1716977803,205,0.8909682474968197,3.385508145340064,0.4434183085472351,0.24116024877285663
869,1716981198,1716983884,2686,1.6248592366076515,4.371902214045088,0.25049575828547493,0.22271396289654546
870,1716984798,1716985959,1161,1.3150006280483568,4.159538245104709,0.6601385208844457,0.6957262885434548
871,1716988398,1716989858,1460,1.301773521459812,3.8780054701855646,0.2054913532251394,0.5993020461890576
872,1716991998,1716993731,1733,1.0964588549615597,4.060258542197728,0.43035051754810694,0.5566245594432734
873,1716995598,1716999198,3600,0.36399209525384824,3.0722489180213506,0.1,0.1
874,1716999198,1717000262,1064,1.1243376880349492,4.067678798498186,0.2822093844381471,0.16797099738621485
875,1717002798,1717006398,3600,0.1569862297550854,3.0490542368863265,0.1,0.1
876,1717006398,1717008636,2238,1.9059205782031285,4.515824609948112,0.39179338227648863,0.3672003610851896
877,1717009998,1717013598,3600,0.42209527144015646,3.1190902429431655,0.1,0.1
878,1717013598,1717017198,3600,0.2641607614438618,3.178438928114218,0.1,0.1
879,1717017198,1717019811,2613,2.365522623627144,4.57976620069252,0.5613740670333119,0.4276753377162221
880,1717020798,1717024398,3600,0.15238026713306652,3.009792933011618,0.1,0.1
881,1717024398,1717027998,3600,0.256126561425396,3.0575036239293345,0.1,0.1
882,1717027998,1717031598,3600,0.12151469941124385,3.1070042533964957,0.1,0.1
883,1717031598,1717033297,1699,1.360814948672922,4.013280159130922,0.8290931399868448,0.3341247543308658
884,1717035198,1717038798,3600,0.31903994809451297,3.120033280127546,0.1,0.1
885,1717038798,1717039154,356,0.5171563697491269,3.5049483368310543,0.12322112817976186,0.6742242711316733
886,1717042398,1717045645,3247,1.71522764032057,4.5503628679411,0.5955886410675156,0.15452478951953594
887,1717045998,1717046598,600,1.0949025570455253,4.056178160026441,0.5571268351706582,0.18499576513548424
888,1717049598,1717053198,3600,0.4540626892626486,3.052025523174843,0.1,0.1
889,1717053198,1717055731,2533,2.024220063857432,4.557229507281684,0.40917180396275,0.23227009918796057
890,1717056798,1717060398,3600,0.2829158744699932,3.0586486246914135,0.1,0.1
891,1717060398,1717061127,729,1.0515329922308914,4.0424470046128365,0.6366326293307046,0.5348349470833382
892,1717063998,1717067598,3600,0.25533590898361347,3.129763308296102,0.1,0.1
893,1717067598,1717071198,3600,0.2832278245679025,3.152493595869853,0.1,0.1
894,1717071198,1717072523,1325,1.0885923770301476,3.879097489970049,0.8044352042062531,0.3081222226630518
895,1717074798,1717078398,3600,0.14876285318569887,3.019021070497872,0.1,0.1
896,1717078398,1717081998,3600,0.2607175968008094,3.1636175705252882,0.1,0.1
897,1717081998,1717085598,3600,0.19725211489885788,3.0087235631248346,0.1,0.1
898,1717085598,1717086223,625,1.3920357143315738,4.177128620762592,0.864742815205568,0.684990083921549
899,1717089198,1717091872,2674,1.9826783998265585,4.409172321102441,0.6820789232243272,0.9569835588886625
900,1717092798,1717093732,934,1.2098472698504574,3.933072770270123,0.13890951010791083,0.6682035366144858
901,1717096398,1717099998,3600,0.3914452616336105,3.1157857779215545,0.1,0.1
902,1717099998,1717103598,3600,0.45930456545605336,3.1423390110844407,0.1,0.1
903,1717103598,1717107198,3600,0.1201096211556445,3.1693652915771797,0.1,0.1
904,1717107198,1717110798,3600,0.21734600512219307,3.1873592558882384,0.1,0.1
905,1717110798,1717110890,92,0.5014146317166064,3.569096771559951,0.4531504364136435,0.18033669795732205
906,1717114398,1717115540,1142,1.2795495108977248,3.8600356581931394,0.6117080062734429,0.6020202656406177
907,1717117998,1717118502,504,0.6284214575894291,3.5452502878761476,0.5492316171861746,0.3816611545259222
908,1717121598,1717125198,3600,0.42030535865915186,3.0307089677820986,0.1,0.1
909,1717125198,1717127714,2516,1.6545599772826294,4.303374144465897,0.523344111464127,0.4746569889441514
910,1717128798,1717132398,3600,0.29874673493423587,3.018293575535586,0.1,0.1
911,1717132398,1717135998,3600,0.10881630416453142,3.194063400843369,0.1,0.1
912,1717135998,1717137238,1240,1.18199604072947,4.1730598106580965,0.7782807408855624,0.4169218432185393
913,1717139598,1717140601,1003,1.0501961023867863,3.920611849622017,0.4888898816071945,0.6510836417707604
914,1717143198,1717145195,1997,1.7995052259517215,4.4340680763028315,0.15296367289466906,0.687021897750401
915,1717146798,1717149910,3112,2.298331706670443,4.3517948916251346,0.8344748101334957,0.492753594392335
916,1717150398,1717153998,3600,0.14854216716977942,3.0117987983912133,0.1,0.1
917,1717153998,1717157598,3600,0.40694663500730577,3.098788940868242,0.1,0.1
918,1717157598,1717160451,2853,2.2262508347824523,4.618611616257049,0.11851650205116485,0.47186772770219765
919,1717161198,1717161957,759,1.325114965683936,4.043544668305698,0.9873161251171468,0.2848436236938314
920,1717164798,1717165648,850,1.4764463873676146,3.9101995131940437,0.9383720575027805,0.15569394060246197
921,1717168398,1717171998,3600,0.20013285829420913,3.1027415405056304,0.1,0.1
922,1717171998,1717175206,3208,2.1892320709830386,4.558834308765753,0.5501890322554306,0.13680352002185409
923,1717175598,1717176372,774,1.463397197834999,4.114817833406637,0.5823512407723637,0.5958660005073053
924,1717179198,1717182798,3600,0.35451406113936146,3.1529615315491655,0.1,0.1
925,1717182798,1717185961,3163,2.4997564634327007,4.583839443855196,0.2004673321615114,0.4382797739970332
926,1717186398,1717189643,3245,1.9719948616162273,4.683433593903265,0.9671090266851127,0.6846978445985569
927,1717189998,1717192818,2820,2.3973758429090997,4.444956333239074,0.9209266835306524,0.37473504361927146
928,1717193598,1717195227,1629,1.1383027802583912,4.098433580372153,0.26788977028300476,0.5813726443052354
929,1717197198,1717200798,3600,0.2727926494258444,3.0124494829807857,0.1,0.1
930,1717200798,1717204398,3600,0.28561290338030876,3.1123159170271104,0.1,0.1
931,1717204398,1717207255,2857,1.736508129104859,4.513477597000955,0.528764117267109,0.8336306705664704
932,1717207998,1717210358,2360,2.281828859326719,4.68134292818208,0.8468254477336973,0.9155161984400407
933,1717211598,1717215198,3600,0.43004375362709335,3.13600360677446,0.1,0.1
934,1717215198,1717218798,3600,0.48836577948367166,3.050547250959672,0.1,0.1
935,1717218798,1717222289,3491,1.9108636719015346,4.31191740063407,0.1088383315521238,0.7551317523902764
936,1717222398,1717225168,2770,1.7308940374497064,4.48382453702616,0.4222686553560886,0.4310099995250102
937,1717225998,1717228930,2932,2.286359716289728,4.459537827027495,0.4302494466785496,0.6815364812320404
938,1717229598,1717233198,3600,0.38865843198753736,3.1108684806529716,0.1,0.1
939,1717233198,1717234436,1238,1.2617309763753612,3.904164369989785,0.5664123014389338,0.8699794474947721
940,1717236798,1717239100,2302,2.188811149136966,4.5250248106432895,0.12988533197684277,0.6234893401090302
941,1717240398,1717243998,3600,0.1915173805088987,3.17590295112185,0.1,0.1
942,1717243998,1717245841,1843,1.8911434476118385,4.6968875025108385,0.5891211942308457,0.8111326314769529
943,1717247598,1717251198,3600,0.4443188099572759,3.1523481654087058,0.1,0.1
944,1717251198,1717252609,1411,1.2514555349676404,3.8360784492981392,0.2135173308459402,0.199177127063221
945,1717254798,1717258398,3600,0.434944335027186,3.1293136908330172,0.1,0.1
946,1717258398,1717260423,2025,2.190300356214297,4.473645101688182,0.7612136090353889,0.8213847291762296
947,1717261998,1717265598,3600,0.1522744241147616,3.1400290484378335,0.1,0.1
948,1717265598,1717266473,875,1.3031034736051477,3.8470301043068784,0.20499329384180726,0.5589954626496295
949,1717269198,1717272798,3600,0.4883320236890345,3.046145630364176,0.1,0.1
950,1717272798,1717276398,3600,0.33648741662379256,3.041678875993206,0.1,0.1
951,1717276398,1717279998,3600,0.3557514942486417,3.0494412816492655,0.1,0.1
952,1717279998,1717283004,3006,1.975557585299693,4.307706184638392,0.6954425757700619,0.49065335389497833
953,1717283598,1717287198,3600,0.20630899283767157,3.1083414411610395,0.1,0.1
954,1717287198,1717287556,358,0.8371607643617301,3.6085070267083053,0.25183584146883803,0.2020161734055386
955,1717290798,1717294398,3600,0.37610795026209565,3.1735674090722807,0.1,0.1
956,1717294398,1717297998,3600,0.4798520282882749,3.0052774394579354,0.1,0.1
957,1717297998,1717301581,3583,1.7449315031999482,4.654964302221235,0.6826136296721661,0.5788060883755062
958,1717301598,1717303600,2002,2.4427070466824077,4.421804640304553,0.2606430461617112,0.8783532255679187
959,1717305198,1717306136,938,1.033813949952866,4.190286995489062,0.8097744239282232,0.23245016530719145
960,1717308798,1717309087,289,0.7291069323261737,3.3886862416343275,0.9755033433185399,0.9898538111349835
961,1717312398,1717315998,3600,0.13214640503785896,3.020305624710712,0.1,0.1
962,1717315998,1717319598,3600,0.36972708734276194,3.0711602684975685,0.1,0.1
963,1717319598,1717320977,1379,1.380279585775277,4.031581439195247,0.5327149328324766,0.8803474816117824
964,1717323198,1717326798,3600,0.18091699595266808,3.0323081843785986,0.1,0.1
965,1717326798,1717330398,3600,0.49319028149919086,3.0724814619922625,0.1,0.1
966,1717330398,1717330827,429,0.7712455818247433,3.554441072513502,0.5862304190529672,0.5340438958155691
967,1717333998,1717335416,1418,1.1399603375338783,3.822429371431878,0.3685264335802073,0.8962070005844638
968,1717337598,1717341198,3600,0.16920750887376318,3.1270939382455505,0.1,0.1
969,1717341198,1717344798,3600,0.46632707562947806,3.0600241293102344,0.1,0.1
970,1717344798,1717348398,3600,0.13332634645531427,3.1464342575705064,0.1,0.1
971,1717348398,1717351998,3600,0.354054304507865,3.082348982280713,0.1,0.1
972,1717351998,1717352081,83,0.7999472572403223,3.413150660062907,0.6112665348342857,0.6026230260423784
973,1717355598,1717359198,3600,0.2743130029405372,3.022606242379567,0.1,0.1
974,1717359198,1717361976,2778,2.2396299380110096,4.619406435841926,0.6957161867535067,0.2823711480873336
975,1717362798,1717364648,1850,2.3311606993223255,4.648020436552299,0.18103625980473925,0.8794626486065066
976,1717366398,1717369720,3322,2.3081813606513846,4.341134330439165,0.2044047510195347,0.5653006717288441
977,1717369998,1717373598,3600,0.12144464342696533,3.1763687832780017,0.1,0.1
978,1717373598,1717377198,3600,0.3684820054744986,3.110379730911504,0.1,0.1
979,1717377198,1717377543,345,0.714680436532278,3.6037834615749507,0.5024910579442,0.7603085435091771
980,1717380798,1717384398,3600,0.3841601423842239,3.166961153635373,0.1,0.1
981,1717384398,1717387869,3471,1.958629149882852,4.50493048804833,0.7527368756501385,0.9352852592948286
982,1717387998,1717391598,3600,0.42714085884165887,3.042536118364344,0.1,0.1
983,1717391598,1717395198,3600,0.10456257457189927,3.1934069430108964,0.1,0.1
984,1717395198,1717395373,175,0.5072234778985676,3.58319306296597,0.77474471762815,0.1548479945585788
985,1717398798,1717401191,2393,1.6449155602190553,4.6123999612565045,0.7616762723578678,0.9133953057192582
986,1717402398,1717403834,1436,1.1274880696893312,4.003620347607889,0.7842990941542852,0.4092215727583468
987,1717405998,1717409598,3600,0.28465998188228664,3.132125802491187,0.1,0.1
988,1717409598,1717412583,2985,1.535296336419262,4.68772950141297,0.25038726179857085,0.7682706931753178
989,1717413198,1717416798,3600,0.14946158336011425,3.151727962783057,0.1,0.1
990,1717416798,1717417575,777,1.176369182588347,4.0658568125916394,0.5295995841041993,0.4320000994228589
991,1717420398,1717421821,1423,1.3702746119668046,3.9558220653349934,0.9931000657783671,0.3037556517899913
992,1717423998,1717427598,3600,0.1736926264641529,3.0639219751829048,0.1,0.1
993,1717427598,1717431198,3600,0.29828171334149245,3.022369171474784,0.1,0.1
994,1717431198,1717434798,3600,0.21351514292094495,3.0124199254454385,0.1,0.1
995,1717434798,1717438398,3600,0.39982791407188134,3.1046955083520804,0.1,0.1
996,1717438398,1717441998,3600,0.32776899181723385,3.0006337298000822,0.1,0.1
997,1717441998,1717445598,3600,0.25202745232608825,3.1232017506761776,0.1,0.1
998,1717445598,1717449198,3600,0.40866506043801964,3.1936289163367357,0.1,0.1
999,1717449198,1717452798,3600,0.40530068030232236,3.0323486252707923,0.1,0.1
1000,1717452798,1717455741,2943,1.763781692454741,4.4165700536328085,0.9263263435898752,0.7522061945248388
1001,1717456398,1717459998,3600,0.33889081491099715,3.1481296208885214,0.1,0.1
1002,1717459998,1717463598,3600,0.4536486636066509,3.093628138644886,0.1,0.1
1003,1717463598,1717467198,3600,0.12086493375178771,3.0744777551864253,0.1,0.1
1004,1717467198,1717467560,362,0.5468945266183534,3.6699960481305753,0.19810732327328706,0.9128580219330569
1005,1717470798,1717471153,355,0.538878229048547,3.329109972497699,0.899556100791697,0.14508391745328053
1006,1717474398,1717477998,3600,0.4814207787691721,3.08535502131873,0.1,0.1
1007,1717477998,1717478379,381,0.7005195905092002,3.4595784686461344,0.40435254931871667,0.6332454861292607
1008,1717481598,1717483305,1707,1.0074063489198124,3.8115277211770753,0.9449240473101003,0.9798289789811613
1009,1717485198,1717488798,3600,0.44789578397950247,3.112144522169113,0.1,0.1
1010,1717488798,1717490727,1929,1.5939260467037517,4.577870902077953,0.8010748187862154,0.6051062173452285
1011,1717492398,1717495998,3600,0.3036565300954369,3.0327783194265074,0.1,0.1
1012,1717495998,1717499598,3600,0.3735484123370477,3.1762362167285545,0.1,0.1
1013,1717499598,1717503198,3600,0.373423152864542,3.178257331706586,0.1,0.1
1014,1717503198,1717506798,3600,0.13415865812900474,3.0268567599846246,0.1,0.1
1015,1717506798,1717507082,284,0.9696595277208809,3.6791624454454723,0.883626695995991,0.60587500758935
1016,1717510398,1717513998,3600,0.4279209383367303,3.130436514372355,0.1,0.1
1017,1717513998,1717517598,3600,0.33368936062672494,3.1183151844256543,0.1,0.1
1018,1717517598,1717521198,3600,0.1576588888539608,3.197362708724128,0.1,0.1
1019,1717521198,1717521773,575,0.7651282215819406,3.3924360563264173,0.5767065713919581,0.5987439469235253
1020,1717524798,1717525542,744,1.4518184083153773,3.8494467461024886,0.6751178497488383,0.5177532878476591
1021,1717528398,1717531998,3600,0.3407597275736255,3.1780547651878295,0.1,0.1
1022,1717531998,1717535562,3564,1.9416418601128487,4.524983026284037,0.9101192889234423,0.226713325227168
1023,1717535598,1717539198,3600,0.25778803110151294,3.1419942948674002,0.1,0.1
1024,1717539198,1717542798,3600,0.4518851459068267,3.0639418115032466,0.1,0.1
1025,1717542798,1717546398,3600,0.26694419321200935,3.042726002748088,0.1,0.1
1026,1717546398,1717549998,3600,0.13935302164806995,3.0084555388809604,0.1,0.1
1027,1717549998,1717553598,3600,0.183875661846041,3.197251315347003,0.1,0.1
1028,1717553598,1717553816,218,0.548094188966818,3.677712919638811,0.6334767430843373,0.8918878827835763
1029,1717557198,1717560798,3600,0.3297793236719134,3.1140185030498855,0.1,0.1
1030,1717560798,1717562577,1779,1.402993036053111,4.104959563538887,0.5099898422384841,0.5550680718267755
1031,1717564398,1717567998,3600,0.1568416507504029,3.129697474953503,0.1,0.1
1032,1717567998,1717569279,1281,1.0623964096052918,4.105036138279898,0.1424181929016355,0.5035921552202964
1033,1717571598,1717572701,1103,1.1508081047437575,4.012252848951269,0.6525539324401042,0.9815921397242254
1034,1717575198,1717577425,2227,1.6887698327060314,4.518843351638748,0.7363989387910408,0.969113879575225
1035,1717578798,1717579400,602,1.1278825115073672,4.153955773245736,0.48418486843234043,0.4613433806570748
1036,1717582398,1717585998,3600,0.10439578241408838,3.1752368434525855,0.1,0.1
1037,1717585998,1717589598,3600,0.16100773486312772,3.062061772859027,0.1,0.1
1038,1717589598,1717593198,3600,0.44344057933325265,3.143054060315299,0.1,0.1
1039,1717593198,1717594704,1506,1.1051134604086954,4.101783346840083,0.5368414933459502,0.10946912797507992
1040,1717596798,1717600398,3600,0.13237392417728897,3.146183207948972,0.1,0.1
1041,1717600398,1717601556,1158,1.428595134112406,4.079883264669581,0.8694272504890961,0.44460432937408256
1042,1717603998,1717606709,2711,2.4553952176518603,4.3552766573978365,0.6207558910062737,0.16524277981848856
1043,1717607598,1717611198,3600,0.13406119893203053,3.0922482503764503,0.1,0.1
1044,1717611198,1717612720,1522,1.4650375054732467,4.059946737479622,0.7318029805772588,0.6484444866189677
1045,1717614798,1717618284,3486,1.5505149834671255,4.32960199004515,0.8131934685252763,0.732773593651952
1046,1717618398,1717621778,3380,1.8235982655525578,4.393278183051952,0.6658206382114861,0.8311515192957489
1047,1717621998,1717625598,3600,0.35122715571973084,3.163873627173493,0.1,0.1
1048,1717625598,1717629178,3580,2.1875691020381742,4.381950675454528,0.17862569348983248,0.3797370257259003
1049,1717629198,1717630449,1251,1.2932765379083553,3.891425965640134,0.8640867334346062,0.6226765771598313
1050,1717632798,1717636398,3600,0.2534779516326249,3.0335381147323823,0.1,0.1
1051,1717636398,1717639998,3600,0.47428833397344183,3.121099409747449,0.1,0.1
1052,1717639998,1717643598,3600,0.4959122769298975,3.1238941872882053,0.1,0.1
1053,1717643598,1717647198,3600,0.17204748832518157,3.0339693019598672,0.1,0.1
1054,1717647198,1717650798,3600,0.18577521463999536,3.1102298282563474,0.1,0.1
1055,1717650798,1717651385,587,0.8375463407283286,3.3767707839551395,0.43290614605221733,0.20612126942594672
1056,1717654398,1717656394,1996,2.2428676169859,4.502175697318398,0.3050632212862078,0.24060631991242765
1057,1717657998,1717661598,3600,0.42990435516432435,3.0518789381551246,0.1,0.1
1058,1717661598,1717661949,351,0.8090756769642597,3.629642808325144,0.9916026369294922,0.24129454115645765
1059,1717665198,1717667240,2042,2.1942642530242695,4.380598794890241,0.44224580638648736,0.6182017605085541
1060,1717668798,1717672398,3600,0.4208653958232643,3.0144431521633255,0.1,0.1
1061,1717672398,1717675998,3600,0.2713059814623968,3.145224684021775,0.1,0.1
1062,1717675998,1717679549,3551,2.3285770555298466,4.304467056470741,0.5350816780352452,0.48524133930280033
1063,1717679598,1717683106,3508,1.5937385914035214,4.496710701102961,0.890444854408437,0.19648337959796286
1064,1717683198,1717686629,3431,2.1642332092919476,4.607601073093056,0.9920584262975676,0.30158641637394645
1065,1717686798,1717688088,1290,1.2686355098146094,4.13272733624668,0.9272170271484573,0.258591217130978
1066,1717690398,1717690574,176,0.7084724317998367,3.675658148497039,0.7839786884299913,0.4909602268264288
1067,1717693998,1717696577,2579,2.00737924730418,4.631859628384293,0.33364235047999746,0.5892673747378934
1068,1717697598,1717700540,2942,1.9842872665852864,4.493847688543149,0.4314046595249553,0.33948391398138844
1069,1717701198,1717703687,2489,2.2842250530001484,4.478064526507798,0.3352096365373891,0.7114699679194362
1070,1717704798,1717708398,3600,0.48417088038908696,3.004644206648106,0.1,0.1
1071,1717708398,1717711998,3600,0.16464854123662223,3.0049964406239047,0.1,0.1
1072,1717711998,1717712250,252,0.712445760956105,3.5003093904435545,0.48931581498210697,0.4146651774236637
1073,1717715598,1717718486,2888,2.2220287661832865,4.587785632012279,0.9540421034075826,0.377160564533383
1074,1717719198,1717722798,3600,0.10858770570276409,3.031168446935403,0.1,0.1
1075,1717722798,1717726398,3600,0.21323953279872626,3.0888258247789557,0.1,0.1
1076,1717726398,1717729946,3548,2.047078259321723,4.547981680107983,0.7820605621143658,0.7933402776031194
1077,1717729998,1717731356,1358,1.2898275293468888,3.972427454035384,0.13145500723811426,0.5297075096506986
1078,1717733598,1717737198,3600,0.4054614901003283,3.12694686362485,0.1,0.1
1079,1717737198,1717740798,3600,0.24035302451496002,3.056388673495911,0.1,0.1
1080,1717740798,1717744398,3600,0.4871227763639224,3.1361610397995676,0.1,0.1
1081,1717744398,1717746034,1636,1.0328252972013603,4.057718049515275,0.7862302214054665,0.7119626734294098
1082,1717747998,1717748459,461,0.6692761058561287,3.310435854576943,0.8339061501733822,0.30673866173485376
1083,1717751598,1717755198,3600,0.41243097325019307,3.004250103007689,0.1,0.1
1084,1717755198,1717756626,1428,1.4738055829699563,4.060720418409524,0.8943280961229653,0.4333635885120515
1085,1717758798,1717759556,758,1.2034771825300896,4.0315982915969215,0.48918063824380065,0.9389314817464754
1086,1717762398,1717765572,3174,2.4288720497395246,4.366135417702237,0.3389486975757018,0.25500606425381717
1087,1717765998,1717769598,3600,0.3054190369404305,3.0633751714590094,0.1,0.1
1088,1717769598,1717773198,3600,0.1937886583612668,3.1634745964062834,0.1,0.1
1089,1717773198,1717776798,3600,0.25295781494959174,3.102486275001565,0.1,0.1
1090,1717776798,1717780398,3600,0.16198834877804225,3.10815350754671,0.1,0.1
1091,1717780398,1717783011,2613,2.4928178247597463,4.3406286795593445,0.19255621768016745,0.3722285631843114
1092,1717783998,1717787598,3600,0.29665791238205924,3.0276021017992405,0.1,0.1
1093,1717787598,1717791198,3600,0.20364739486897623,3.1333741611381885,0.1,0.1
1094,1717791198,1717792370,1172,1.3866548375280938,4.1437570658259375,0.9338597634021764,0.8137774389115346
1095,1717794798,1717795807,1009,1.1595294756343255,3.9608103688305207,0.5772092938031574,0.15402648374000358
1096,1717798398,1717800813,2415,1.544390658556044,4.3989330494445005,0.43212409910722105,0.22175789032022844
1097,1717801998,1717805194,3196,1.9125944829244979,4.409131779800772,0.4093093788953054,0.9302562505136198
1098,1717805598,1717809198,3600,0.3654720493815591,3.1745679286258186,0.1,0.1
1099,1717809198,1717812798,3600,0.27446823090977135,3.0218542168359654,0.1,0.1
1100,1717812798,1717812881,83,0.993148549155944,3.370692273751043,0.38070038896772607,0.2173621560865085
1101,1717816398,1717819998,3600,0.4933123093470061,3.0281927687176795,0.1,0.1
1102,1717819998,1717823598,3600,0.2686661674220341,3.16379263639323,0.1,0.1
1103,1717823598,1717827068,3470,2.4422598597372036,4.599030384036152,0.7003292687646907,0.16714896899565157
1104,1717827198,1717830798,3600,0.41931667622449253,3.0533494444022966,0.1,0.1
1105,1717830798,1717834253,3455,2.2721761516713217,4.351779120263035,0.6370636185106576,0.5913780739164899
1106,1717834398,1717837998,3600,0.3287237039011025,3.0144498705608567,0.1,0.1
1107,1717837998,1717839907,1909,1.567617617295953,4.3593192675678125,0.15081741774674529,0.9173806449192181
1108,1717841598,1717845198,3600,0.4477577946481378,3.073850251936766,0.1,0.1
1109,1717845198,1717848798,3600,0.15682820234743478,3.0173633825339605,0.1,0.1
1110,1717848798,1717852398,3600,0.277657848111891,3.0170416586448225,0.1,0.1
1111,1717852398,1717854908,2510,1.5180503693202057,4.48128623347357,0.769007849465769,0.6873238400993134
1112,1717855998,1717857504,1506,1.4961858499132124,4.044722155140634,0.5306216377644684,0.1867234604307775
1113,1717859598,1717861646,2048,2.140863736579808,4.662940681237893,0.834388637766912,0.9091345419024598
1114,1717863198,1717866371,3173,1.614616708536324,4.342052540104744,0.7422881311759844,0.47282924935768067
1115,1717866798,1717870398,3600,0.366560851687888,3.0904235035945553,0.1,0.1
1116,1717870398,1717871738,1340,1.2520585137755913,3.982542817483303,0.7372636333910537,0.12068266766120472
1117,1717873998,1717875459,1461,1.3403043636241336,3.940603456809768,0.48852546687892573,0.6245028758667179
1118,1717877598,1717881130,3532,2.4287063303699377,4.609266445051683,0.8289553854219042,0.26018678702146325
1119,1717881198,1717884798,3600,0.379830786374187,3.1478608392750904,0.1,0.1
1120,1717884798,1717888398,3600,0.3682869786838122,3.0936563024020116,0.1,0.1
1121,1717888398,1717890527,2129,2.169556900113143,4.411726091382064,0.19170474434023033,0.5862072826911755
1122,1717891998,1717895598,3600,0.21328411337744202,3.061416761495867,0.1,0.1
1123,1717895598,1717896786,1188,1.2236770467698355,4.0417569829694875,0.232756835908804,0.8510591711016121
1124,1717899198,1717901012,1814,2.197764068297649,4.385420848222353,0.2667931788533272,0.4477943667250601
1125,1717902798,1717906398,3600,0.15745055220891016,3.087646656774473,0.1,0.1
1126,1717906398,1717907582,1184,1.0609853863730063,3.8899482880471514,0.4187707916382313,0.7581103639645025
1127,1717909998,1717913598,3600,0.2539717339901367,3.0017354457927956,0.1,0.1
1128,1717913598,1717914467,869,1.2895569369491353,3.897359616845143,0.42117852473557804,0.9939914135967756
1129,1717917198,1717920798,3600,0.3217455046528379,3.185857858443035,0.1,0.1
1130,1717920798,1717923529,2731,2.1577011140247206,4.465825121513421,0.13490917848391643,0.2535364716879587
1131,1717924398,1717924682,284,0.9647891152131746,3.6618303099552683,0.5403701655769751,0.2670746114822864
1132,1717927998,1717931598,3600,0.2403082234187763,3.0783248331348734,0.1,0.1
1133,1717931598,1717933581,1983,1.7151105731131546,4.679475946544487,0.5484030831206355,0.25198838097388265
1134,1717935198,1717938798,3600,0.17364525612308113,3.018896978754488,0.1,0.1
1135,1717938798,1717939490,692,1.2314360758122098,4.042736633565287,0.8531889967461238,0.49633904784810023
1136,1717942398,1717945503,3105,1.5837407897335276,4.641608468879218,0.5633273391349354,0.2364458046532814
1137,1717945998,1717948715,2717,1.867047124280501,4.547062645368293,0.14251348311462037,0.9444901697690643
1138,1717949598,1717953198,3600,0.3271609457456537,3.0987058965542977,0.1,0.1
1139,1717953198,1717954237,1039,1.2489786613858587,3.9725349306661673,0.35345056828422383,0.8865602735582454
1140,1717956798,1717958902,2104,2.4289055001965685,4.575676827434957,0.5042546338832415,0.7507430088149314
1141,1717960398,1717962681,2283,2.2400486218057,4.573490845646553,0.7071584054489942,0.24692142524817676
1142,1717963998,1717965957,1959,2.452074931635712,4.320094223004128,0.5706296251074613,0.2824880347588235
1143,1717967598,1717971198,3600,0.3555138592270283,3.1220607963441487,0.1,0.1
1144,1717971198,1717972320,1122,1.417379548848802,4.164142128536256,0.8771640583813597,0.9073335241418464
1145,1717974798,1717978398,3600,0.2711425001797152,3.127821090593219,0.1,0.1
1146,1717978398,1717981998,3600,0.41636975543153065,3.1230871399584372,0.1,0.1
1147,1717981998,1717982251,253,0.8346875026141054,3.666248112503334,0.9172156807719349,0.40696845746622545
1148,1717985598,1717989198,3600,0.15756775998652747,3.0743668938923996,0.1,0.1
1149,1717989198,1717992798,3600,0.47422217569101077,3.0864461924591415,0.1,0.1
1150,1717992798,1717996398,3600,0.3552967661184271,3.1996869291714884,0.1,0.1
1151,1717996398,1717999998,3600,0.24958915092733736,3.134069783439736,0.1,0.1
1152,1717999998,1718002510,2512,1.7564535870279763,4.390229432958079,0.15579524674573147,0.1748934259761592
1153,1718003598,1718005939,2341,2.297556393608032,4.633010063685215,0.9945546094869372,0.24588470312055688
1154,1718007198,1718010798,3600,0.4711753605849388,3.067263355020929,0.1,0.1
1155,1718010798,1718011760,962,1.2843313384129016,3.8103026208236073,0.28415342180728453,0.43909775530750816
1156,1718014398,1718017998,3600,0.24437837990027875,3.1782376384050837,0.1,0.1
1157,1718017998,1718021598,3600,0.4335651255738896,3.0136680353232377,0.1,0.1
1158,1718021598,1718025198,3600,0.29288163716818993,3.141919265549682,0.1,0.1
1159,1718025198,1718028798,3600,0.18323612940970282,3.146955375299358,0.1,0.1
1160,1718028798,1718032398,3600,0.46446419046054876,3.1152389014847555,0.1,0.1
1161,1718032398,1718035998,3600,0.45820903128383017,3.1979861187494167,0.1,0.1
1162,1718035998,1718039185,3187,1.9703965334622162,4.560988498691216,0.9756113113247891,0.7113035922019362
1163,1718039598,1718043198,3600,0.4312394681474462,3.13129034714335,0.1,0.1
1164,1718043198,1718046798,3600,0.49389510658868474,3.0036498324381107,0.1,0.1
1165,1718046798,1718049032,2234,2.2088209839742583,4.44056418348098,0.437619420039417,0.6345965950308547
1166,1718050398,1718053998,3600,0.33037025133326653,3.0496108383320206,0.1,0.1
1167,1718053998,1718057598,3600,0.3108559086719228,3.156505503510485,0.1,0.1
1168,1718057598,1718059234,1636,1.4646172077749462,3.807037911339014,0.458658134678696,0.13503149037096832
1169,1718061198,1718062383,1185,1.0812808409789052,4.124490508245891,0.10079708128168462,0.3927925790948663
1170,1718064798,1718068393,3595,1.6524835574687464,4.46241327705179,0.5232009072210135,0.977561939475778
1171,1718068398,1718070655,2257,2.4199460773723045,4.514794176681199,0.2298877953742058,0.380144646861556
1172,1718071998,1718072393,395,0.5069582498947844,3.3395972584387703,0.22447240833347953,0.355913749287469
1173,1718075598,1718079198,3600,0.14866415021190094,3.0262114143791012,0.1,0.1
1174,1718079198,1718082798,3600,0.35252009512383375,3.0886689060864674,0.1,0.1
1175,1718082798,1718086398,3600,0.26296761116529355,3.0670397925950477,0.1,0.1
1176,1718086398,1718089998,3600,0.3809816688072315,3.0911167808121713,0.1,0.1
1177,1718089998,1718091658,1660,1.0799075153084439,4.090366925710923,0.9088686515430415,0.4485240496272702
1178,1718093598,1718097198,3600,0.4780108274805829,3.168914889403821,0.1,0.1
1179,1718097198,1718100798,3600,0.3041149036333116,3.136914278146468,0.1,0.1
1180,1718100798,1718102653,1855,2.100587734352254,4.480999661549549,0.5971144426796539,0.6248770084550372
1181,1718104398,1718107998,3600,0.2945574261478001,3.0295970676652977,0.1,0.1
1182,1718107998,1718110898,2900,1.7095974940507743,4.512354750587559,0.837712230163265,0.3948007461392762
1183,1718111598,1718115198,3600,0.47278832561030815,3.1982543635470226,0.1,0.1
1184,1718115198,1718117368,2170,2.4508842226788268,4.512361346272752,0.8588080555581851,0.7310484367363307
1185,1718118798,1718121393,2595,1.5338187379957673,4.408712713764604,0.2982898811733144,0.4169315802404262
1186,1718122398,1718125998,3600,0.44048187168632225,3.0405120246787907,0.1,0.1
1187,1718125998,1718129598,3600,0.4720203837211555,3.088853574737275,0.1,0.1
1188,1718129598,1718133198,3600,0.4281470665885936,3.046885715919454,0.1,0.1
1189,1718133198,1718134292,1094,1.4062051578600845,4.171189896414688,0.6468688203945597,0.6511468523955978
1190,1718136798,1718140130,3332,2.444119110864978,4.536091339705413,0.6766042129581431,0.12845992704171638
1191,1718140398,1718143998,3600,0.42767317187175347,3.189458564895332,0.1,0.1
1192,1718143998,1718147576,3578,2.3876753611787462,4.4675120578118,0.3173545396961917,0.7146577243335812
1193,1718147598,1718151198,3600,0.3339645312350725,3.014670366820385,0.1,0.1
1194,1718151198,1718153146,1948,1.6469436538382092,4.409704228868917,0.8517216723831412,0.6187102147444707
1195,1718154798,1718156609,1811,1.621518105006177,4.685561209179008,0.5536436224318705,0.20731277841379242
1196,1718158398,1718161035,2637,1.5057781857870687,4.577643342044273,0.544633660672224,0.15004884410247327
1197,1718161998,1718165598,3600,0.3050820749891404,3.068683975380652,0.1,0.1
1198,1718165598,1718169198,3600,0.2922406619778669,3.1643267132027404,0.1,0.1
1199,1718169198,1718172798,3600,0.4885908916698738,3.095121412037653,0.1,0.1
1200,1718172798,1718176398,3600,0.1621396790013095,3.0419060452056597,0.1,0.1
1201,1718176398,1718179998,3600,0.31584252666267143,3.1911815939618755,0.1,0.1
1202,1718179998,1718183598,3600,0.3653187071567475,3.0264049050543154,0.1,0.1
1203,1718183598,1718184539,941,1.4585955913344435,4.186327932606646,0.7653744445633135,0.25546285803037544
1204,1718187198,1718190798,3600,0.13049117243753627,3.0801244178475287,0.1,0.1
1205,1718190798,1718194398,3600,0.22209495775641186,3.0122906979806854,0.1,0.1
1206,1718194398,1718197998,3600,0.44860159361029095,3.0601845107698713,0.1,0.1
1207,1718197998,1718201598,3600,0.49975020472676124,3.14414749911999,0.1,0.1
1208,1718201598,1718204761,3163,2.304979311534872,4.618920636096951,0.20654070883626122,0.7586860617033463
1209,1718205198,1718207973,2775,2.2992153714779846,4.574960387668901,0.23362845653341222,0.6227446810217657
1210,1718208798,1718212398,3600,0.3576995174654751,3.1269724231458915,0.1,0.1
1211,1718212398,1718215998,3600,0.35379799564304515,3.1894172326577577,0.1,0.1
1212,1718215998,1718219274,3276,2.463206232443275,4.312992314680865,0.34595911989560907,0.6168507152179942
1213,1718219598,1718220984,1386,1.2006528460037014,4.059391508726128,0.3320251551780576,0.13351094819450923
1214,1718223198,1718223460,262,0.5083788006119064,3.6726094232692112,0.2790672366491074,0.9410997276314055
1215,1718226798,1718228538,1740,1.352501897378405,4.112298302007929,0.9960066979136379,0.18881791358751027
1216,1718230398,1718233998,3600,0.14902863771866115,3.1389059887025725,0.1,0.1
1217,1718233998,1718234756,758,1.4761014167424653,3.8832263558795463,0.3845674948617942,0.40733782315813927
1218,1718237598,1718241198,3600,0.38873388727395664,3.0444023226134242,0.1,0.1
1219,1718241198,1718244447,3249,1.595005500095863,4.668583907070908,0.8960290222203305,0.48315323949002864
1220,1718244798,1718246102,1304,1.3798218412961716,4.044728702486955,0.586260044198399,0.7242849890076017
1221,1718248398,1718251998,3600,0.15706246985252934,3.062785337760159,0.1,0.1
1222,1718251998,1718255598,3600,0.3328508367906222,3.0691149097189494,0.1,0.1
1223,1718255598,1718259047,3449,2.096197766534374,4.578996782501783,0.6565911550001872,0.847794456673882
1224,1718259198,1718260533,1335,1.258370591692325,4.092108428874165,0.6028721567163642,0.897897689393573
1225,1718262798,1718266398,3600,0.3371256563889583,3.1264456106649443,0.1,0.1
1226,1718266398,1718267872,1474,1.098686870101711,3.970539766055695,0.7111861376814851,0.28189941480501707
1227,1718269998,1718273598,3600,0.12220075434952893,3.0563253051521686,0.1,0.1
1228,1718273598,1718273977,379,0.9783980065162099,3.3867970984779476,0.18604575923486733,0.5190404328973766
1229,1718277198,1718280798,3600,0.38099806571726347,3.0012898403432935,0.1,0.1
1230,1718280798,1718283802,3004,1.7157621758536181,4.57471005358154,0.8309483616398432,0.56539306228628
1231,1718284398,1718287998,3600,0.4813340346298266,3.1315245816841584,0.1,0.1
1232,1718287998,1718290909,2911,2.285576318936943,4.319239979077077,0.9924447299149125,0.5088729044216526
1233,1718291598,1718292034,436,0.6623962999101893,3.368404559356217,0.6929999985350194,0.39036158024408596
1234,1718295198,1718298798,3600,0.3608017497588113,3.028442808280414,0.1,0.1
1235,1718298798,1718302398,3600,0.1981282355992574,3.0940982101592813,0.1,0.1
1236,1718302398,1718305998,3600,0.4966437538924521,3.0928601570312226,0.1,0.1
1237,1718305998,1718309598,3600,0.2521880652914433,3.0948820748636034,0.1,0.1
1238,1718309598,1718311987,2389,2.1211876486833114,4.4497931307227425,0.10450848180509348,0.5219090581814568
1239,1718313198,1718316798,3600,0.2833424752099538,3.0621129993173772,0.1,0.1
1240,1718316798,1718320398,3600,0.164646502228521,3.0247939706419777,0.1,0.1
1241,1718320398,1718322978,2580,1.800308724822917,4.5154312119470745,0.35831130480771123,0.8301162128313019
1242,1718323998,1718327598,3600,0.4456133491830985,3.0695980389491395,0.1,0.1
1243,1718327598,1718330065,2467,1.8852530000678756,4.690316622136228,0.8727057626792432,0.8433385020248201
1244,1718331198,1718334798,3600,0.35500896420526096,3.07222701282212,0.1,0.1
1245,1718334798,1718338398,3600,0.202248720048558,3.031335743604997,0.1,0.1
1246,1718338398,1718340752,2354,2.0331238681227006,4.4704156686439065,0.4800615655239516,0.4249669374663747
1247,1718341998,1718343904,1906,1.9376766485206995,4.670188853016913,0.8734138428069623,0.5994431993158774
1248,1718345598,1718349198,3600,0.1681909186983083,3.0653670678119975,0.1,0.1
1249,1718349198,1718352798,3600,0.3771918235086029,3.0851216929231344,0.1,0.1
1250,1718352798,1718356200,3402,2.3013479316945267,4.319395520448537,0.7104849000731365,0.1772460348767006
1251,1718356398,1718359998,3600,0.39345396764401264,3.025736981181666,0.1,0.1
1252,1718359998,1718363598,3600,0.1188195481060622,3.109501417298825,0.1,0.1
1253,1718363598,1718365864,2266,1.9519937084729568,4.513020753486287,0.5177448749191595,0.1635547931194733
1254,1718367198,1718370798,3600,0.21703708332620872,3.0719582468119255,0.1,0.1
1255,1718370798,1718373479,2681,2.4718399584845394,4.525601316478038,0.48002069916735557,0.67896149101589
1256,1718374398,1718377998,3600,0.10624926218671411,3.074526098246608,0.1,0.1
1257,1718377998,1718380127,2129,2.003319208440828,4.57976595756647,0.4633255478024292,0.3024671671707059
1258,1718381598,1718385198,3600,0.1533340925654692,3.1913170707238163,0.1,0.1
1259,1718385198,1718386350,1152,1.4977311146356036,3.9554125445530195,0.9464368682695674,0.3608852812824076
1260,1718388798,1718392016,3218,1.928776876120871,4.329453997548787,0.9658358821800687,0.9914434537384333
1261,1718392398,1718395998,3600,0.12910175190519946,3.052300539321287,0.1,0.1
1262,1718395998,1718399598,3600,0.14158939879197008,3.1035550169491097,0.1,0.1
1263,1718399598,1718402644,3046,2.245663162581932,4.588014234976438,0.38067128810657624,0.3853654981099891
1264,1718403198,1718406798,3600,0.12255746135834666,3.0648207258565647,0.1,0.1
1265,1718406798,1718408219,1421,1.0230706685723323,4.161450688357222,0.8477108628575702,0.9174838608360169
1266,1718410398,1718413183,2785,1.7239593975664893,4.544858666785764,0.8091980995257448,0.12191993820549771
1267,1718413998,1718415530,1532,1.14583828210818,4.176180088152903,0.9226674723239106,0.211446022596099
1268,1718417598,1718421198,3600,0.42921199729857207,3.059770852443201,0.1,0.1
1269,1718421198,1718424798,3600,0.14719854237103602,3.029051263020355,0.1,0.1
1270,1718424798,1718428288,3490,2.0922130646476407,4.671463914321461,0.7660666163544477,0.4099180142231629
1271,1718428398,1718431998,3600,0.19110982031568002,3.075543350213657,0.1,0.1
1272,1718431998,1718432350,352,0.7646049085616138,3.301883355382007,0.13585646327191464,0.4732267372556562
1273,1718435598,1718438597,2999,2.1357726355527697,4.5725454150698095,0.446983280747865,0.4316935476131246
1274,1718439198,1718442798,3600,0.4756031199678813,3.028101715995726,0.1,0.1
1275,1718442798,1718445139,2341,1.952421698676862,4.634977044083998,0.1352316243137674,0.2409945422741414
1276,1718446398,1718447986,1588,1.2373125976826365,3.9021019682360882,0.667186559041136,0.7902437019472897
1277,1718449998,1718452533,2535,1.5523749481236098,4.327496509799937,0.12220871818313167,0.6130440923367206
1278,1718453598,1718455854,2256,1.809769562937868,4.443599783395511,0.9188324353241013,0.14732595221539502
1279,1718457198,1718458768,1570,1.3816129770415544,4.136260544584613,0.7162270905879115,0.7993986882354287
1280,1718460798,1718464398,3600,0.2787960163072463,3.0114955688353806,0.1,0.1
1281,1718464398,1718467998,3600,0.3662116844772617,3.177974032531235,0.1,0.1
1282,1718467998,1718468687,689,1.019342073100717,3.804117739484378,0.5635894322474623,0.1437152373297366
1283,1718471598,1718475198,3600,0.4228678753913314,3.076882112472344,0.1,0.1
1284,1718475198,1718477871,2673,2.3606648375168513,4.542519716227767,0.6798798047732337,0.18621269352319164
1285,1718478798,1718482398,3600,0.4768694801034984,3.1489569120292153,0.1,0.1
1286,1718482398,1718485998,3600,0.14199982392172933,3.1815510050188127,0.1,0.1
1287,1718485998,1718489598,3600,0.17067969521858123,3.080092501444047,0.1,0.1
1288,1718489598,1718490893,1295,1.2691163389917375,4.0252989938878,0.5979611394719102,0.6758051140146691
1289,1718493198,1718496078,2880,2.3308877083410193,4.4559283670024925,0.7553724400185843,0.3065243935129016
1290,1718496798,1718499013,2215,1.7656036991545518,4.623680390396658,0.7010856863566249,0.9020959230729263
1291,1718500398,1718503998,3600,0.122228357243743,3.141970413352095,0.1,0.1
1292,1718503998,1718507598,3600,0.11715445533577143,3.137844913275638,0.1,0.1
1293,1718507598,1718509355,1757,1.454590653969639,3.935635456736043,0.810724113956986,0.831747132188825
1294,1718511198,1718514798,3600,0.44370904944660416,3.0109243659752942,0.1,0.1
1295,1718514798,1718518145,3347,1.681810565703275,4.4277396318865865,0.7611161314542839,0.8139698310198877
1296,1718518398,1718518701,303,0.5388196083996432,3.674816517232518,0.12925273636725468,0.6810697695882987
1297,1718521998,1718523381,1383,1.1255962414699605,4.185038748879793,0.4773538482292301,0.26711367575404577
1298,1718525598,1718529198,3600,0.3143869402891713,3.0180210867051303,0.1,0.1
1299,1718529198,1718532798,3600,0.24777816853125847,3.0986060222198453,0.1,0.1
1300,1718532798,1718536398,3600,0.11971197810595924,3.012724600976963,0.1,0.1
1301,1718536398,1718539998,3600,0.38007857393297073,3.0814817247819812,0.1,0.1
1302,1718539998,1718543186,3188,2.407208060943482,4.489428807541048,0.4030365128331359,0.47550713170976877
1303,1718543598,1718546747,3149,2.1479014256044318,4.511039910525538,0.634086790035068,0.6628294813221709
1304,1718547198,1718550798,3600,0.13759583725547425,3.0185873709071513,0.1,0.1
1305,1718550798,1718552520,1722,1.047670472719078,4.001524878378736,0.4075408357986753,0.893089269107314
1306,1718554398,1718557998,3600,0.12193885065814124,3.167835550379191,0.1,0.1
1307,1718557998,1718560694,2696,1.796539329658102,4.676534460668531,0.7643212265157692,0.3329215207983035
1308,1718561598,1718565198,3600,0.3802271847435186,3.1019992082554975,0.1,0.1
1309,1718565198,1718567086,1888,1.8990618373757604,4.684064409263209,0.5144639723106683,0.5486530371780263
1310,1718568798,1718572398,3600,0.42405219131832417,3.0029794623053196,0.1,0.1
1311,1718572398,1718575998,3600,0.3404933460656556,3.191643273820667,0.1,0.1
1312,1718575998,1718579598,3600,0.13995436812169487,3.061647629710685,0.1,0.1
1313,1718579598,1718583198,3600,0.1932999868011454,3.0997666254381264,0.1,0.1
1314,1718583198,1718586798,3600,0.3713746051890635,3.1056340649320084,0.1,0.1
1315,1718586798,1718589352,2554,2.339542250999438,4.452465669147456,0.13314125491353349,0.6147615469059413
1316,1718590398,1718591521,1123,1.0433876331481737,4.075369176420235,0.7506813255357152,0.10768007374029903
1317,1718593998,1718595494,1496,1.4702083755293147,4.022579253604432,0.9367822268114111,0.160798153278904
1318,1718597598,1718601198,3600,0.4617751785850396,3.1313974933254274,0.1,0.1
1319,1718601198,1718604798,3600,0.24660925975321893,3.071350885327709,0.1,0.1
1320,1718604798,1718608398,3600,0.340212561456321,3.097579810730546,0.1,0.1
1321,1718608398,1718611056,2658,2.267427360298564,4.525938254340793,0.4211874073197893,0.42175359058499395
1322,1718611998,1718615598,3600,0.2308671902835347,3.1504514752129897,0.1,0.1
1323,1718615598,1718618297,2699,2.450423474356373,4.614981673483866,0.5669708830716244,0.3082961392033977
1324,1718619198,1718621710,2512,1.6470553617354906,4.36160401657255,0.4627210116852566,0.521209983134493
1325,1718622798,1718625029,2231,1.641953223766523,4.53871576880903,0.6427189480383564,0.6932030709787416
1326,1718626398,1718626793,395,0.654310119910368,3.4637268182241923,0.1004279358361383,0.9944594029168712
1327,1718629998,1718630978,980,1.2482914387370831,3.8623385909632035,0.8987924475291261,0.4479911607048126
1328,1718633598,1718637198,3600,0.42044475724065256,3.135119707732822,0.1,0.1
1329,1718637198,1718640798,3600,0.3802348757048032,3.039611996870922,0.1,0.1
1330,1718640798,1718642823,2025,1.9070582597465853,4.542696286663055,0.5851794664264318,0.14103998797377057
1331,1718644398,1718647998,3600,0.2420075010634656,3.0531912999191126,0.1,0.1
1332,1718647998,1718651598,3600,0.2693550546977016,3.071292754024709,0.1,0.1
1333,1718651598,1718655198,3600,0.19204278703404923,3.0325421342138363,0.1,0.1
1334,1718655198,1718658798,3600,0.12776146339206515,3.0728271534303953,0.1,0.1
1335,1718658798,1718662398,3600,0.39751011741043596,3.1914951037274046,0.1,0.1
1336,1718662398,1718663323,925,1.1555812484220458,4.05337345842516,0.7071894859811625,0.7980868267626302
1337,1718665998,1718668447,2449,1.5591567685648173,4.4395896316404695,0.11416906189747644,0.7249138065099184
1338,1718669598,1718673198,3600,0.46778001356326104,3.184509698908542,0.1,0.1
1339,1718673198,1718676798,3600,0.19897706766341297,3.0679600396267084,0.1,0.1
1340,1718676798,1718680398,3600,0.3876103352434851,3.083988377439951,0.1,0.1
1341,1718680398,1718683738,3340,1.9114930303735176,4.375546092476002,0.36973655806679395,0.5677880134964055
1342,1718683998,1718687598,3600,0.22055702514610676,3.035601738473346,0.1,0.1
1343,1718687598,1718689623,2025,2.1418796677810663,4.365110146685748,0.20758230856816406,0.30707805335508115
1344,1718691198,1718694798,3600,0.42648348429427285,3.170806557185245,0.1,0.1
1345,1718694798,1718698398,3600,0.14705706748118522,3.0958963993613255,0.1,0.1
1346,1718698398,1718701679,3281,2.141970028360652,4.551130546592101,0.735574127259883,0.13241086819114578
1347,1718701998,1718705598,3600,0.43024736177823686,3.103389448804151,0.1,0.1
1348,1718705598,1718709198,3600,0.45460745639072586,3.0096858226767536,0.1,0.1
1349,1718709198,1718712798,3600,0.10171608554759307,3.0105934506761782,0.1,0.1
1350,1718712798,1718714053,1255,1.3172432442411273,3.9305284487228076,0.12274628288089065,0.3012590558776262
1351,1718716398,1718717449,1051,1.2323480724846922,4.087771550839513,0.9907310047707483,0.8399055513569557
1352,1718719998,1718723598,3600,0.49135905863296514,3.1962100993690776,0.1,0.1
1353,1718723598,1718727198,3600,0.4075418908167293,3.111580130752048,0.1,0.1
1354,1718727198,1718729480,2282,1.788343133746892,4.430772363859594,0.8493959430420438,0.17102296248178173
1355,1718730798,1718730911,113,0.8333440415235663,3.4652475058478704,0.5082798519272937,0.8649417463401025
1356,1718734398,1718737998,3600,0.1240331814297257,3.1756077428470757,0.1,0.1
1357,1718737998,1718741337,3339,1.9711803924307405,4.697662680541158,0.28339042736929515,0.12836319978833244
1358,1718741598,1718743865,2267,1.9800304830509674,4.382244427808809,0.7899008515478183,0.30376491891313995
1359,1718745198,1718748798,3600,0.2016866924215108,3.12338408290753,0.1,0.1
1360,1718748798,1718752398,3600,0.14858251397832054,3.0013340621264497,0.1,0.1
1361,1718752398,1718754041,1643,1.1718108625724957,3.808397892858043,0.7459597573396227,0.6019496247046077
1362,1718755998,1718758201,2203,1.727757556842608,4.3440472125566085,0.15429640336435063,0.6712394282453177
1363,1718759598,1718762563,2965,1.5219050893349264,4.6536595030126735,0.7020402409751426,0.8322038291195567
1364,1718763198,1718765821,2623,2.2394790452502535,4.597635185581553,0.7304976825202074,0.19401900435884512
1365,1718766798,1718770398,3600,0.3710425564478963,3.0644748431739064,0.1,0.1
1366,1718770398,1718773998,3600,0.23494477088133692,3.0867755287871055,0.1,0.1
1367,1718773998,1718776117,2119,1.6558922496917248,4.4643068418514416,0.9022050471609491,0.705248010232595
1368,1718777598,1718781198,3600,0.21924566769843612,3.0379979175367424,0.1,0.1
1369,1718781198,1718784798,3600,0.4493922877281128,3.115039533449965,0.1,0.1
1370,1718784798,1718788398,3600,0.48052200085302454,3.134416560730722,0.1,0.1
1371,1718788398,1718790795,2397,2.0864784623888966,4.5324895547614625,0.32776510682827165,0.22503284571111362
1372,1718791998,1718795598,3600,0.19888722793608965,3.0977964801545443,0.1,0.1
1373,1718795598,1718799198,3600,0.22282470464586968,3.058729680280788,0.1,0.1
1374,1718799198,1718802798,3600,0.44383041864164285,3.1072764884125346,0.1,0.1
1375,1718802798,1718803064,266,0.7587340428852376,3.605030651411275,0.4629804806365372,0.47516667014373004
1376,1718806398,1718806563,165,0.9302824867458157,3.5175303722954636,0.4082393710884661,0.7444722861618768
1377,1718809998,1718810091,93,0.9889182176622462,3.42138597864986,0.2882961280848816,0.36559872429627516
1378,1718813598,1718815121,1523,1.0360122928018372,3.8079323299776284,0.18091797949763544,0.5926469036097913
1379,1718817198,1718817631,433,0.8325883777521224,3.686412184270222,0.8480550516328859,0.449184880019177
1380,1718820798,1718824398,3600,0.39356560572221677,3.018659807150108,0.1,0.1
1381,1718824398,1718827998,3600,0.24418314797573426,3.0344758753066663,0.1,0.1
1382,1718827998,1718831598,3600,0.4068025008884132,3.149346509494277,0.1,0.1
1383,1718831598,1718833962,2364,2.2922755669685926,4.580561538186055,0.2951723828136311,0.5445008404201339
1384,1718835198,1718836185,987,1.4062871234588292,3.9512293221900725,0.2053726668544906,0.7530053289439524
1385,1718838798,1718842398,3600,0.4618215795357772,3.1710095812734878,0.1,0.1
1386,1718842398,1718843851,1453,1.3756731773751711,4.062050769794103,0.617066358563442,0.11895287327693363
1387,1718845998,1718849598,3600,0.34883455372556305,3.073324584179706,0.1,0.1
1388,1718849598,1718850708,1110,1.4503254488745572,4.188556287040912,0.3609966402063882,0.4446642808624256
1389,1718853198,1718853900,702,1.4106416418236483,3.9149824217655262,0.3295030581153209,0.8114444155228937
1390,1718856798,1718860398,3600,0.15541524179038024,3.1867284490336893,0.1,0.1
1391,1718860398,1718863587,3189,1.6052236357133918,4.456289952800899,0.38591978423505857,0.3750208792731321
1392,1718863998,1718865013,1015,1.1498415493845473,3.9311235626665546,0.8830806963825755,0.6671590274235142
1393,1718867598,1718870544,2946,1.7664872612773275,4.6893903137194055,0.49619212506842736,0.4241832712732677
1394,1718871198,1718874798,3600,0.2086079310686588,3.0345634499777736,0.1,0.1
1395,1718874798,1718876601,1803,2.3852678754693426,4.5691264123994335,0.5388928512450123,0.27259022459536597
1396,1718878398,1718881687,3289,1.7218725134177646,4.5440724891325015,0.377364318433552,0.24245192735876325
1397,1718881998,1718885598,3600,0.17028635331456676,3.0699194955523295,0.1,0.1
1398,1718885598,1718889198,3600,0.29091667224184825,3.1482784363118492,0.1,0.1
1399,1718889198,1718891068,1870,2.3349425267908286,4.623098766398498,0.7030998984902188,0.790243742273628
1400,1718892798,1718896398,3600,0.3093960403945112,3.066165879762881,0.1,0.1
1401,1718896398,1718899998,3600,0.21189346406768453,3.1726338624370256,0.1,0.1
1402,1718899998,1718900774,776,1.2457238630115368,3.9540411793664028,0.2140623140297792,0.9247001968615778
1403,1718903598,1718903978,380,0.8198515621156519,3.684654062281962,0.6214538585994681,0.3476807885641687
1404,1718907198,1718910798,3600,0.13867650568519277,3.0640544732940227,0.1,0.1
1405,1718910798,1718911055,257,0.9001877405834271,3.3837584694769,0.1020038804736855,0.9263299291911592
1406,1718914398,1718917998,3600,0.26288387903578947,3.065425031650538,0.1,0.1
1407,1718917998,1718921598,3600,0.25181317939073844,3.1695733754357764,0.1,0.1
1408,1718921598,1718923594,1996,2.3410133300273595,4.607696530377152,0.18932020010983414,0.46651739980358875
1409,1718925198,1718928798,3600,0.11563694247074872,3.0910627339886205,0.1,0.1
1410,1718928798,1718932376,3578,2.485018979933317,4.617018237484811,0.2988394740807936,0.7467300249462037
1411,1718932398,1718935998,3600,0.13021577637607457,3.0818970410151607,0.1,0.1
1412,1718935998,1718937612,1614,1.1949952307686411,3.9011512660538963,0.5571830615023893,0.86857163858793
1413,1718939598,1718943198,3600,0.3612561475234196,3.1140605438229016,0.1,0.1
1414,1718943198,1718946798,3600,0.418545994340635,3.104138425955927,0.1,0.1
1415,1718946798,1718949123,2325,2.4833777333334117,4.553952802357176,0.5252184017347448,0.8942857411798748
1416,1718950398,1718953998,3600,0.288940937140227,3.0304180521404698,0.1,0.1
1417,1718953998,1718956691,2693,2.133182278233869,4.537193170881289,0.20134555280422786,0.8640435855732346
1418,1718957598,1718961067,3469,1.6779096484862666,4.605712794437414,0.9748566370965348,0.9948678618888053
1419,1718961198,1718963274,2076,2.314740329126224,4.599481779687216,0.9607390311742541,0.9479272763509168
1420,1718964798,1718968398,3600,0.10086592076379836,3.1889796767832053,0.1,0.1
1421,1718968398,1718971998,3600,0.4984730318905741,3.0180062777123604,0.1,0.1
1422,1718971998,1718975598,3600,0.4795085804261934,3.1691565506707433,0.1,0.1
1423,1718975598,1718979198,3600,0.18748668898670082,3.162119782161392,0.1,0.1
1424,1718979198,1718982798,3600,0.49493712876171214,3.0206734813184672,0.1,0.1
1425,1718982798,1718986398,3600,0.11979011584697795,3.0584825593846134,0.1,0.1
1426,1718986398,1718989519,3121,1.5503754527441567,4.467281985939377,0.6449454467219554,0.9283344638050103
1427,1718989998,1718993598,3600,0.21283262993813878,3.1416489205308697,0.1,0.1
1428,1718993598,1718995266,1668,1.4503264573773647,4.114742178253232,0.8633404051016456,0.6776790951027304
1429,1718997198,1719000798,3600,0.1162904721916882,3.0589582396555968,0.1,0.1
1430,1719000798,1719001716,918,1.2555017160924573,4.135441178167628,0.22714191549496704,0.8971919732132454
1431,1719004398,1719006149,1751,1.0980674800987573,3.9867637368195448,0.2425823883965233,0.7616123047161856
1432,1719007998,1719011598,3600,0.3057170408346557,3.120888299155159,0.1,0.1
1433,1719011598,1719013439,1841,1.6231210219759675,4.679126581209735,0.9728429476626713,0.4191588715342206
1434,1719015198,1719018798,3600,0.17042281564060863,3.1893252659576103,0.1,0.1
1435,1719018798,1719022072,3274,2.108000342805883,4.4854600712161785,0.7965200543165442,0.15934014320299894
1436,1719022398,1719024258,1860,2.4577771801673816,4.312959629491018,0.7887527968183043,0.11579937764226075
1437,1719025998,1719026418,420,0.7237986138264136,3.3514590777882507,0.6144726329062966,0.664434315972122
1438,1719029598,1719032385,2787,1.6386092793626843,4.500795574001687,0.36589045873440695,0.9453629872834038
1439,1719033198,1719036798,3600,0.16832199991407695,3.1114943111457447,0.1,0.1
1440,1719036798,1719037453,655,1.3149809997336597,3.933706870917583,0.34109847523882014,0.7810168011519283
1441,1719040398,1719043998,3600,0.11119917173391279,3.0478058456047377,0.1,0.1
1442,1719043998,1719047598,3600,0.2715969495167235,3.116077921549689,0.1,0.1
1443,1719047598,1719051198,3600,0.3055618345529909,3.1360844337393767,0.1,0.1
1444,1719051198,1719054292,3094,2.4135286422867477,4.432747998320773,0.7637578919428833,0.6460545788463943
1445,1719054798,1719057858,3060,1.502926580568396,4.630056064596597,0.7086564013219537,0.9878271514635921
1446,1719058398,1719061998,3600,0.42368453956522456,3.1657902611462188,0.1,0.1
1447,1719061998,1719065598,3600,0.15015181125617594,3.147113183472107,0.1,0.1
1448,1719065598,1719067659,2061,1.854084025439002,4.5067488699281375,0.5440186312302073,0.5814328979257251
1449,1719069198,1719072798,3600,0.4571243696599685,3.0677601515314126,0.1,0.1
1450,1719072798,1719074239,1441,1.0384061375808993,4.069787709100196,0.9881114372828547,0.9623520233173118
1451,1719076398,1719078023,1625,1.4796370228408924,3.8662979813533256,0.6520485884526948,0.7283225018000762
1452,1719079998,1719082249,2251,2.456753580837491,4.611117703855799,0.4498883484362938,0.17668767911735256
1453,1719083598,1719083921,323,0.9155730930978347,3.59534853610308,0.376236187233986,0.7631610022109642
1454,1719087198,1719090798,3600,0.2471953803654167,3.0009517722776327,0.1,0.1
1455,1719090798,1719091850,1052,1.2616252720591723,3.9987368690211422,0.48037991635186805,0.9571971995882714
1456,1719094398,1719094857,459,0.8191488274132497,3.6979970146195833,0.6534597439710847,0.3297456740197564
1457,1719097998,1719100797,2799,2.111148502378157,4.526264354459453,0.9181292042954996,0.8767324392796019
1458,1719101598,1719104697,3099,1.7988746420199013,4.55111944360568,0.1500184816355467,0.42624563653718506
1459,1719105198,1719108798,3600,0.2842029093021748,3.0159451971780613,0.1,0.1
1460,1719108798,1719112398,3600,0.42100899010075643,3.101078996987834,0.1,0.1
1461,1719112398,1719115998,3600,0.312922801490694,3.0625884092511177,0.1,0.1
1462,1719115998,1719116768,770,1.444984097262284,3.9035317972272034,0.15495616373717405,0.1830585272793106
1463,1719119598,1719123198,3600,0.4752230067333587,3.1885316917675564,0.1,0.1
1464,1719123198,1719126798,3600,0.12446157805289292,3.058594402447434,0.1,0.1
1465,1719126798,1719130398,3600,0.2803161404049792,3.1779026758292797,0.1,0.1
1466,1719130398,1719133998,3600,0.1875475375946053,3.1419453670511244,0.1,0.1
1467,1719133998,1719137598,3600,0.4215737069685851,3.0460626724880133,0.1,0.1
1468,1719137598,1719141198,3600,0.23517851685189345,3.1686373415225457,0.1,0.1
1469,1719141198,1719144798,3600,0.2999424078626649,3.008726953056738,0.1,0.1
1470,1719144798,1719147582,2784,1.9787452067114981,4.444169909415573,0.4444946535256882,0.2004648826599772
1471,1719148398,1719151998,3600,0.475925164729316,3.060270956084968,0.1,0.1
1472,1719151998,1719155598,3600,0.4646727711365026,3.0857139268657154,0.1,0.1
1473,1719155598,1719159063,3465,1.9131615631149663,4.575774319677984,0.3126832947352465,0.10365662070738467
1474,1719159198,1719161144,1946,2.4417860935851743,4.314038125287692,0.3652284567805576,0.5359406690359699
1475,1719162798,1719163286,488,0.6453552588858671,3.307783941013649,0.5724272578274903,0.7098455174504295
1476,1719166398,1719168347,1949,1.58434622723103,4.672381482388525,0.3633479015041561,0.2662554118821624
1477,1719169998,1719172506,2508,2.1681667785324445,4.664668789728087,0.7507624377004228,0.4981716032474385
1478,1719173598,1719177198,3600,0.10521317767842678,3.1063662336094535,0.1,0.1
1479,1719177198,1719180798,3600,0.14999425205237032,3.1198238057772967,0.1,0.1
1480,1719180798,1719183256,2458,1.8177323998613697,4.494673717402882,0.8755438953363951,0.6846954789140793
1481,1719184398,1719187142,2744,2.3655729140494515,4.504716346170183,0.7957654702800656,0.8703347311809377
1482,1719187998,1719191598,3600,0.37190938295762244,3.1527786607281847,0.1,0.1
1483,1719191598,1719195198,3600,0.3498272732627217,3.1334167033502407,0.1,0.1
1484,1719195198,1719198025,2827,2.274104152475616,4.599284988209077,0.4940874622717645,0.9842842230704038
1485,1719198798,1719199739,941,1.3285968775572927,3.9919687124717447,0.46106514516149455,0.5242641591441068
1486,1719202398,1719205050,2652,2.3186909540856058,4.5897639120411355,0.460579174295324,0.4122162526579901
1487,1719205998,1719207063,1065,1.3144426986706508,3.8480391927550612,0.208568544581756,0.21081853961827934
1488,1719209598,1719213198,3600,0.4277364072172465,3.05707672963284,0.1,0.1
1489,1719213198,1719216798,3600,0.2746774170756602,3.148783119351506,0.1,0.1
1490,1719216798,1719220398,3600,0.19922889384018885,3.111315893585649,0.1,0.1
1491,1719220398,1719221454,1056,1.2949773493296417,4.059549077301817,0.9477749118486238,0.5317406313530479
1492,1719223998,1719227598,3600,0.45843594418350553,3.051150499682611,0.1,0.1
1493,1719227598,1719231198,3600,0.4151709232508475,3.128078001202955,0.1,0.1
1494,1719231198,1719231594,396,0.6180072633839673,3.3018716124706047,0.313970258181703,0.1849632103588682
1495,1719234798,1719235273,475,0.9849881343988656,3.350058812168637,0.6522144632859206,0.24067830632712492
1496,1719238398,1719241998,3600,0.3189485840015466,3.0994862157029868,0.1,0.1
1497,1719241998,1719242240,242,0.5102627760802725,3.6651692708958565,0.16780324411158282,0.42074685257736355
1498,1719245598,1719249198,3600,0.4179068539183629,3.084214804453413,0.1,0.1
1499,1719249198,1719250744,1546,1.0051662361723206,3.9902121492924896,0.6620012001738379,0.37467394678212174
1500,1719252798,1719255557,2759,2.420174466935051,4.6190056968772275,0.33974705650808623,0.462561598415983
1501,1719256398,1719258686,2288,1.8358368418955289,4.638252242577965,0.6935989474665635,0.7107597238222331
1502,1719259998,1719260551,553,0.8431620223161644,3.429638325433233,0.7236723486363114,0.6305989210353434
1503,1719263598,1719267198,3600,0.45224429346980555,3.037864993773282,0.1,0.1
1504,1719267198,1719270798,3600,0.1461386106268615,3.176781466854219,0.1,0.1
1505,1719270798,1719274398,3600,0.49302245803736044,3.156188016900447,0.1,0.1
1506,1719274398,1719277998,3600,0.16483366011841696,3.16714676054659,0.1,0.1
1507,1719277998,1719281598,3600,0.22407427327428076,3.089705865624472,0.1,0.1
1508,1719281598,1719282051,453,0.6054055673808811,3.494741903278089,0.8513801354414596,0.8354192754130526
1509,1719285198,1719288798,3600,0.25778291768667627,3.0171656384439327,0.1,0.1
1510,1719288798,1719292398,3600,0.31490475315485744,3.022470587049166,0.1,0.1
1511,1719292398,1719295998,3600,0.471603629838903,3.0687978345783815,0.1,0.1
1512,1719295998,1719297494,1496,1.4977619973050074,3.8789078564978747,0.49968653094918014,0.3043128064571773
1513,1719299598,1719301488,1890,1.7184121150421992,4.337326381461285,0.8026402492494246,0.5707971911804041
1514,1719303198,1719306798,3600,0.4055055831156994,3.006592283235159,0.1,0.1
1515,1719306798,1719310398,3600,0.3686466443386467,3.1210139160829824,0.1,0.1
1516,1719310398,1719310916,518,0.9594688402016963,3.458439762373948,0.8732752336269787,0.22468968625948615
1517,1719313998,1719317598,3600,0.28849958285997573,3.076115554889539,0.1,0.1
1518,1719317598,1719319265,1667,1.308588485492676,3.9796067060746956,0.6615036694282074,0.864149248195809
1519,1719321198,1719323611,2413,1.9507422497364864,4.433463741529006,0.8072339602020497,0.35368359361409185
1520,1719324798,1719327183,2385,2.3472479048828987,4.412684796888067,0.6187692919617237,0.847931213900511
1521,1719328398,1719331998,3600,0.23576566546455224,3.1388293591418117,0.1,0.1
1522,1719331998,1719335598,3600,0.3011575525864983,3.084897489251309,0.1,0.1
1523,1719335598,1719337687,2089,2.1842245610679667,4.517760581627758,0.7770172615164328,0.36739400788204724
1524,1719339198,1719342798,3600,0.3555367290260726,3.173743109155325,0.1,0.1
1525,1719342798,1719346398,3600,0.20299598606671132,3.086000340624983,0.1,0.1
1526,1719346398,1719347818,1420,1.3721460525061184,3.988384042016932,0.30690695047687727,0.45455276160102986
1527,1719349998,1719350252,254,0.5556714844664999,3.6241235571008446,0.8987096843298643,0.9950773779251746
1528,1719353598,1719357198,3600,0.18940507618210278,3.184682214192021,0.1,0.1
1529,1719357198,1719358861,1663,1.002280747045285,3.804764521610837,0.9121638962619335,0.3104941940349334
1530,1719360798,1719364398,3600,0.18672854936701755,3.153094201593779,0.1,0.1
1531,1719364398,1719367828,3430,1.8280479887054022,4.360315818458656,0.37625015317124855,0.8608632023723455
1532,1719367998,1719371598,3600,0.27826763325400994,3.0399390901142804,0.1,0.1
1533,1719371598,1719372789,1191,1.0604589337109647,3.834004869892388,0.7964971279277034,0.44084530376412767
1534,1719375198,1719378776,3578,2.2286925414775993,4.556177894730259,0.7600907921535736,0.5713294259131899
1535,1719378798,1719382398,3600,0.12358439540231494,3.198876190449383,0.1,0.1
1536,1719382398,1719385494,3096,2.1927073844725986,4.558800724628451,0.24403533273307737,0.9544728720145876
1537,1719385998,1719389598,3600,0.439734954702213,3.1628310218445654,0.1,0.1
1538,1719389598,1719393198,3600,0.3743732853343109,3.171058910439434,0.1,0.1
1539,1719393198,1719396798,3600,0.252492401304547,3.02508971627785,0.1,0.1
1540,1719396798,1719398344,1546,1.0667740025908867,3.8928255736259656,0.7614663642926597,0.597289010625038
1541,1719400398,1719401027,629,1.3555704818999923,3.8640939487037707,0.6579770369490608,0.5812519472236337
1542,1719403998,1719404276,278,0.5640671610861079,3.4983962178075805,0.8924803269044486,0.5011246174290191
1543,1719407598,1719411198,3600,0.3214517213863112,3.117648860491963,0.1,0.1
1544,1719411198,1719414798,3600,0.11210634921928651,3.0770164440795256,0.1,0.1
1545,1719414798,1719416867,2069,1.8627685770659652,4.391683248445672,0.17924336172980077,0.8281983760622749
1546,1719418398,1719421998,3600,0.20717662107441603,3.1736748223664315,0.1,0.1
1547,1719421998,1719423543,1545,1.2074183740431197,3.963450045256637,0.7624294924383398,0.9696736897573659
1548,1719425598,1719426909,1311,1.3767190643080605,4.135143725063982,0.23236699772430833,0.9775310121312926
1549,1719429198,1719431863,2665,1.8465133431671044,4.64374988757459,0.6164114696517241,0.48842536287822624
1550,1719432798,1719436398,3600,0.33969636376054313,3.0384953928276945,0.1,0.1
1551,1719436398,1719436953,555,0.5547289092039539,3.577330484460577,0.28255644616305775,0.389029373539029
1552,1719439998,1719443598,3600,0.4174664594709342,3.1557809244511628,0.1,0.1
1553,1719443598,1719447198,3600,0.14208073086901396,3.034320979825823,0.1,0.1
1554,1719447198,1719450798,3600,0.38221058846635225,3.1536179736414978,0.1,0.1
1555,1719450798,1719452565,1767,1.2135595347034267,4.075501205108167,0.4338705042219603,0.7036877454714859
1556,1719454398,1719457998,3600,0.21207250320690918,3.1700971871681234,0.1,0.1
1557,1719457998,1719461294,3296,2.4300595472928035,4.568515236141692,0.4360127586424959,0.8777308016498768
1558,1719461598,1719463600,2002,2.204311532836947,4.334934554700124,0.8333970242410242,0.500707964375686
1559,1719465198,1719468798,3600,0.3196549135779049,3.0078279492885307,0.1,0.1
1560,1719468798,1719472398,3600,0.39344391865837613,3.161146627344664,0.1,0.1
1561,1719472398,1719473988,1590,1.1869178812798535,3.8416329430984364,0.4479841895838027,0.11694404990609006
1562,1719475998,1719479598,3600,0.20095778676758502,3.1074171030161435,0.1,0.1
1563,1719479598,1719483198,3600,0.2975878301463265,3.197137814249686,0.1,0.1
1564,1719483198,1719483761,563,0.8019181870488199,3.439587398886077,0.5027182111399502,0.6606107682236907
1565,1719486798,1719490398,3600,0.4174389467070272,3.1712967206922555,0.1,0.1
1566,1719490398,1719490688,290,0.9296870075274801,3.4474095403609137,0.4562450256602747,0.5535105163711336
1567,1719493998,1719494809,811,1.480282796783125,3.801431112920675,0.6548408910097991,0.40142872108412697
1568,1719497598,1719501198,3600,0.30803895526474623,3.155452618810515,0.1,0.1
1569,1719501198,1719504798,3600,0.39088267239561003,3.121850629823165,0.1,0.1
1570,1719504798,1719508398,3600,0.3219693212540145,3.111574161676773,0.1,0.1
1571,1719508398,1719510345,1947,1.6080567265560284,4.41463622181032,0.8569297496107221,0.6877815177270191
1572,1719511998,1719515279,3281,2.2213710963583164,4.3186301924051005,0.6762535044722416,0.7486346622753691
1573,1719515598,1719519198,3600,0.3414973097262034,3.1808689789213345,0.1,0.1
1574,1719519198,1719520458,1260,1.4532230926767586,3.8131778367093014,0.537528713704905,0.8838536108081513
1575,1719522798,1719526398,3600,0.45982170729343974,3.144534704756311,0.1,0.1
1576,1719526398,1719527091,693,1.0240286623926964,4.133192602560006,0.5783738226090691,0.2284229646177212
1577,1719529998,1719533598,3600,0.42326554629596735,3.174873381611693,0.1,0.1
1578,1719533598,1719537198,3600,0.3597998006622859,3.0318512275838576,0.1,0.1
1579,1719537198,1719537634,436,0.6068555700943131,3.623597326936122,0.3729101791218157,0.3593019789820664
1580,1719540798,1719542706,1908,2.092207580691077,4.418782972342856,0.5164644980691636,0.2369772626538093
1581,1719544398,1719547998,3600,0.4043142107788127,3.0010106903799607,0.1,0.1
1582,1719547998,1719551018,3020,1.593911453758017,4.578316737402826,0.9689827628021688,0.4936617612342731
1583,1719551598,1719555198,3600,0.16539225364189547,3.129705598353236,0.1,0.1
1584,1719555198,1719558798,3600,0.3744779900865537,3.074439301164502,0.1,0.1
1585,1719558798,1719562398,3600,0.17454171266892016,3.155723024872593,0.1,0.1
1586,1719562398,1719563024,626,1.0062671488363855,3.9482069579685173,0.6211042471395836,0.5283757419917567
1587,1719565998,1719569598,3600,0.26278938070022817,3.1356351363700363,0.1,0.1
1588,1719569598,1719571469,1871,2.252521754349259,4.536058052882084,0.8483764104382905,0.12578368027640205
1589,1719573198,1719576198,3000,2.2680364808043514,4.548646862440909,0.554511510162169,0.6591993037638472
1590,1719576798,1719578420,1622,1.031976174915339,4.121385602626887,0.13183866395543248,0.8989164814462494
1591,1719580398,1719581300,902,1.3563233283807477,3.8959794695141237,0.374377861078251,0.6381786482160695
1592,1719583998,1719587598,3600,0.18646168062870405,3.1134595294316116,0.1,0.1
1593,1719587598,1719588061,463,0.9713321694934045,3.521247393260414,0.5465194283448532,0.5801893129395387
1594,1719591198,1719591547,349,0.6746374307827282,3.3418445890914006,0.46061226537380573,0.38105421766872194
1595,1719594798,1719598398,3600,0.14367721380475995,3.0209385863701286,0.1,0.1
1596,1719598398,1719601998,3600,0.39852145780880377,3.0505469075314724,0.1,0.1
1597,1719601998,1719604501,2503,2.1373479827681288,4.4340066450225715,0.680607252996127,0.9670742607222296
1598,1719605598,1719606542,944,1.2933409712616444,4.178549334638184,0.44734224095049735,0.4144607817991457
1599,1719609198,1719612798,3600,0.21527252191581533,3.088187685439634,0.1,0.1
1600,1719612798,1719616398,3600,0.4817717926431223,3.0992394230263036,0.1,0.1
1601,1719616398,1719619998,3600,0.21645350910612837,3.021824015431341,0.1,0.1
1602,1719619998,1719623598,3600,0.1440764060900604,3.147576412935415,0.1,0.1
1603,1719623598,1719627132,3534,2.3192568915501046,4.325530149066894,0.4356580597033147,0.9122219699785743
1604,1719627198,1719630727,3529,1.846858082190547,4.4826505797356795,0.630996269960078,0.6024064069889618
1605,1719630798,1719634398,3600,0.2386493071126723,3.1820081156964384,0.1,0.1
1606,1719634398,1719637998,3600,0.4589174595111294,3.1971875138549355,0.1,0.1
1607,1719637998,1719638200,202,0.8675949128862388,3.482998337331375,0.3235978566620666,0.11256955654260702
1608,1719641598,1719645198,3600,0.3445403551758444,3.1434103179253965,0.1,0.1
1609,1719645198,1719645364,166,0.9860885519642668,3.339048001786982,0.2556222224512106,0.7076457315388401
1610,1719648798,1719652398,3600,0.4120265046749908,3.053132926786512,0.1,0.1
1611,1719652398,1719655012,2614,1.5582072688732995,4.5657852175452085,0.8094268938381617,0.7376136259200479
1612,1719655998,1719659598,3600,0.21252254957232394,3.0341794059558986,0.1,0.1
1613,1719659598,1719663198,3600,0.4966197525340068,3.163435991996839,0.1,0.1
1614,1719663198,1719665952,2754,1.5039940320196967,4.44503097606141,0.9398168766175744,0.21203377404597246
1615,1719666798,1719670398,3600,0.13547038403249073,3.070253130989284,0.1,0.1
1616,1719670398,1719672877,2479,1.6124160586209082,4.357462995058721,0.5185089875403964,0.7488999544830415
1617,1719673998,1719677598,3600,0.4906452302751093,3.090907514145204,0.1,0.1
1618,1719677598,1719678622,1024,1.4356877650609237,4.022409242287995,0.2737241218004811,0.5124078195310648
1619,1719681198,1719682892,1694,1.1188552133648877,4.1719939147883025,0.6225896733428704,0.5093908381430131
1620,1719684798,1719688398,3600,0.19285339173935673,3.199160016753069,0.1,0.1
1621,1719688398,1719691998,3600,0.15848666078533752,3.0045193802476895,0.1,0.1
1622,1719691998,1719695598,3600,0.21422832578542828,3.164853204942662,0.1,0.1
1623,1719695598,1719698893,3295,1.987896360458124,4.509780602703637,0.4577940259774539,0.8956690690393738
1624,1719699198,1719702798,3600,0.29149444033809235,3.14636882357766,0.1,0.1
1625,1719702798,1719703473,675,1.164689707328439,4.107141169932744,0.9729142789920614,0.2858814407691446
1626,1719706398,1719708220,1822,1.5927226129546979,4.461348878480832,0.9292716190178709,0.3747352559238468
1627,1719709998,1719712004,2006,2.0375629448808272,4.405042155933807,0.13074229159496115,0.19304571254101774
1628,1719713598,1719714702,1104,1.4566646664475054,3.8849621656782967,0.4552382239851901,0.621276648200137
1629,1719717198,1719720798,3600,0.17200460821157249,3.191069485077922,0.1,0.1
1630,1719720798,1719722573,1775,1.1007004121101716,3.8108059819090805,0.6437653730468691,0.6635240245367314
1631,1719724398,1719725583,1185,1.4083446892151215,3.9097291411717108,0.6065619112586192,0.5144476501194211
1632,1719727998,1719730335,2337,2.455378183334663,4.516104640365999,0.2659616486597218,0.478674569447911
1633,1719731598,1719733236,1638,1.2777021659116092,4.109931271676732,0.8012619037622668,0.6557164258281593
1634,1719735198,1719738798,3600,0.13976597588500247,3.0028848451527033,0.1,0.1
1635,1719738798,1719742206,3408,1.8371533504824986,4.400565363998758,0.6760571654051427,0.5320373786582293
1636,1719742398,1719744198,1800,1.893993541361421,4.351955751388688,0.8590775237374807,0.4145931549944023
1637,1719745998,1719749598,3600,0.48472465218885585,3.038423564154378,0.1,0.1
1638,1719749598,1719753198,3600,0.2633769761655328,3.1923141666591466,0.1,0.1
1639,1719753198,1719756798,3600,0.11910575943194585,3.0236181230082058,0.1,0.1
1640,1719756798,1719758411,1613,1.013785351391528,3.823230396086429,0.6342821622921958,0.24818243174621363
1641,1719760398,1719761816,1418,1.2081872634342818,4.06942606204339,0.29703669773112623,0.68813086435265
1642,1719763998,1719766439,2441,2.339480829937877,4.421909032706787,0.85618004645624,0.8875188732558914
1643,1719767598,1719771198,3600,0.10296418587555577,3.0654646192366726,0.1,0.1
1644,1719771198,1719774798,3600,0.15196842986826076,3.129513132035608,0.1,0.1
1645,1719774798,1719778398,3600,0.20518079405033035,3.0381664103651134,0.1,0.1
1646,1719778398,1719779311,913,1.20650530805504,3.804440912704509,0.8188786417427972,0.23694386727369093
1647,1719781998,1719784888,2890,1.5713404428003692,4.5319799342691995,0.15358132540143932,0.29390467601253256
1648,1719785598,1719789198,3600,0.3343597013767545,3.0319449414572412,0.1,0.1
1649,1719789198,1719792798,3600,0.4372680863091998,3.0032081208030954,0.1,0.1
1650,1719792798,1719796398,3600,0.1245236411415585,3.0631552298871694,0.1,0.1
1651,1719796398,1719799998,3600,0.13605363657322203,3.049728220193325,0.1,0.1
1652,1719799998,1719803598,3600,0.3368124872502628,3.140507967392195,0.1,0.1
1653,1719803598,1719804883,1285,1.1913468247806143,3.90317075383341,0.43099410257378523,0.6945158499542787
1654,1719807198,1719810462,3264,2.286620347952536,4.391592440974698,0.8021004431695498,0.37078786199850144
1655,1719810798,1719814398,3600,0.1040260399198957,3.122775752854981,0.1,0.1
1656,1719814398,1719815602,1204,1.0154834007889288,4.197720754653031,0.7551989103687067,0.946424678020685
1657,1719817998,1719820420,2422,1.853359371372826,4.698875875682971,0.4984555244691583,0.8253313392711278
1658,1719821598,1719825198,3600,0.10088041927045457,3.0044298121788184,0.1,0.1
1659,1719825198,1719828798,3600,0.23611394228525762,3.1032014075665884,0.1,0.1
1660,1719828798,1719832398,3600,0.31043771589327784,3.08079706494783,0.1,0.1
1661,1719832398,1719835115,2717,1.9089927982805115,4.512548908257554,0.6015947618431632,0.8070657899766822
1662,1719835998,1719839598,3600,0.45912134356978496,3.0611242884284917,0.1,0.1
1663,1719839598,1719843198,3600,0.45557056929224105,3.050693942843634,0.1,0.1
1664,1719843198,1719846798,3600,0.4242907553756944,3.1867574557630896,0.1,0.1
1665,1719846798,1719847208,410,0.6751261073554329,3.4017076771938135,0.3100464641755956,0.6118419691761985
1666,1719850398,1719852932,2534,1.5901343268894685,4.3476166833551915,0.6927968558937799,0.9217892878555585
1667,1719853998,1719857598,3600,0.13102614253402095,3.128719458193793,0.1,0.1
1668,1719857598,1719857736,138,0.5144043129786797,3.512205641819431,0.7818856079274693,0.3571969207472865
1669,1719861198,1719864790,3592,1.5862934722868718,4.672360273479585,0.20066047921627306,0.4065185893305323
1670,1719864798,1719868398,3600,0.17797106416639297,3.0486830993538008,0.1,0.1
1671,1719868398,1719868688,290,0.652175502253218,3.376806258668396,0.6233438446641867,0.6437348366565346
1672,1719871998,1719875598,3600,0.36686626847251447,3.102922178223534,0.1,0.1
1673,1719875598,1719878797,3199,2.1470387612210002,4.381292195091207,0.11124841697988447,0.8607343039339352
1674,1719879198,1719882798,3600,0.24989009660351186,3.139727450692135,0.1,0.1
1675,1719882798,1719885822,3024,2.0803045020987647,4.4830838496675005,0.8594597477098309,0.6085533650003965
1676,1719886398,1719887636,1238,1.1960219181717269,4.142154778290007,0.5304464181491509,0.21321889282978973
1677,1719889998,1719890522,524,0.9194968782415931,3.539689183579109,0.31101066155614554,0.7924114134955529
1678,1719893598,1719894837,1239,1.4793226830070545,4.153283754448721,0.4608616690663073,0.22928271324444835
1679,1719897198,1719900798,3600,0.4521464316624696,3.141766581074606,0.1,0.1
1680,1719900798,1719904102,3304,1.588613293032072,4.594037748367907,0.8511876237365844,0.6398632486764363
1681,1719904398,1719905259,861,1.4564914601737913,4.1707181276814635,0.13242861341230008,0.7163878817982253
1682,1719907998,1719909501,1503,1.3165586363618378,4.110913012506457,0.8588084995881354,0.830943087509383
1683,1719911598,1719915198,3600,0.2483421298038304,3.0615717812043983,0.1,0.1
1684,1719915198,1719918798,3600,0.4700406380044643,3.1200480939538022,0.1,0.1
1685,1719918798,1719922398,3600,0.4346660787239842,3.0613359820244215,0.1,0.1
1686,1719922398,1719925998,3600,0.21471631519327758,3.012223401185766,0.1,0.1
1687,1719925998,1719929598,3600,0.4621734177122735,3.0689303228345386,0.1,0.1
1688,1719929598,1719932625,3027,2.489945125215216,4.421833943237801,0.33389799439345635,0.8683003679250677
1689,1719933198,1719935234,2036,2.187473103011294,4.628383480176065,0.6690735192166858,0.9196824023014982
1690,1719936798,1719939656,2858,2.4711103209827376,4.544324289664218,0.45348059246726957,0.8001508179023659
1691,1719940398,1719943998,3600,0.2803056550640304,3.0660051952129947,0.1,0.1
1692,1719943998,1719947598,3600,0.26529106489035953,3.0446155489497206,0.1,0.1
1693,1719947598,1719949332,1734,1.1317332838574625,4.0348676221528015,0.17310522672197082,0.30545245888577555
1694,1719951198,1719954798,3600,0.11197931763923408,3.133452278420047,0.1,0.1
1695,1719954798,1719958291,3493,2.3553206653158734,4.344573955731766,0.5244914131166196,0.8209588116369593
1696,1719958398,1719958928,530,0.9476006140937042,3.3880277133298704,0.42135104612645746,0.6974779036507848
1697,1719961998,1719965598,3600,0.18143363720103906,3.1100475795191356,0.1,0.1
1698,1719965598,1719969198,3600,0.2544010147633278,3.05507622577208,0.1,0.1
1699,1719969198,1719972283,3085,1.898220870095605,4.611872160935194,0.7042624737788792,0.8216423907899345
1700,1719972798,1719976398,3600,0.3963773964101198,3.1592707172636354,0.1,0.1
1701,1719976398,1719979998,3600,0.4771132929348455,3.182391799241975,0.1,0.1
1702,1719979998,1719982049,2051,1.614677722623616,4.367266579563744,0.6133081565272566,0.13315391237725183
1703,1719983598,1719985134,1536,1.4626719622543338,3.9454106721992748,0.2589467828841251,0.7210662422215774
1704,1719987198,1719990798,3600,0.2686880797064326,3.015564009093886,0.1,0.1
1705,1719990798,1719994398,3600,0.29739490379891,3.172834880077978,0.1,0.1
1706,1719994398,1719997465,3067,2.393004367323103,4.407519206207723,0.514909283349363,0.9576467739316011
1707,1719997998,1720001490,3492,1.652754871498819,4.487847692561984,0.10737213240189929,0.5925690544004757
1708,1720001598,1720003932,2334,1.9856406212361435,4.511323158923846,0.4330630554877737,0.2794737229069689
1709,1720005198,1720008798,3600,0.17213221475279217,3.1355940193190652,0.1,0.1
1710,1720008798,1720010359,1561,1.202693574236502,4.1255339915394424,0.4523466906323471,0.9690348329592015
1711,1720012398,1720015998,3600,0.4854620026313744,3.1365373070455966,0.1,0.1
1712,1720015998,1720019598,3600,0.44655600978522647,3.1750012327727637,0.1,0.1
1713,1720019598,1720023198,3600,0.4092626738896604,3.0706169699553145,0.1,0.1
1714,1720023198,1720023605,407,0.6949104707738823,3.5625020545078003,0.6641930089197203,0.7616310032320143
1715,1720026798,1720027987,1189,1.4354757794464168,4.165573811775178,0.4417135081393725,0.9623039611260131
1716,1720030398,1720033998,3600,0.3070021935727869,3.058554640538236,0.1,0.1
1717,1720033998,1720035077,1079,1.3812237466694257,3.9265432242422293,0.175794361510338,0.28936178654239564
1718,1720037598,1720041198,3600,0.3488733079697881,3.0429110114313365,0.1,0.1
1719,1720041198,1720041650,452,0.86173612410939,3.6904319295767682,0.6263405291305562,0.6099966545995857
1720,1720044798,1720048398,3600,0.4735220511183993,3.1181238995981224,0.1,0.1
1721,1720048398,1720049785,1387,1.013473897258159,3.8924138286145435,0.43201809018046355,0.8642886884654247
1722,1720051998,1720055598,3600,0.21450814328024226,3.042368576593725,0.1,0.1
1723,1720055598,1720059198,3600,0.3439142389221535,3.125629898999362,0.1,0.1
1724,1720059198,1720062674,3476,2.2063567697720607,4.348844002387764,0.7664558820105952,0.22081478549605194
1725,1720062798,1720066398,3600,0.2856082349875999,3.092683368321852,0.1,0.1
1726,1720066398,1720069998,3600,0.4384900876840898,3.1244585449498286,0.1,0.1
1727,1720069998,1720073598,3600,0.13442299176172645,3.0520018035727725,0.1,0.1
1728,1720073598,1720074922,1324,1.3418426482003978,3.950387285791945,0.7861799086878544,0.3525426207707546
1729,1720077198,1720080798,3600,0.3188909645046412,3.1150856470114756,0.1,0.1
1730,1720080798,1720084398,3600,0.4075364290833686,3.0384432392101104,0.1,0.1
1731,1720084398,1720084940,542,0.8504577183584034,3.668931845881204,0.27650522922351706,0.6846028513385112
1732,1720087998,1720088747,749,1.1993624319610219,3.9203616391121687,0.9106148500640078,0.5907156484373791
1733,1720091598,1720093684,2086,1.867604257072677,4.581145173071904,0.2798209989959761,0.1832990997562561
1734,1720095198,1720098798,3600,0.24175538575631217,3.150728858426197,0.1,0.1
1735,1720098798,1720099664,866,1.154871316045199,4.1969061671431485,0.5640926332588146,0.6409049288705051
1736,1720102398,1720105998,3600,0.26316627728400266,3.0653512638569156,0.1,0.1
1737,1720105998,1720107468,1470,1.4292342059021395,3.8298635807081887,0.7213455413845093,0.6595873660810893
1738,1720109598,1720113092,3494,1.5605417124606833,4.475227759585154,0.16502020121068842,0.839754253762677
1739,1720113198,1720116798,3600,0.15174564666788048,3.199633422503855,0.1,0.1
1740,1720116798,1720120084,3286,2.1562878911228616,4.59566317609206,0.5202058032282075,0.15977276561806214
1741,1720120398,1720123998,3600,0.24795954522954183,3.0315633174245873,0.1,0.1
1742,1720123998,1720127598,3600,0.3012200549578712,3.0692110689582295,0.1,0.1
1743,1720127598,1720131198,3600,0.2570580327713595,3.1181025197051553,0.1,0.1
1744,1720131198,1720132558,1360,1.245697218620859,4.052355054384522,0.8141171629461579,0.4628382663148126
1745,1720134798,1720135571,773,1.1096815056449196,4.1522325664198005,0.6019123330572052,0.8367866123027347
1746,1720138398,1720141998,3600,0.4532600052671977,3.0185143976259736,0.1,0.1
1747,1720141998,1720145598,3600,0.15576081121022434,3.1068129720327966,0.1,0.1
1748,1720145598,1720149198,3600,0.41199345665718645,3.158170549943753,0.1,0.1
1749,1720149198,1720152154,2956,1.6302320505383758,4.5300587918896165,0.5688153688806944,0.9534943539120244
1750,1720152798,1720156398,3600,0.30085108504904456,3.01072595512642,0.1,0.1
1751,1720156398,1720159998,3600,0.3686997806488669,3.0992063242957255,0.1,0.1
1752,1720159998,1720160262,264,0.7396184661151677,3.6296115710041916,0.8869736341641311,0.4719196603770285
1753,1720163598,1720167198,3600,0.37819064426901294,3.1384396559130012,0.1,0.1
1754,1720167198,1720169905,2707,2.1165974213835606,4.345345583658886,0.3805325786345847,0.7127149941070468
1755,1720170798,1720172308,1510,1.353135866454936,3.97890866798337,0.40030847809236925,0.8529734982923692
1756,1720174398,1720177998,3600,0.3402751877985224,3.0166308766849337,0.1,0.1
1757,1720177998,1720179937,1939,1.556842408503293,4.306159561452428,0.7769421742291619,0.7284242222191382
1758,1720181598,1720185198,3600,0.2023050937343178,3.118339535652177,0.1,0.1
1759,1720185198,1720187689,2491,1.9826100845410215,4.6936577712481595,0.2328933039767307,0.6107382890753983
1760,1720188798,1720192398,3600,0.19104479682900927,3.10301724412041,0.1,0.1
1761,1720192398,1720193997,1599,1.302214801666664,3.9274024970676384,0.15769642899220734,0.36823593828148093
1762,1720195998,1720198920,2922,1.7330754328704636,4.371446808647,0.8470875516063096,0.7816231199506924
1763,1720199598,1720203198,3600,0.32688881163838623,3.159294882551715,0.1,0.1
1764,1720203198,1720206798,3600,0.3374096513265913,3.0094804335273366,0.1,0.1
1765,1720206798,1720206897,99,0.8076333795436713,3.6014441335266034,0.8704123609860849,0.8794018877214592
1766,1720210398,1720213998,3600,0.21104001799169356,3.080331003754231,0.1,0.1
1767,1720213998,1720214744,746,1.4386366353031512,4.087792406327881,0.20145471538997345,0.428316905275799
1768,1720217598,1720221198,3600,0.20065057804671438,3.027018490761103,0.1,0.1
1769,1720221198,1720224798,3600,0.2309460709715591,3.154306026336689,0.1,0.1
1770,1720224798,1720228398,3600,0.24202928075314356,3.1543140542523567,0.1,0.1
1771,1720228398,1720228676,278,0.9305050839615118,3.3281238356624576,0.41606458635175614,0.9811965878800685
1772,1720231998,1720235598,3600,0.14309564298713406,3.1447485773519195,0.1,0.1
1773,1720235598,1720237938,2340,1.9619124848040685,4.3738066510656886,0.20161732899621843,0.2808459293548762
1774,1720239198,1720242798,3600,0.18728124271228036,3.17917558895125,0.1,0.1
1775,1720242798,1720244183,1385,1.492879025751154,3.94186437300423,0.9136965656672494,0.9782324876894992
1776,1720246398,1720249998,3600,0.16501933501728586,3.1061182183903067,0.1,0.1
1777,1720249998,1720252557,2559,2.169022406976861,4.446026997101465,0.27607662501434915,0.9300030782123687
1778,1720253598,1720257198,3600,0.3941973982525778,3.1009803540443506,0.1,0.1
1779,1720257198,1720260798,3600,0.46558195863103446,3.1048448050162087,0.1,0.1
1780,1720260798,1720262222,1424,1.2661952525183555,4.009350624271348,0.8591835746968527,0.24022913498835052
1781,1720264398,1720267492,3094,1.6593879268453153,4.64130285206347,0.6631038659650392,0.8137711654059455
1782,1720267998,1720271598,3600,0.2084945675541472,3.1692575539635386,0.1,0.1
1783,1720271598,1720275198,3600,0.44915608387384387,3.1842062577437353,0.1,0.1
1784,1720275198,1720278798,3600,0.41932912539189116,3.0044489958885015,0.1,0.1
1785,1720278798,1720282398,3600,0.3064829759374226,3.033234581195069,0.1,0.1
1786,1720282398,1720284589,2191,2.1388955780117143,4.35701279540509,0.36450348297447177,0.6699134583716131
1787,1720285998,1720289489,3491,2.107746669027509,4.391371217031125,0.6272001555518185,0.15343111796692097
1788,1720289598,1720293198,3600,0.10963650978823046,3.128116387352177,0.1,0.1
1789,1720293198,1720294101,903,1.2734862281180706,4.004323012206019,0.37869737593832675,0.740926514606164
1790,1720296798,1720298354,1556,1.4687138271833724,3.837026912771503,0.8337317932547135,0.950586239770187
1791,1720300398,1720301321,923,1.2846860860441645,3.887877006810255,0.8330157523903047,0.9064199288519932
1792,1720303998,1720305373,1375,1.3054747015998345,4.033413903594384,0.6105857637770509,0.9221927354489556
1793,1720307598,1720310412,2814,2.0638318829620843,4.440226842349853,0.5852458688116079,0.48992166486038446
1794,1720311198,1720313358,2160,1.8350301385183407,4.302455456344715,0.8694301621841269,0.9480133285791934
1795,1720314798,1720318398,3600,0.2236806548714585,3.168079402340478,0.1,0.1
1796,1720318398,1720320924,2526,1.829036519612901,4.451563331513326,0.44340348603177515,0.5974156015736185
1797,1720321998,1720325228,3230,1.8874860980346895,4.529834355551441,0.4817925363053872,0.8396527239222582
1798,1720325598,1720328911,3313,2.1290344516623523,4.339165789002862,0.3022455864024899,0.33426117193355653
1799,1720329198,1720331905,2707,2.0058069785784163,4.452409466597029,0.2520886632650601,0.1557492600145574
1800,1720332798,1720336398,3600,0.20730640434182446,3.19283519835638,0.1,0.1
1801,1720336398,1720336824,426,0.9781180224869364,3.445616260259296,0.7462606170430249,0.10656738254470897
1802,1720339998,1720340295,297,0.776859746491611,3.4209900078139452,0.3170626099226347,0.30351795591180764
1803,1720343598,1720347198,3600,0.4206605549529292,3.1937730421483517,0.1,0.1
1804,1720347198,1720350798,3600,0.48876148775446804,3.1184967866251943,0.1,0.1
1805,1720350798,1720351474,676,1.1072167996978457,3.8055690916834854,0.8969960715995093,0.7306066400381255
1806,1720354398,1720357998,3600,0.15709668122548925,3.072188562947154,0.1,0.1
1807,1720357998,1720359982,1984,2.356957476948138,4.407493613176218,0.6540880476629471,0.5083609297484687
1808,1720361598,1720365198,3600,0.21773562122214868,3.0194565551106094,0.1,0.1
1809,1720365198,1720368798,3600,0.29229007346736946,3.151583223133005,0.1,0.1
1810,1720368798,1720372398,3600,0.37298689888753334,3.095148395665012,0.1,0.1
1811,1720372398,1720375835,3437,1.6398453959822064,4.455062174375979,0.3333292856571949,0.5136601124745549
1812,1720375998,1720377324,1326,1.349505541306523,3.8982914247207447,0.7732328112672426,0.572909456839006
1813,1720379598,1720381815,2217,2.3931781431956574,4.509432349402937,0.1713929702339012,0.5727222018402669
1814,1720383198,1720386798,3600,0.3144009834353231,3.083298611298395,0.1,0.1
1815,1720386798,1720387934,1136,1.4208646890788188,4.103870898249361,0.14514354310741223,0.15716337475934036
1816,1720390398,1720393407,3009,1.8308682058382812,4.409639730039065,0.8980769305951168,0.9889177292130961
1817,1720393998,1720397598,3600,0.4531658609977828,3.0500433099873967,0.1,0.1
1818,1720397598,1720400418,2820,2.1255558004307593,4.449964213673172,0.6233804015779979,0.5162962851275287
1819,1720401198,1720404798,3600,0.34485856198378073,3.037214842721108,0.1,0.1
1820,1720404798,1720407270,2472,1.7099204946876845,4.352712590215798,0.5700531454754879,0.7702133295734258
1821,1720408398,1720411998,3600,0.4717857044992384,3.0572257829835987,0.1,0.1
1822,1720411998,1720415598,3600,0.18438216509198033,3.06777894644744,0.1,0.1
1823,1720415598,1720418052,2454,1.8191579071184207,4.457481165593717,0.7364998087428334,0.37864861350277346
1824,1720419198,1720422414,3216,1.6765746439473959,4.666246133370449,0.9880167918572264,0.6084708010165422
1825,1720422798,1720426398,3600,0.4649920268829576,3.0347025970503707,0.1,0.1
1826,1720426398,1720429998,3600,0.3483386448466236,3.0260771040153824,0.1,0.1
1827,1720429998,1720433598,3600,0.29848934147987444,3.144513295995873,0.1,0.1
1828,1720433598,1720436611,3013,2.1488389070369305,4.549946596139985,0.1750078642694502,0.2194144016038766
1829,1720437198,1720440798,3600,0.42977054003407367,3.012485267330239,0.1,0.1
1830,1720440798,1720444195,3397,2.4834202670549312,4.647343859951252,0.5250127023818457,0.22226758746151817
1831,1720444398,1720445269,871,1.0125272457233596,4.171221219517107,0.7096485148109793,0.4220950354735059
1832,1720447998,1720450307,2309,1.7859959481122267,4.625784832789365,0.30231375745126937,0.5388014235072421
1833,1720451598,1720455198,3600,0.3605974883272395,3.1647635288908256,0.1,0.1
1834,1720455198,1720456838,1640,1.4362621309252246,3.8633453107646174,0.38030500290722447,0.8254688880970815
1835,1720458798,1720462398,3600,0.10946078695825467,3.0025977179568497,0.1,0.1
1836,1720462398,1720465998,3600,0.34519030348857627,3.0153747706475484,0.1,0.1
1837,1720465998,1720467870,1872,1.7759720738282876,4.448998387573225,0.4213038442997544,0.9040786809884006
1838,1720469598,1720473198,3600,0.2568549231692877,3.1721611023271787,0.1,0.1
1839,1720473198,1720473621,423,0.6456027928523966,3.6662103966651105,0.5533671280982623,0.48128481948669766
1840,1720476798,1720479122,2324,2.1440412766780286,4.401411011491581,0.3432929915982673,0.23700240868426198
1841,1720480398,1720482942,2544,1.8340799277467195,4.621520954953697,0.6155443065218642,0.7982119443228808
1842,1720483998,1720487191,3193,1.7501283693267409,4.3491753885134,0.19352745611075167,0.31499021908760305
1843,1720487598,1720491198,3600,0.4217146467146924,3.0090432009474783,0.1,0.1
1844,1720491198,1720494798,3600,0.44614151531394375,3.0836375329066112,0.1,0.1
1845,1720494798,1720498078,3280,1.7075434039221515,4.5853387546740025,0.15721392994787273,0.9173656163768523
1846,1720498398,1720501634,3236,2.3820394786368433,4.571992702938458,0.5370931694829574,0.2992727031736647
1847,1720501998,1720505598,3600,0.4328134328998924,3.07054810909969,0.1,0.1
1848,1720505598,1720507413,1815,2.2800711302704966,4.519147880684985,0.7612554891698222,0.7321848257230414
1849,1720509198,1720512798,3600,0.16409349660682598,3.1029607674530317,0.1,0.1
1850,1720512798,1720516398,3600,0.23408149175170953,3.0239099348292773,0.1,0.1
1851,1720516398,1720517115,717,1.1274174067109026,3.9557110367339074,0.5385723033117343,0.17979248259419067
1852,1720519998,1720521519,1521,1.2128342294500705,3.843184393799347,0.3429436554606805,0.872717322261995
1853,1720523598,1720527198,3600,0.1935958680513933,3.186575016525996,0.1,0.1
1854,1720527198,1720530798,3600,0.20649989787345613,3.1088653877211936,0.1,0.1
1855,1720530798,1720531438,640,1.006653127338007,3.880223985036503,0.7538407424189207,0.39980878967917255
1856,1720534398,1720537998,3600,0.1404004984891763,3.0550470399583203,0.1,0.1
1857,1720537998,1720540326,2328,2.19649051078214,4.3576458358252,0.9230730608048663,0.558237406634832
1858,1720541598,1720545198,3600,0.29864462592506746,3.0399261282208685,0.1,0.1
1859,1720545198,1720546727,1529,1.1610968868228242,4.008461517724562,0.10108282213145371,0.1846661259150209
1860,1720548798,1720552398,3600,0.3560562125145901,3.052436842670948,0.1,0.1
1861,1720552398,1720554513,2115,1.9453338965056979,4.4851721097581665,0.2969367973370495,0.679762135813153
1862,1720555998,1720559598,3600,0.15725332294159197,3.1499723665932766,0.1,0.1
1863,1720559598,1720562714,3116,1.7029343740353942,4.552904278813288,0.4607135604574293,0.4149238584231748
1864,1720563198,1720566798,3600,0.4064102319242662,3.0264733559959507,0.1,0.1
1865,1720566798,1720570398,3600,0.4233242561143713,3.078385692132367,0.1,0.1
1866,1720570398,1720573466,3068,2.359636259942837,4.3649947129434565,0.16498146049489237,0.45792064842511304
1867,1720573998,1720577598,3600,0.3717293415289292,3.0562503315274867,0.1,0.1
1868,1720577598,1720581197,3599,2.2137271718670988,4.3778283733279455,0.47325772690366585,0.6438445329672339
1869,1720581198,1720582774,1576,1.1408373778437784,3.9952402543691274,0.6266427012314622,0.4945482314804521
1870,1720584798,1720588398,3600,0.4908516174060322,3.1725037789058783,0.1,0.1
1871,1720588398,1720591998,3600,0.35580720312955894,3.1202277882806526,0.1,0.1
1872,1720591998,1720595598,3600,0.3158460257292144,3.1969142327171203,0.1,0.1
1873,1720595598,1720599198,3600,0.11559974466067198,3.0327131550787185,0.1,0.1
1874,1720599198,1720602645,3447,2.1226177861858533,4.353814594558811,0.49024458053392495,0.12857769070354452
1875,1720602798,1720606398,3600,0.10289840027870772,3.0309140878365692,0.1,0.1
1876,1720606398,1720609998,3600,0.3067990961407967,3.17790273699927,0.1,0.1
1877,1720609998,1720610583,585,0.7405008609672863,3.584703491904217,0.6890727343070938,0.247613051559358
1878,1720613598,1720617198,3600,0.27918460444142745,3.198617304239163,0.1,0.1
1879,1720617198,1720620798,3600,0.4374611106449271,3.1923665417825347,0.1,0.1
1880,1720620798,1720624398,3600,0.13346604223834127,3.080921349219756,0.1,0.1
1881,1720624398,1720627998,3600,0.1646216054685154,3.1138472554033534,0.1,0.1
1882,1720627998,1720631598,3600,0.3614305483312342,3.1552401220315565,0.1,0.1
1883,1720631598,1720634821,3223,1.9244326731749326,4.318513929107572,0.6518551211080562,0.6104117037388348
1884,1720635198,1720637028,1830,1.891761978296921,4.689676062051115,0.6381319409669712,0.15864483498701623
1885,1720638798,1720642398,3600,0.18827983884452337,3.145319657349075,0.1,0.1
1886,1720642398,1720645998,3600,0.4467446091177373,3.1335498585966963,0.1,0.1
1887,1720645998,1720649598,3600,0.4811743387415004,3.116425606375522,0.1,0.1
1888,1720649598,1720650162,564,0.5093621732228026,3.600568662876925,0.10361901029747311,0.3296426456519351
1889,1720653198,1720656798,3600,0.46175954745239656,3.1797032394081524,0.1,0.1
1890,1720656798,1720657686,888,1.1744192213697886,4.022187247917061,0.31490442699853693,0.46688719648739063
1891,1720660398,1720663338,2940,1.6282363920189313,4.349754018980584,0.4034908831154256,0.5186183913988034
1892,1720663998,1720667274,3276,1.5737053201573667,4.683802742835646,0.1873906636261844,0.8369108791151525
1893,1720667598,1720667707,109,0.8385327586758995,3.5834017355727306,0.5859263020191507,0.5414275899855717
1894,1720671198,1720674798,3600,0.329289341642954,3.1238212763758417,0.1,0.1
1895,1720674798,1720678398,3600,0.39770110223938027,3.1138146512455185,0.1,0.1
1896,1720678398,1720681998,3600,0.1056088148202956,3.065407316881489,0.1,0.1
1897,1720681998,1720685598,3600,0.21323839480741166,3.0913914245772753,0.1,0.1
1898,1720685598,1720689198,3600,0.3214630930032075,3.015830423527072,0.1,0.1
1899,1720689198,1720692798,3600,0.4545422467474497,3.125259455809894,0.1,0.1
1900,1720692798,1720696398,3600,0.14666281957406702,3.03743274028393,0.1,0.1
1901,1720696398,1720699998,3600,0.11058701374521879,3.129529208663249,0.1,0.1
1902,1720699998,1720703598,3600,0.1869075064615444,3.0301839734027403,0.1,0.1
1903,1720703598,1720707198,3600,0.26378653190886464,3.1642899127555277,0.1,0.1
1904,1720707198,1720710798,3600,0.47258869970114425,3.084568953851802,0.1,0.1
1905,1720710798,1720711099,301,0.7946945898374624,3.496065457804427,0.5316764936898879,0.4100108854373604
1906,1720714398,1720716151,1753,1.3836509051647705,4.016253988038787,0.5789158367917108,0.21638672946833912
1907,1720717998,1720720488,2490,2.3507966260121567,4.32180033546793,0.2312555071722377,0.8443092885461477
1908,1720721598,1720725198,3600,0.10123123976905926,3.1950575771669243,0.1,0.1
1909,1720725198,1720728798,3600,0.25825222243488555,3.0161979522355398,0.1,0.1
1910,1720728798,1720729981,1183,1.3252580729565668,3.9536017226573867,0.733455992533484,0.6363474690635552
1911,1720732398,1720735998,3600,0.1386423087012798,3.12453900863757,0.1,0.1
1912,1720735998,1720739598,3600,0.43343752372908106,3.0868882921675347,0.1,0.1
1913,1720739598,1720743198,3600,0.22665124794952052,3.112999395124913,0.1,0.1
1914,1720743198,1720744351,1153,1.070332104289617,3.968698564552014,0.49104504766203294,0.13248235459981458
1915,1720746798,1720750398,3600,0.22425532537495765,3.062128546255445,0.1,0.1
1916,1720750398,1720751048,650,1.4680147278430433,3.9426428864966554,0.6901141409994579,0.5371424451943037
1917,1720753998,1720756571,2573,2.192919752964463,4.699753852854029,0.11502427038854446,0.8815776468278029
1918,1720757598,1720758744,1146,1.0482116916126436,4.1590782699769715,0.3234125029708286,0.5358717477143051
1919,1720761198,1720762825,1627,1.2408271958351924,3.885082193987886,0.9806032765887995,0.5399386026099073
1920,1720764798,1720767233,2435,1.633872023932585,4.699016087423552,0.9887186118923302,0.9138436103955436
1921,1720768398,1720770542,2144,1.5755754524615722,4.476060688990155,0.87580209687477,0.206595931229387
1922,1720771998,1720774380,2382,1.7390081336236505,4.663835048881618,0.6210471849337817,0.526388187917059
1923,1720775598,1720779198,3600,0.126502981382131,3.054016585160442,0.1,0.1
1924,1720779198,1720781506,2308,2.137809436022513,4.335280601316044,0.4211967319478531,0.889152194430923
1925,1720782798,1720786398,3600,0.48043650902941293,3.041397544261702,0.1,0.1
1926,1720786398,1720789998,3600,0.14150185197052775,3.087960192437975,0.1,0.1
1927,1720789998,1720793598,3600,0.32672091206400933,3.1017954896617246,0.1,0.1
1928,1720793598,1720793855,257,0.6196030331959244,3.327266509210619,0.28055092683554905,0.5549284474126118
1929,1720797198,1720797439,241,0.746359432933457,3.3988412118416513,0.7955908705752603,0.7692784378236701
1930,1720800798,1720801489,691,1.1000966829326133,4.1349103270283845,0.1383668092345891,0.5194730230031315
1931,1720804398,1720806757,2359,2.206340167952841,4.39411356870195,0.935659272337675,0.8163253462493143
1932,1720807998,1720810053,2055,2.2846721632032603,4.476073755212476,0.5972395068617953,0.5750052894863081
1933,1720811598,1720812687,1089,1.2853292484218566,4.11107248507312,0.7138344871252117,0.7494687831685632
1934,1720815198,1720818798,3600,0.22982178184274968,3.014345020831197,0.1,0.1
1935,1720818798,1720821896,3098,2.192421978944229,4.586033838966469,0.7800830359220677,0.5401658924147406
1936,1720822398,1720824292,1894,2.441515564690907,4.450668165058419,0.29586909282119866,0.8739389361786695
1937,1720825998,1720827858,1860,1.9554349406615348,4.660715097905833,0.648062161282387,0.8220607285807845
1938,1720829598,1720831399,1801,2.4790336810300326,4.47354619003433,0.808078443125955,0.9856995390887264
1939,1720833198,1720834795,1597,1.421324908611951,3.915050759212679,0.8192040684825551,0.8788535991353897
1940,1720836798,1720839832,3034,2.099706639667472,4.580016339515931,0.7501223235142781,0.9908419803535029
1941,1720840398,1720843998,3600,0.2143773369042959,3.164540413897331,0.1,0.1
1942,1720843998,1720847598,3600,0.3944158183659541,3.0952623020214056,0.1,0.1
1943,1720847598,1720850621,3023,1.8401158666238688,4.38844618373503,0.48558728849583876,0.17969563812625136
1944,1720851198,1720851813,615,1.0561816573549323,3.8896808687754336,0.23113318687446008,0.8329310712455894
1945,1720854798,1720857899,3101,1.8184521340870787,4.412274888365074,0.7684673590725977,0.20696417759699381
1946,1720858398,1720861998,3600,0.17707752986190695,3.1142235547029777,0.1,0.1
1947,1720861998,1720862708,710,1.1027447788871463,4.111619173061831,0.5847783439577491,0.9615808161529836
1948,1720865598,1720866648,1050,1.089385402589175,4.101154802297043,0.7058725273884625,0.9340055798179047
1949,1720869198,1720869277,79,0.9958625461063189,3.560745206456964,0.44065532594721213,0.6749080625530773
1950,1720872798,1720874480,1682,1.2069921379308095,4.065425584216352,0.5449510161492784,0.6097028762180416
1951,1720876398,1720879318,2920,2.0053449179701794,4.438384011205858,0.16645047094838805,0.2784329765454392
1952,1720879998,1720883598,3600,0.23332840013709646,3.15740606143847,0.1,0.1
1953,1720883598,1720886872,3274,2.1471499581695297,4.413388658504167,0.8195503236413603,0.9809702476076027
1954,1720887198,1720890798,3600,0.22170282806639416,3.150349054540243,0.1,0.1
1955,1720890798,1720894398,3600,0.2624782197892931,3.133735549781359,0.1,0.1
1956,1720894398,1720897998,3600,0.37030155037567225,3.0921809546543604,0.1,0.1
1957,1720897998,1720898100,102,0.7268944833298714,3.4352609196456503,0.9011801136365136,0.805902910185305
1958,1720901598,1720905198,3600,0.2912972296976838,3.0474562293622793,0.1,0.1
1959,1720905198,1720908798,3600,0.1423757515174475,3.0796349460536336,0.1,0.1
1960,1720908798,1720912398,3600,0.15070087244100439,3.019333546098316,0.1,0.1
1961,1720912398,1720915998,3600,0.1641053001933644,3.069266747357903,0.1,0.1
1962,1720915998,1720919598,3600,0.4212621005571737,3.193004268799461,0.1,0.1
1963,1720919598,1720923198,3600,0.34221987106671015,3.179172308722342,0.1,0.1
1964,1720923198,1720923631,433,0.9621394343848617,3.385017704021953,0.36518576611088605,0.51801202637588
1965,1720926798,1720927090,292,0.507985199831894,3.6204125752842997,0.9063298747052941,0.4768223015790428
1966,1720930398,1720933296,2898,1.5285352333061455,4.45284289829181,0.16072520526601844,0.8362173537188117
1967,1720933998,1720935072,1074,1.1881396474874553,4.192066226709246,0.4485278631724511,0.7125850320928292
1968,1720937598,1720939608,2010,2.0764509072334567,4.608128407563891,0.7593145168513575,0.39998354997119845
1969,1720941198,1720944798,3600,0.2680604986396238,3.139829052899306,0.1,0.1
1970,1720944798,1720948398,3600,0.2848428951662481,3.1871251795708297,0.1,0.1
1971,1720948398,1720950334,1936,1.9794807673419639,4.416614238810767,0.514839747398252,0.5266470993871271
1972,1720951998,1720955598,3600,0.4014467656483196,3.1960211980967217,0.1,0.1
1973,1720955598,1720958213,2615,1.7906892833522745,4.4322207400531175,0.5902079426754041,0.8030155391496911
1974,1720959198,1720960342,1144,1.373001937464058,3.983200509311906,0.7168987813209255,0.2231286175691226
1975,1720962798,1720963942,1144,1.1657695305139484,3.9161402343601712,0.5533778826607789,0.29812646130728887
1976,1720966398,1720969998,3600,0.2296033626726104,3.0174729870301316,0.1,0.1
1977,1720969998,1720972692,2694,2.0900715224320727,4.652418002847026,0.885590538032096,0.9365620842419292
1978,1720973598,1720976814,3216,1.6056952688418789,4.635176647328022,0.5290309680740012,0.23004159890146825
1979,1720977198,1720980798,3600,0.4505894716294,3.1353834717801683,0.1,0.1
1980,1720980798,1720981781,983,1.2767757960661186,4.137372951314875,0.3082310852791462,0.5945169609582575
1981,1720984398,1720987998,3600,0.17760064451725488,3.092978677851339,0.1,0.1
1982,1720987998,1720990772,2774,1.9976620156901133,4.320230043919695,0.7853591066397824,0.8696771619476984
1983,1720991598,1720992022,424,0.7534076644812021,3.367480475287122,0.4715788096923672,0.9534836839943324
1984,1720995198,1720996275,1077,1.3826393689416463,3.865965181619155,0.9461046187263235,0.9893255150454279
1985,1720998798,1721002398,3600,0.15632813679364724,3.064101911204997,0.1,0.1
1986,1721002398,1721005998,3600,0.11429431122496553,3.0571420987607247,0.1,0.1
1987,1721005998,1721009598,3600,0.35303019246375833,3.1002724632989795,0.1,0.1
1988,1721009598,1721009960,362,0.7987337238820371,3.5760862346354756,0.8795399176735086,0.7936013617430655
1989,1721013198,1721015739,2541,1.8656889205711469,4.495424119768993,0.46816886437070604,0.6771219063626102
1990,1721016798,1721020398,3600,0.47372420525120074,3.1426658387336373,0.1,0.1
1991,1721020398,1721023998,3600,0.2648694637040947,3.152223652961493,0.1,0.1
1992,1721023998,1721027598,3600,0.1763964128841592,3.0709125889588065,0.1,0.1
1993,1721027598,1721027727,129,0.8564408057375754,3.6274685336473818,0.7003081996815432,0.7109924574230506
1994,1721031198,1721034669,3471,2.0903281473452946,4.447303222742806,0.4413236960058231,0.7268945190852847
1995,1721034798,1721038398,3600,0.12483348612280101,3.1947164974134346,0.1,0.1
1996,1721038398,1721039350,952,1.3909270538612297,4.077477207821903,0.7000986162976922,0.43419069313404246
1997,1721041998,1721042824,826,1.3537616521829978,4.0465615234232715,0.5479593676974666,0.38989396476067084
1998,1721045598,1721049198,3600,0.34483585818813633,3.048631332919063,0.1,0.1
1999,1721049198,1721052798,3600,0.16209637263264068,3.046146128092607,0.1,0.1
2000,1721052798,1721056398,3600,0.17725927954459253,3.1311586793920134,0.1,0.1
2001,1721056398,1721058798,2400,2.3095304634385485,4.392014822713547,0.2666274532123634,0.2703722522511193
2002,1721059998,1721063598,3600,0.3847159977412241,3.1847245042615597,0.1,0.1
2003,1721063598,1721067198,3600,0.4489978568070421,3.008440562753809,0.1,0.1
2004,1721067198,1721070128,2930,2.07472261879835,4.667529402741528,0.8800683631932964,0.6492553557774613
2005,1721070798,1721071133,335,0.7593581371434279,3.4254211871150493,0.504911609352347,0.870432288333051
2006,1721074398,1721077998,3600,0.28783363584977134,3.0732834330098675,0.1,0.1
2007,1721077998,1721080925,2927,1.697820052441056,4.608034927135141,0.4406708378205889,0.25332720864954644
2008,1721081598,1721085198,3600,0.38721378290833763,3.122107718344865,0.1,0.1
2009,1721085198,1721088798,3600,0.15609789989396392,3.0984167760690298,0.1,0.1
2010,1721088798,1721090257,1459,1.3055632723563786,3.881854903847166,0.39672287203402723,0.958531350680538
2011,1721092398,1721093896,1498,1.2684278435391234,3.8045210551507056,0.17956433274673533,0.5609953243140764
2012,1721095998,1721099598,3600,0.4412203204746935,3.020635320655805,0.1,0.1
2013,1721099598,1721103198,3600,0.20782825444524278,3.0322153323034526,0.1,0.1
2014,1721103198,1721106052,2854,2.3287885671817645,4.597043034747911,0.6461477929693663,0.34007261328317456
2015,1721106798,1721110398,3600,0.1724124932458369,3.1026302873577225,0.1,0.1
2016,1721110398,1721110931,533,0.9189046284394096,3.621554194280817,0.4141034984837487,0.44002562851353133
2017,1721113998,1721115304,1306,1.3372105923891682,4.159497660139785,0.5447905533527413,0.9726679480547117
2018,1721117598,1721120330,2732,2.22994073354951,4.565770649587972,0.9873920987659831,0.3241826121873419
2019,1721121198,1721122403,1205,1.2728395987648384,3.8933834778350023,0.37088940277945837,0.6273661708073558
2020,1721124798,1721128398,3600,0.47399391545439373,3.0794504123354356,0.1,0.1
2021,1721128398,1721131998,3600,0.2554401102638698,3.0599731523286278,0.1,0.1
2022,1721131998,1721133197,1199,1.2296982664921812,4.046445068607183,0.24387376903094343,0.17230029398057983
2023,1721135598,1721139198,3600,0.12252424080963463,3.1586338744211724,0.1,0.1
2024,1721139198,1721142798,3600,0.27448881533652625,3.051822441138221,0.1,0.1
2025,1721142798,1721146398,3600,0.23842692577086597,3.043009724396327,0.1,0.1
2026,1721146398,1721149998,3600,0.26910142593685316,3.1807323734567463,0.1,0.1
2027,1721149998,1721153598,3600,0.19455981331773664,3.084868036730781,0.1,0.1
2028,1721153598,1721157198,3600,0.3712824265839131,3.1421856220474327,0.1,0.1
2029,1721157198,1721159955,2757,2.1713927771207837,4.596545505242364,0.2986597134335196,0.12837251070973482
2030,1721160798,1721161680,882,1.1678657918939153,3.853017187884419,0.19404588377964577,0.3116985387003954
2031,1721164398,1721167998,3600,0.2968816675391606,3.049824279560338,0.1,0.1
2032,1721167998,1721170237,2239,2.4383730819767653,4.34774615390283,0.712181257952203,0.9066965888475554
2033,1721171598,1721172949,1351,1.2590069991897368,4.034548104050703,0.9587902577037273,0.7785604787726611
2034,1721175198,1721178798,3600,0.3627590475655783,3.102886858915194,0.1,0.1
2035,1721178798,1721180692,1894,2.0634380742152247,4.663266020807875,0.4555291644328331,0.6273135362402658
2036,1721182398,1721184264,1866,2.10021635365013,4.363517777549591,0.14150321451355735,0.7236550845710785
2037,1721185998,1721189548,3550,1.7722781717573606,4.557203265377976,0.7172259702986495,0.6119301353776906
2038,1721189598,1721193198,3600,0.15922498405708452,3.1002304407940326,0.1,0.1
2039,1721193198,1721193986,788,1.2817464706593165,3.809083207564803,0.47974623274723294,0.9913065000555974
2040,1721196798,1721198803,2005,1.9639456573264877,4.468325430756938,0.15012858679005803,0.928788994046613
2041,1721200398,1721202536,2138,1.5739957557306887,4.601255501843977,0.8316266565525259,0.7757649166654874
2042,1721203998,1721207598,3600,0.3413932685928343,3.014676450767315,0.1,0.1
2043,1721207598,1721208018,420,0.6021170699776127,3.6816153299753838,0.49568750019387187,0.9501751582502513
2044,1721211198,1721214798,3600,0.31868181331596657,3.187717382504858,0.1,0.1
2045,1721214798,1721218398,3600,0.3682481927784559,3.150047270352337,0.1,0.1
2046,1721218398,1721218846,448,0.7424799840450697,3.620834389160147,0.21278547717329954,0.7179610411684489
2047,1721221998,1721225598,3600,0.33893710312631153,3.0304671930199807,0.1,0.1
2048,1721225598,1721226667,1069,1.0186718617723005,3.983029116059139,0.2041610715289405,0.343781230557518
2049,1721229198,1721232798,3600,0.3413831540394348,3.1757586771018915,0.1,0.1
2050,1721232798,1721233098,300,0.8803728174076733,3.5456588617864377,0.5984132267456903,0.44977300034898726
2051,1721236398,1721237967,1569,1.3096289282317737,3.837271802017645,0.2318952608682036,0.3449455964590451
2052,1721239998,1721243598,3600,0.32548919369605445,3.122383501833846,0.1,0.1
2053,1721243598,1721245672,2074,2.2737983984695367,4.697229511599237,0.9961615287517684,0.2379092781370427
2054,1721247198,1721250798,3600,0.3615713306391978,3.0769018765495066,0.1,0.1
2055,1721250798,1721253852,3054,2.0489160496708463,4.349096776727873,0.8108710725607267,0.7152493455488996
2056,1721254398,1721256524,2126,1.9276408080560623,4.370318266184484,0.24262091810811362,0.9229120403017902
2057,1721257998,1721261054,3056,2.359413535190158,4.601464440846692,0.7836848054148007,0.12383992520063151
2058,1721261598,1721265198,3600,0.20480912364078635,3.050881823843189,0.1,0.1
2059,1721265198,1721268798,3600,0.19137355245419801,3.0476590907197103,0.1,0.1
2060,1721268798,1721272398,3600,0.3521791979923756,3.1037519026723612,0.1,0.1
2061,1721272398,1721275998,3600,0.3517954701463041,3.0938941726511286,0.1,0.1
2062,1721275998,1721279576,3578,1.5288523753436056,4.63957083050206,0.7514975973553226,0.308604054330492
2063,1721279598,1721282067,2469,1.94586617635462,4.443844043569706,0.5631180589571773,0.8374403627156584
2064,1721283198,1721286798,3600,0.18171271458779784,3.192130326415548,0.1,0.1
2065,1721286798,1721288469,1671,1.4682990976054051,4.042152289149421,0.9168855728344999,0.9178488711726422
2066,1721290398,1721293998,3600,0.3499860293887672,3.1092711861929487,0.1,0.1
2067,1721293998,1721296607,2609,2.1897315229213783,4.398826669238955,0.2796967001274244,0.38220081410954476
2068,1721297598,1721301160,3562,2.4487066047266643,4.342919909358262,0.7619829096941297,0.42634295435353486
2069,1721301198,1721304798,3600,0.24053702597936139,3.0468501138224258,0.1,0.1
2070,1721304798,1721308398,3600,0.14884067635068887,3.1190909934107705,0.1,0.1
2071,1721308398,1721309893,1495,1.3322141425445195,3.8467613992035687,0.5208774266243731,0.916571865050423
2072,1721311998,1721315598,3600,0.2668270378867086,3.170161696406696,0.1,0.1
2073,1721315598,1721319198,3600,0.22693022883894975,3.101081514423722,0.1,0.1
2074,1721319198,1721320051,853,1.4029529735488793,4.1567747752549975,0.1069051387872128,0.8269242090639596
2075,1721322798,1721325838,3040,1.634260239644048,4.6518137212729025,0.708108660795454,0.9806280670893431
2076,1721326398,1721326514,116,0.790307082932453,3.6172925820827575,0.45352546619206746,0.4031632918777589
2077,1721329998,1721332088,2090,1.5089221760242308,4.659487716246286,0.15918105471587357,0.3006591821752295
2078,1721333598,1721337198,3600,0.22778163921744948,3.176961973469944,0.1,0.1
2079,1721337198,1721337515,317,0.8577772695696053,3.345258231594546,0.11405930865332878,0.9997382288613674
2080,1721340798,1721344398,3600,0.14954611590729683,3.01145384326651,0.1,0.1
2081,1721344398,1721347998,3600,0.464196006143872,3.196218854599025,0.1,0.1
2082,1721347998,1721349725,1727,1.1591456443355668,3.9828200404593868,0.6139380383550169,0.6645346917295966
2083,1721351598,1721353895,2297,1.882085694197058,4.577483902245641,0.6406521384734801,0.2541927090239865
2084,1721355198,1721358798,3600,0.12618563470860208,3.155278206586821,0.1,0.1
2085,1721358798,1721362398,3600,0.25419168273087867,3.0242544790474772,0.1,0.1
2086,1721362398,1721365998,3600,0.18009338587346205,3.184770592521339,0.1,0.1
2087,1721365998,1721369598,3600,0.41939299254885976,3.1940197628579274,0.1,0.1
2088,1721369598,1721373198,3600,0.19194921805350518,3.1492984813981533,0.1,0.1
2089,1721373198,1721376798,3600,0.3493060575074066,3.0274206957819323,0.1,0.1
2090,1721376798,1721380262,3464,1.8583755934682107,4.4982847216435395,0.8831158304123545,0.8776808051516268
2091,1721380398,1721383998,3600,0.40846976093555987,3.1170121041496617,0.1,0.1
2092,1721383998,1721384491,493,0.7332882093585305,3.4897907077951307,0.893048442911575,0.11623769485693086
2093,1721387598,1721387949,351,0.5588757699728026,3.6330731647029055,0.3568647223636934,0.2181786489475871
2094,1721391198,1721394798,3600,0.4051172402097606,3.1059636697680366,0.1,0.1
2095,1721394798,1721396631,1833,2.1358777907250257,4.467888577403123,0.1419308655119951,0.8242501610282527
2096,1721398398,1721401777,3379,2.462209710196712,4.589749925636366,0.1708032937435187,0.6412143816508565
2097,1721401998,1721402429,431,0.7880515632424825,3.41928672176628,0.7822659280531609,0.46028141057187133
2098,1721405598,1721409168,3570,2.155448604265138,4.442892232177534,0.34282843867496204,0.7104069956261362
2099,1721409198,1721412798,3600,0.1677971425013094,3.190310248535436,0.1,0.1
2100,1721412798,1721416398,3600,0.1596216383447171,3.119289335301294,0.1,0.1
2101,1721416398,1721419998,3600,0.48197411805426715,3.1060110992194216,0.1,0.1
2102,1721419998,1721420260,262,0.8350382685599483,3.562535321174667,0.7594703053296578,0.4243863275271137
2103,1721423598,1721423898,300,0.8436944455575395,3.543465752844741,0.23739255432791168,0.2684415170906558
2104,1721427198,1721430798,3600,0.4363753232828862,3.073490199249652,0.1,0.1
2105,1721430798,1721434398,3600,0.2423137031129739,3.152461247195621,0.1,0.1
2106,1721434398,1721435595,1197,1.0150626484681466,4.15322098077449,0.9235492440542902,0.5057857327469774
2107,1721437998,1721441598,3600,0.287478194837526,3.1522093074120807,0.1,0.1
2108,1721441598,1721444075,2477,2.2383236700657405,4.3489368670419575,0.8398808412187744,0.36917142064653397
2109,1721445198,1721448798,3600,0.4297807484374977,3.0727612550505667,0.1,0.1
2110,1721448798,1721450908,2110,1.8168023443179298,4.334586791671272,0.38200007827076266,0.8751617202805074
2111,1721452398,1721455998,3600,0.2507949909869923,3.0919437703198485,0.1,0.1
2112,1721455998,1721459598,3600,0.23656019289040542,3.0613001300288847,0.1,0.1
2113,1721459598,1721463198,3600,0.3406444925132214,3.1908443956921912,0.1,0.1
2114,1721463198,1721466798,3600,0.21053790056188504,3.157718901038932,0.1,0.1
2115,1721466798,1721467664,866,1.1762203491324044,3.9554049422740265,0.8262847953641008,0.1596233970076229
2116,1721470398,1721473998,3600,0.18979018734766726,3.178932513559578,0.1,0.1
2117,1721473998,1721477598,3600,0.216403197074346,3.176186672639019,0.1,0.1
2118,1721477598,1721478959,1361,1.217833331830131,4.027239690984333,0.7748646058932661,0.9091274231914971
2119,1721481198,1721484798,3600,0.43458279526122146,3.0587554605826255,0.1,0.1
2120,1721484798,1721488126,3328,2.0136636866356,4.3915187586378535,0.35998574565747976,0.5734975110844157
2121,1721488398,1721491998,3600,0.26750905436756184,3.160279599819004,0.1,0.1
2122,1721491998,1721495598,3600,0.13635950508256767,3.0201283000818835,0.1,0.1
2123,1721495598,1721498493,2895,1.5383468659123487,4.592291610602261,0.6977572383683255,0.9185739754280976
2124,1721499198,1721501076,1878,1.763387413277767,4.652376401666049,0.15238946047367108,0.44700095645049476
2125,1721502798,1721504359,1561,1.2410799276851918,3.9652243582485265,0.63716297243171,0.24641367508016504
2126,1721506398,1721509998,3600,0.11761831152267749,3.15222402631772,0.1,0.1
2127,1721509998,1721513598,3600,0.2815899978959099,3.078922920542723,0.1,0.1
2128,1721513598,1721517198,3600,0.10706375783105866,3.180218527672054,0.1,0.1
2129,1721517198,1721520798,3600,0.3521400468431706,3.0024623249386853,0.1,0.1
2130,1721520798,1721522107,1309,1.1258985088026428,3.8174545224150696,0.48930770282437297,0.89812719507752
2131,1721524398,1721527998,3600,0.39015901197049974,3.077054096464708,0.1,0.1
2132,1721527998,1721529474,1476,1.4102350998509694,3.8041712574182,0.21064531181252882,0.7297440078076604
2133,1721531598,1721534704,3106,1.9147817702349887,4.694803690446729,0.5266202328767428,0.5307877542859123
2134,1721535198,1721537687,2489,1.6447787965326637,4.688891702039323,0.25978950189294225,0.8719310149530491
2135,1721538798,1721540669,1871,2.3966102705680012,4.40856692096037,0.8692135954568568,0.7630213380332747
2136,1721542398,1721545998,3600,0.22838928402381625,3.077835924909724,0.1,0.1
2137,1721545998,1721549598,3600,0.10552206435480622,3.1163771663830255,0.1,0.1
2138,1721549598,1721551095,1497,1.372269507482101,4.134283294873914,0.29712362642167967,0.32223411228118815
2139,1721553198,1721556798,3600,0.222918320675465,3.037090779063485,0.1,0.1
2140,1721556798,1721557724,926,1.4892539156116635,3.865876564310524,0.297526920502155,0.13991604369269298
2141,1721560398,1721563998,3600,0.21927413845199492,3.1086074203719924,0.1,0.1
2142,1721563998,1721565442,1444,1.4647809562308007,4.038084485587862,0.6750835404019452,0.15821167531842484
2143,1721567598,1721571198,3600,0.2666240561996206,3.104689069614558,0.1,0.1
2144,1721571198,1721574798,3600,0.1112588405796446,3.0751325577580126,0.1,0.1
2145,1721574798,1721578398,3600,0.3608465630664882,3.105555893219295,0.1,0.1
2146,1721578398,1721581998,3600,0.4944084502455358,3.0288398856227854,0.1,0.1
2147,1721581998,1721585598,3600,0.141415005240657,3.1357829675967173,0.1,0.1
2148,1721585598,1721589198,3600,0.35893993802371327,3.1165378456792405,0.1,0.1
2149,1721589198,1721589309,111,0.5839859262974891,3.677651639826407,0.23094384812250585,0.47268749624443296
2150,1721592798,1721594345,1547,1.2777997963606604,4.047334002617447,0.22865545701599188,0.9588142371296009
2151,1721596398,1721598701,2303,2.3342453600815647,4.615183624963043,0.5609906374997947,0.20025265684292687
2152,1721599998,1721601089,1091,1.1487971885412664,4.055921139834286,0.725665490625516,0.12673156454158416
2153,1721603598,1721603832,234,0.7426936867065959,3.3958963581270507,0.2133152213113481,0.1720766923685002
2154,1721607198,1721608231,1033,1.0571434440649758,4.035235439062431,0.12062574462966176,0.3371206601508011
2155,1721610798,1721611776,978,1.0837745166249908,4.1056470815973025,0.321638876608059,0.28870205700593676
2156,1721614398,1721617998,3600,0.17352455583260462,3.0189526165485394,0.1,0.1
2157,1721617998,1721621598,3600,0.4471809287148103,3.178548018261328,0.1,0.1
2158,1721621598,1721625198,3600,0.21684077776892072,3.057654850881351,0.1,0.1
2159,1721625198,1721626324,1126,1.1545687333273702,4.132815690031815,0.7535841897230872,0.9560948726725917
2160,1721628798,1721630392,1594,1.4354867863437377,3.9301372566609833,0.7083581071513125,0.5973609210773942
2161,1721632398,1721634532,2134,2.302912007952915,4.383413726637281,0.5562827732092958,0.803006429227722
2162,1721635998,1721637857,1859,2.0811751157631178,4.519466734428652,0.14681362912796947,0.7242259862323361
2163,1721639598,1721643198,3600,0.1308016691754503,3.023219046291135,0.1,0.1
2164,1721643198,1721646729,3531,1.8239291454231226,4.6926016317794526,0.7559738989135777,0.2823282706736807
2165,1721646798,1721650398,3600,0.31822076366151375,3.0308686535695073,0.1,0.1
2166,1721650398,1721653998,3600,0.11509410137855705,3.188420943255018,0.1,0.1
2167,1721653998,1721657598,3600,0.10949220490142918,3.178920363934426,0.1,0.1
2168,1721657598,1721661198,3600,0.21944558363342198,3.1772718691259096,0.1,0.1
2169,1721661198,1721664798,3600,0.37391457057956523,3.049842883205987,0.1,0.1
2170,1721664798,1721668398,3600,0.1594133901883125,3.169513128789888,0.1,0.1
2171,1721668398,1721671998,3600,0.17219244430334438,3.0116215052179234,0.1,0.1
2172,1721671998,1721675598,3600,0.37290404105125474,3.0619295981762544,0.1,0.1
2173,1721675598,1721679198,3600,0.15824032132025076,3.119090638633813,0.1,0.1
2174,1721679198,1721682798,3600,0.394243960329817,3.0028666419641947,0.1,0.1
2175,1721682798,1721686398,3600,0.23298949331386215,3.1053918956196243,0.1,0.1
2176,1721686398,1721688086,1688,1.3569680814168583,3.8479675059563254,0.5085977036013339,0.6002487672557982
2177,1721689998,1721691103,1105,1.1336467457350232,4.003149495726177,0.6955760419719442,0.41152844795651833
2178,1721693598,1721697198,3600,0.48658773474588657,3.1621698512237244,0.1,0.1
2179,1721697198,1721700798,3600,0.16332096604700203,3.0307424038766047,0.1,0.1
2180,1721700798,1721702006,1208,1.0718523102356035,4.136748772574451,0.9199968151337533,0.5692924963857978
2181,1721704398,1721707998,3600,0.3395041402414658,3.1467791260962414,0.1,0.1
2182,1721707998,1721711598,3600,0.4977651261625745,3.0507289913853084,0.1,0.1
2183,1721711598,1721715198,3600,0.10384759202860994,3.1110357201562677,0.1,0.1
2184,1721715198,1721716716,1518,1.1483368272218013,3.871334065041009,0.5261481667449485,0.6875866874248545
2185,1721718798,1721722133,3335,1.5399874843301027,4.682548521133637,0.4443412277436247,0.437265519416394
2186,1721722398,1721722796,398,0.8530983317468923,3.5609730811160727,0.5646290760424548,0.3595337655761308
2187,1721725998,1721727903,1905,2.0930067723209893,4.3272312158674655,0.7524445455386188,0.17572820700274186
2188,1721729598,1721733198,3600,0.3579551933523689,3.1914275392107783,0.1,0.1
2189,1721733198,1721736798,3600,0.42893514511745245,3.0415736742666004,0.1,0.1
2190,1721736798,1721740398,3600,0.4215395163639363,3.037206786495129,0.1,0.1
2191,1721740398,1721743998,3600,0.16053154324894106,3.164388177905477,0.1,0.1
2192,1721743998,1721747598,3600,0.37171329577808154,3.109344259902642,0.1,0.1
2193,1721747598,1721751198,3600,0.25433864933524164,3.1819512914147157,0.1,0.1
2194,1721751198,1721754798,3600,0.44707983539084484,3.008012175584125,0.1,0.1
2195,1721754798,1721758398,3600,0.2271741200037729,3.093985492370142,0.1,0.1
2196,1721758398,1721760556,2158,1.6073037632506626,4.582655410897419,0.8526615584086742,0.718704704237213
2197,1721761998,1721765598,3600,0.4875943766546945,3.0195545875192704,0.1,0.1
2198,1721765598,1721767688,2090,1.9413415776674148,4.675067996794294,0.4121228285417242,0.27536436412096066
2199,1721769198,1721772798,3600,0.32718959772376144,3.00390073475149,0.1,0.1
2200,1721772798,1721776398,3600,0.20910791651943425,3.128624467278539,0.1,0.1
2201,1721776398,1721779998,3600,0.19968467250968472,3.0426243005646256,0.1,0.1
2202,1721779998,1721783598,3600,0.20790725109207206,3.1713177195991094,0.1,0.1
2203,1721783598,1721786609,3011,1.7223757740556198,4.479383670897803,0.4165209527760574,0.36497392729090294
2204,1721787198,1721790798,3600,0.2201828181226524,3.109239142113178,0.1,0.1
2205,1721790798,1721793869,3071,2.2603004264393745,4.501458118731162,0.19776352328368946,0.3240123621924123
2206,1721794398,1721796854,2456,1.7960877277720666,4.336108439814702,0.7024076102229534,0.3032562659898076
2207,1721797998,1721798154,156,0.5956524269175915,3.4211622782566824,0.36550988762362513,0.41104761743564733
2208,1721801598,1721804267,2669,2.1764566420154914,4.660707635655959,0.2998662216143269,0.8909727635036226
2209,1721805198,1721807816,2618,1.6642687318461666,4.456533659739929,0.7701891450321304,0.27291219484733964
2210,1721808798,1721812398,3600,0.22589993165365138,3.019007343439778,0.1,0.1
2211,1721812398,1721813996,1598,1.1042520190507772,4.111306914268081,0.4083580858678274,0.4339292566841412
2212,1721815998,1721816324,326,0.6053772557877874,3.587843963034137,0.8777724960975577,0.7331980525517198
2213,1721819598,1721820359,761,1.3983740514145375,4.042799433319086,0.7846361535419953,0.6261524127128657
2214,1721823198,1721823458,260,0.5890218679753632,3.527104166663942,0.11838127251607122,0.7213089034873293
2215,1721826798,1721828519,1721,1.0668736031024406,4.007444042497472,0.940846696188792,0.5609842658058263
2216,1721830398,1721833998,3600,0.19478002675249245,3.120880931410115,0.1,0.1
2217,1721833998,1721837598,3600,0.21437471631131225,3.0940397664763135,0.1,0.1
2218,1721837598,1721841198,3600,0.1433811342599648,3.0049305739061087,0.1,0.1
2219,1721841198,1721843397,2199,2.2468545395669164,4.427927782873309,0.7613316667887425,0.3175501092086489
2220,1721844798,1721846538,1740,1.1483585869996207,4.100233630682367,0.7445664445065391,0.47567109712802347
2221,1721848398,1721851998,3600,0.3426753530540564,3.1904267902908883,0.1,0.1
2222,1721851998,1721855598,3600,0.4182984912232941,3.0056587975017734,0.1,0.1
2223,1721855598,1721859198,3600,0.40421984066737626,3.063321302657479,0.1,0.1
2224,1721859198,1721860078,880,1.1623826889625302,4.099549463040416,0.5972500357006255,0.4316754331386503
2225,1721862798,1721866398,3600,0.28210588113507973,3.13355422459561,0.1,0.1
2226,1721866398,1721869730,3332,2.3240706355295475,4.618264586214609,0.8759706354052941,0.29570145200415293
2227,1721869998,1721873598,3600,0.39410915615394626,3.183607232721233,0.1,0.1
2228,1721873598,1721874177,579,0.6168955675402413,3.5962572466314917,0.8448274243231554,0.44086756744530486
2229,1721877198,1721880798,3600,0.1791106307029677,3.103449240541924,0.1,0.1
2230,1721880798,1721884398,3600,0.16372930734001068,3.009369754567673,0.1,0.1
2231,1721884398,1721885483,1085,1.4901237238461031,3.807980910743833,0.9279029842592684,0.8141177356340439
2232,1721887998,1721889731,1733,1.4869943068621192,4.061348067093402,0.5812422315062462,0.16704959194060726
2233,1721891598,1721895198,3600,0.44826571604906473,3.0038246468613936,0.1,0.1
2234,1721895198,1721897930,2732,2.061925392554739,4.314167853477101,0.4385283077498595,0.7788219022687125
2235,1721898798,1721902398,3600,0.10599941420539022,3.1647797783881857,0.1,0.1
2236,1721902398,1721904065,1667,1.3314049904377607,4.044849577818456,0.9573474199623806,0.1674660902645135
2237,1721905998,1721908218,2220,1.870068450529693,4.317562676945394,0.8126997604167993,0.6411034936596214
2238,1721909598,1721913198,3600,0.2693009428880498,3.056085100131515,0.1,0.1
2239,1721913198,1721916798,3600,0.24808974296471709,3.1813178290713693,0.1,0.1
2240,1721916798,1721917585,787,1.236943385266275,3.9571820271736815,0.5881856325490147,0.7080828463390257
2241,1721920398,1721923998,3600,0.13887977527138948,3.1714173808874766,0.1,0.1
2242,1721923998,1721927598,3600,0.1281088528927331,3.1935274594980814,0.1,0.1
2243,1721927598,1721931198,3600,0.19940187390301278,3.1072704245297063,0.1,0.1
2244,1721931198,1721934798,3600,0.4177942515706844,3.1074014937174974,0.1,0.1
2245,1721934798,1721936174,1376,1.251241125546138,4.097765205672523,0.8729838505711284,0.7701516993046726
2246,1721938398,1721941998,3600,0.37415641955253187,3.0256101291292627,0.1,0.1
2247,1721941998,1721944036,2038,2.43016305922371,4.625889083341091,0.7153824981253568,0.5697466236038365
2248,1721945598,1721946803,1205,1.329993485483409,4.164948354467598,0.1278764383155954,0.29291872008249753
2249,1721949198,1721952798,3600,0.28193855908235205,3.112777292448186,0.1,0.1
2250,1721952798,1721956398,3600,0.37023392568535773,3.1550619552777803,0.1,0.1
2251,1721956398,1721959998,3600,0.4051022047005718,3.1606321072077184,0.1,0.1
2252,1721959998,1721963598,3600,0.3818514806132193,3.180972691884683,0.1,0.1
2253,1721963598,1721964483,885,1.216786898747938,3.9859206622593506,0.6318182615888176,0.3571305567088454
2254,1721967198,1721970798,3600,0.13123189862894705,3.120565522254562,0.1,0.1
2255,1721970798,1721974398,3600,0.35143493444568685,3.0257010807207574,0.1,0.1
2256,1721974398,1721977998,3600,0.48651478657010994,3.0446004635405046,0.1,0.1
2257,1721977998,1721979662,1664,1.3577767615503746,4.012596555744471,0.9693074378456727,0.28210445717205934
2258,1721981598,1721983824,2226,1.9643718923890172,4.358052876977537,0.13868085052769968,0.5744538381419986
2259,1721985198,1721987474,2276,2.0556195917478437,4.4155843646948805,0.31834764066124516,0.15155337953303602
2260,1721988798,1721992398,3600,0.356109648570998,3.1208308434612313,0.1,0.1
2261,1721992398,1721995438,3040,2.1623369309897393,4.5312606781227895,0.45818736662651005,0.3709986291051005
2262,1721995998,1721998546,2548,1.511183922278866,4.455648620731365,0.46781712107620477,0.683780264828702
2263,1721999598,1722003198,3600,0.32814573075757814,3.15349527725859,0.1,0.1
2264,1722003198,1722003508,310,0.6844216753771732,3.60793146499136,0.7030852191488488,0.5923846935998053
2265,1722006798,1722010398,3600,0.22530868316983993,3.075114018185693,0.1,0.1
2266,1722010398,1722013998,3600,0.2261580380578594,3.1869667143988463,0.1,0.1
2267,1722013998,1722014268,270,0.7052500400510736,3.6451600001784805,0.27261601279010245,0.9518322305629754
2268,1722017598,1722021198,3600,0.2536232081547979,3.132827298541166,0.1,0.1
2269,1722021198,1722024798,3600,0.49916547730267447,3.1150219422880596,0.1,0.1
2270,1722024798,1722027013,2215,1.8998209433924225,4.61120500242487,0.8040632635328815,0.8245929077488561
2271,1722028398,1722031998,3600,0.3681554247777601,3.0323374932481535,0.1,0.1
2272,1722031998,1722035001,3003,1.6951815592315607,4.485888025236283,0.12721717328243276,0.25507981638257005
2273,1722035598,1722039198,3600,0.35202962385977954,3.1903416634163695,0.1,0.1
2274,1722039198,1722040435,1237,1.257516514837298,3.8825672111949774,0.5976010930884535,0.2027457317523929
2275,1722042798,1722046398,3600,0.16370943096242163,3.156420321443333,0.1,0.1
2276,1722046398,1722049998,3600,0.44361217989834933,3.140079038523508,0.1,0.1
2277,1722049998,1722051766,1768,1.278005559906613,3.868374003388526,0.5358621416808597,0.8661430208257761
2278,1722053598,1722057198,3600,0.4774116402178685,3.0976023621128954,0.1,0.1
2279,1722057198,1722060154,2956,1.5585676888363262,4.30289738812769,0.4791454029043146,0.5478778701443745
2280,1722060798,1722063090,2292,1.8146707549043484,4.529139277919259,0.3866783890421046,0.8528466668920144
2281,1722064398,1722064679,281,0.5030947398230399,3.68490684939999,0.6180650974485367,0.3020870480143054
2282,1722067998,1722070682,2684,1.7702903138773376,4.608137497661721,0.7528149234954604,0.8563215213850641
2283,1722071598,1722072685,1087,1.1493449155943396,3.8707959669371723,0.5592174246092533,0.8738916900023804
2284,1722075198,1722078798,3600,0.26348191459590176,3.0934275858252698,0.1,0.1
2285,1722078798,1722082398,3600,0.3599088379588882,3.05370624502406,0.1,0.1
2286,1722082398,1722082806,408,0.9221011521306417,3.6365603764006265,0.34959909197078876,0.5385255820554258
2287,1722085998,1722089598,3600,0.25307191510355215,3.153575821521894,0.1,0.1
2288,1722089598,1722093198,3600,0.3679499938691173,3.0075082875091903,0.1,0.1
2289,1722093198,1722096798,3600,0.19375943146700073,3.023404786205485,0.1,0.1
2290,1722096798,1722100398,3600,0.28588668481130886,3.0193819439462817,0.1,0.1
2291,1722100398,1722103998,3600,0.36967073538283035,3.013489371592209,0.1,0.1
2292,1722103998,1722107598,3600,0.14193420740943785,3.1091439744298413,0.1,0.1
2293,1722107598,1722109920,2322,1.8793602891218337,4.639541507473969,0.4233873656285231,0.14536966093948112
2294,1722111198,1722113336,2138,1.8669127110905923,4.518733442467169,0.7045679608595072,0.46471530815329076
2295,1722114798,1722118398,3600,0.3636189941040713,3.0014250343715063,0.1,0.1
2296,1722118398,1722121998,3600,0.19035439641519908,3.089262292585929,0.1,0.1
2297,1722121998,1722125598,3600,0.33059129887096506,3.0012272985607558,0.1,0.1
2298,1722125598,1722129079,3481,2.434915968282702,4.6784319866054815,0.26595390671468433,0.22570583479422904
2299,1722129198,1722131435,2237,2.365788438684327,4.42155683074362,0.4922416768024519,0.7574613489782264
2300,1722132798,1722136398,3600,0.10409089385835811,3.0401629816152678,0.1,0.1
2301,1722136398,1722139998,3600,0.3532485347755324,3.000859787990214,0.1,0.1
2302,1722139998,1722142479,2481,2.159591929315205,4.502709195184334,0.3994050558656843,0.43295224303120305
2303,1722143598,1722147198,3600,0.33146582864635576,3.114760937885178,0.1,0.1
2304,1722147198,1722150798,3600,0.3298572283697271,3.1372053870301118,0.1,0.1
2305,1722150798,1722152373,1575,1.2894569365071176,3.9531717266342175,0.1425221710672085,0.4197406122034857
2306,1722154398,1722157195,2797,1.6047371203503205,4.420124122367598,0.49946131485048595,0.585732726256346
2307,1722157998,1722161598,3600,0.42342398768887446,3.0002499333476482,0.1,0.1
2308,1722161598,1722165198,3600,0.31207591267759593,3.003280673099778,0.1,0.1
2309,1722165198,1722168798,3600,0.4097268606581933,3.1102159598540986,0.1,0.1
2310,1722168798,1722172398,3600,0.23490047236662304,3.090863257621875,0.1,0.1
2311,1722172398,1722175998,3600,0.18961044270159377,3.010748229528378,0.1,0.1
2312,1722175998,1722176065,67,0.7342971310686298,3.589436531719598,0.8430527961746288,0.3153789619872309
2313,1722179598,1722183198,3600,0.30917731807647886,3.1173901270968862,0.1,0.1
2314,1722183198,1722186798,3600,0.27653650886131353,3.1145139132096964,0.1,0.1
2315,1722186798,1722187255,457,0.8232596102994316,3.5552352986488307,0.1437016911452273,0.13123297785074314
2316,1722190398,1722193998,3600,0.11727368941424308,3.177119974882863,0.1,0.1
2317,1722193998,1722196738,2740,1.5525812374312915,4.324678192942193,0.18599564203807273,0.9443691971876595
2318,1722197598,1722201198,3600,0.32221167295336073,3.0897245852585935,0.1,0.1
2319,1722201198,1722204798,3600,0.11625131294105061,3.0948420232362444,0.1,0.1
2320,1722204798,1722208398,3600,0.33500791022772036,3.0034568676247257,0.1,0.1
2321,1722208398,1722208575,177,0.5280501738563368,3.402523323061965,0.1010704734576654,0.3821320980518512
2322,1722211998,1722214666,2668,1.6601160662608572,4.395835794338534,0.1567301003039413,0.5890984831714492
2323,1722215598,1722219198,3600,0.10230070152068525,3.102268760714642,0.1,0.1
2324,1722219198,1722221002,1804,2.009249178689416,4.591664019582731,0.7249964976524893,0.702010710371571
2325,1722222798,1722226398,3600,0.20837998060682847,3.0376114026456955,0.1,0.1
2326,1722226398,1722229838,3440,1.8236241467374752,4.303186629954239,0.4959732544808457,0.6821015070434587
2327,1722229998,1722233598,3600,0.13479582602772902,3.178129415283927,0.1,0.1
2328,1722233598,1722237198,3600,0.18273099685808425,3.172114317935967,0.1,0.1
2329,1722237198,1722240490,3292,2.3468437224468213,4.578663578771674,0.3516117517256685,0.33328178433334227
2330,1722240798,1722243975,3177,1.6543495325201836,4.5534551987064775,0.6036765037939712,0.3915731199760024
2331,1722244398,1722247998,3600,0.29987340486518266,3.093792014928262,0.1,0.1
2332,1722247998,1722248291,293,0.6902940739580872,3.5340587137640656,0.6890310805120671,0.370605094714919
2333,1722251598,1722255198,3600,0.28746505725741067,3.0152677713944556,0.1,0.1
2334,1722255198,1722258798,3600,0.48516483459339244,3.1525511011963174,0.1,0.1
2335,1722258798,1722262398,3600,0.36085610447011307,3.181739171913723,0.1,0.1
2336,1722262398,1722265998,3600,0.28544964207617896,3.15174013969183,0.1,0.1
2337,1722265998,1722269598,3600,0.2891031573276104,3.198466981644098,0.1,0.1
2338,1722269598,1722270793,1195,1.215930884405782,4.064900739242097,0.7847143028339436,0.26704934567891303
2339,1722273198,1722276054,2856,1.8410618376243213,4.581882598507204,0.14678491058047138,0.32902111674951323
2340,1722276798,1722280398,3600,0.4954024053259801,3.1237193846683122,0.1,0.1
2341,1722280398,1722281761,1363,1.1489463592307683,3.9307450522929512,0.6092228940509453,0.6898604498020682
2342,1722283998,1722287598,3600,0.37383455056417836,3.0777049350517225,0.1,0.1
2343,1722287598,1722291198,3600,0.13418440857823236,3.0799503666034416,0.1,0.1
2344,1722291198,1722294798,3600,0.43135134772545014,3.0209410107475922,0.1,0.1
2345,1722294798,1722295677,879,1.4684964544744616,4.116634619234263,0.6666533905613173,0.9567288119657414
2346,1722298398,1722301998,3600,0.4538931017447253,3.1850635898793365,0.1,0.1
2347,1722301998,1722304052,2054,2.113653265934219,4.5640757927178655,0.6325525131573005,0.46842368934479983
2348,1722305598,1722309198,3600,0.45802983208520487,3.1212870302457754,0.1,0.1
2349,1722309198,1722311379,2181,2.3968427345175263,4.42046924302586,0.853341442243298,0.3110107438350732
2350,1722312798,1722316398,3600,0.465333141925233,3.124151898419314,0.1,0.1
2351,1722316398,1722316952,554,0.9596339313000816,3.5474247679719957,0.8401970182058046,0.14238103626200388
2352,1722319998,1722323598,3600,0.20583938676946315,3.105322554338901,0.1,0.1
2353,1722323598,1722327198,3600,0.30446953640199587,3.032687165559834,0.1,0.1
2354,1722327198,1722327976,778,1.3960048400734988,3.9497181602315465,0.550577816211561,0.9632389041400312
2355,1722330798,1722334398,3600,0.21583574466244204,3.007887948465154,0.1,0.1
2356,1722334398,1722337998,3600,0.33581129268225235,3.0211825026936183,0.1,0.1
2357,1722337998,1722339176,1178,1.448702624381028,4.017661062840112,0.8085412631999918,0.47144459934605243
2358,1722341598,1722343124,1526,1.281264882429391,3.9290785266176256,0.7484021395024514,0.6939981393804806
2359,1722345198,1722348659,3461,1.7504079853709014,4.551430042996686,0.9635585192701098,0.14055609171653158
2360,1722348798,1722352398,3600,0.16898315440711337,3.105925304340594,0.1,0.1
2361,1722352398,1722355998,3600,0.251148107287819,3.1919957705475355,0.1,0.1
2362,1722355998,1722356708,710,1.482902478242698,3.902169999731867,0.6315494499285215,0.5877189038222586
2363,1722359598,1722363198,3600,0.3062161298637081,3.073490426749306,0.1,0.1
2364,1722363198,1722366049,2851,1.9751199638698458,4.438558932937541,0.3537996176154905,0.8424601574299488
2365,1722366798,1722367939,1141,1.0612305888907336,3.87857050496616,0.22304047691895273,0.8513895660343995
2366,1722370398,1722371379,981,1.0159707231998345,4.082635808277405,0.3470917960089314,0.5259581022763595
2367,1722373998,1722377598,3600,0.39250996161203366,3.136511129909225,0.1,0.1
2368,1722377598,1722381198,3600,0.13155817523647972,3.0743970123397624,0.1,0.1
2369,1722381198,1722384798,3600,0.22772200383120378,3.0458092018192677,0.1,0.1
2370,1722384798,1722386631,1833,1.693931092304143,4.547345439093125,0.529075333443596,0.2721788750150661
2371,1722388398,1722391998,3600,0.4309351148740457,3.11393727023091,0.1,0.1
2372,1722391998,1722393028,1030,1.0106772428872217,3.962986068369861,0.5787727530560522,0.3880967072930577
2373,1722395598,1722397140,1542,1.1741002994720697,4.021875294423139,0.7622069846468217,0.5843891936300314
2374,1722399198,1722402469,3271,2.467289725009697,4.551595785527717,0.7351328094953964,0.7857722717492095
2375,1722402798,1722404361,1563,1.3797117988539593,4.045079666911036,0.7394236223800219,0.4317293191238254
2376,1722406398,1722407101,703,1.2540547891562874,4.143799671143592,0.4902776945817253,0.5314968470516137
2377,1722409998,1722413598,3600,0.23102891679389206,3.026798922524988,0.1,0.1
2378,1722413598,1722417198,3600,0.38987554399533386,3.1034564263989055,0.1,0.1
2379,1722417198,1722420602,3404,2.0202836167161387,4.32951613832817,0.9023362829644637,0.6460442662175744
2380,1722420798,1722423723,2925,2.499635770709374,4.648952565845743,0.36626383062229906,0.16771198590479813
2381,1722424398,1722427998,3600,0.24238964974870938,3.1479473259492314,0.1,0.1
2382,1722427998,1722431598,3600,0.3932311044968396,3.1775938571788136,0.1,0.1
2383,1722431598,1722434251,2653,2.2450579152838572,4.68248261015569,0.9336150630367884,0.24810875778709024
2384,1722435198,1722437236,2038,2.232291954497371,4.668133753083747,0.6456771895684741,0.6294314309864496
2385,1722438798,1722442398,3600,0.448175758530985,3.1013401475553035,0.1,0.1
2386,1722442398,1722444336,1938,2.0537752264089946,4.471092194524846,0.9939342388171525,0.9174029125305819
2387,1722445998,1722449598,3600,0.3298546191720182,3.140641033161758,0.1,0.1
2388,1722449598,1722453198,3600,0.1282658817616641,3.1232803746847138,0.1,0.1
2389,1722453198,1722454244,1046,1.2489173463335992,3.877609448647423,0.8074935003488948,0.5454904387712929
2390,1722456798,1722459339,2541,2.29317048966721,4.653488228268946,0.49885687771585774,0.9086734943458172
2391,1722460398,1722462472,2074,1.8721061129086758,4.580907021722029,0.13448205961187853,0.3559175673378977
2392,1722463998,1722465227,1229,1.1644564721606443,4.132253657736514,0.9706392146596704,0.9231471052064839
2393,1722467598,1722469490,1892,1.8056041290702574,4.426016394413872,0.3833350592262501,0.4594083796802536
2394,1722471198,1722474798,3600,0.2495076729265429,3.1074713317455394,0.1,0.1
2395,1722474798,1722476161,1363,1.0631555474765348,4.069288688997858,0.5267468846513511,0.5175588368620059
2396,1722478398,1722481998,3600,0.46312799925538795,3.0495093355535134,0.1,0.1
2397,1722481998,1722483061,1063,1.4698711188137037,3.872777876254641,0.6683156776650347,0.2613873210048866
2398,1722485598,1722488487,2889,2.162509601770923,4.490318482772012,0.735047927118343,0.9452995602205564
2399,1722489198,1722492798,3600,0.4328931650412393,3.00259263141355,0.1,0.1
2400,1722492798,1722494439,1641,1.4351983973804319,4.187985532446119,0.47739017168446884,0.39100433895963227
2401,1722496398,1722499998,3600,0.4665748682165992,3.0252220577883264,0.1,0.1
2402,1722499998,1722503598,3600,0.2127875541922229,3.141996721043399,0.1,0.1
2403,1722503598,1722504326,728,1.0327204541428043,4.013305847103794,0.8276617913129877,0.9877693489917522
2404,1722507198,1722510798,3600,0.4749533336161852,3.095149301577936,0.1,0.1
2405,1722510798,1722514398,3600,0.4845900380070194,3.1565419300163975,0.1,0.1
2406,1722514398,1722517437,3039,2.368205351516807,4.584155243467366,0.5970033180956141,0.3544869542880914
2407,1722517998,1722521598,3600,0.1739194394333664,3.07824082191922,0.1,0.1
2408,1722521598,1722525198,3600,0.2984932010626248,3.1919948227218966,0.1,0.1
2409,1722525198,1722528798,3600,0.1925591848799505,3.1938898172577623,0.1,0.1
2410,1722528798,1722530716,1918,2.0917150542467184,4.587073135763432,0.6123768150026696,0.61621616684193
2411,1722532398,1722535998,3600,0.42113416317295815,3.1330046202110133,0.1,0.1
2412,1722535998,1722536128,130,0.6265719614270795,3.3424244481307923,0.7582374209309171,0.7054134640255894
2413,1722539598,1722541713,2115,1.5508703156328387,4.317234177382052,0.27806723927728316,0.25512092729559843
2414,1722543198,1722545363,2165,2.3664287859697746,4.686754606774826,0.9685658156273732,0.9599717245638935
2415,1722546798,1722547162,364,0.7169892287782318,3.3436347477497304,0.5700378147795143,0.26511435550435036
2416,1722550398,1722552177,1779,1.2191272058167346,3.941915810296707,0.8368128449509386,0.7758775032758372
2417,1722553998,1722557598,3600,0.2448625270268576,3.099245107763121,0.1,0.1
2418,1722557598,1722558832,1234,1.3013662807511723,4.087094817397991,0.7638526199992891,0.26021279248186097
2419,1722561198,1722564798,3600,0.12251458792218228,3.0652419889331584,0.1,0.1
2420,1722564798,1722568398,3600,0.48848673239093643,3.145688454887087,0.1,0.1
2421,1722568398,1722571998,3600,0.18355188158139746,3.145268822713245,0.1,0.1
2422,1722571998,1722575598,3600,0.3911706145940421,3.118274999797359,0.1,0.1
2423,1722575598,1722577030,1432,1.3710630191816247,4.199893791676366,0.848269870560269,0.4196991822718851
2424,1722579198,1722582798,3600,0.4831700750135203,3.005144769155594,0.1,0.1
2425,1722582798,1722586398,3600,0.12799255340829765,3.114304858969279,0.1,0.1
2426,1722586398,1722589998,3600,0.4853163419624257,3.067343732048797,0.1,0.1
2427,1722589998,1722593598,3600,0.17756043931054016,3.1615940419060853,0.1,0.1
2428,1722593598,1722597198,3600,0.20584389713838022,3.059503778171955,0.1,0.1
2429,1722597198,1722600798,3600,0.3543408846057723,3.0055894439724455,0.1,0.1
2430,1722600798,1722604398,3600,0.1434568699853975,3.1202454417312544,0.1,0.1
2431,1722604398,1722607998,3600,0.12960744345393352,3.1537212516737054,0.1,0.1
2432,1722607998,1722611598,3600,0.35762655360609974,3.137835707144169,0.1,0.1
2433,1722611598,1722615198,3600,0.35437263301073074,3.059997758173058,0.1,0.1
2434,1722615198,1722616518,1320,1.3951259773594724,3.9850558838442627,0.21058847566039463,0.6862284875986381
2435,1722618798,1722622398,3600,0.433517921569031,3.0728020518630177,0.1,0.1
2436,1722622398,1722624619,2221,1.7284475563666977,4.352979527490786,0.9314489105277598,0.7934347094197999
2437,1722625998,1722629598,3600,0.37906750131252764,3.099264567758551,0.1,0.1
2438,1722629598,1722630958,1360,1.1098218588468263,3.8153365197712863,0.9244476434940018,0.4665756695021597
2439,1722633198,1722634039,841,1.1829900994180202,4.092352679604961,0.5493485907327414,0.9233882994241691
2440,1722636798,1722640398,3600,0.1078074611961319,3.039838192825698,0.1,0.1
2441,1722640398,1722643788,3390,1.8026223061533861,4.651180368625168,0.11073516663716915,0.9962541888005766
2442,1722643998,1722645605,1607,1.3388516502577978,3.9581802350747552,0.5036696897877916,0.5679773235200051
2443,1722647598,1722649253,1655,1.470418426260123,4.17365664757437,0.30267506142463013,0.5849995786949598
2444,1722651198,1722654798,3600,0.3688125512117566,3.162883603920632,0.1,0.1
2445,1722654798,1722657300,2502,2.2485750332156664,4.556704760743011,0.1877927068680556,0.16695578861831414
2446,1722658398,1722660150,1752,1.1758373237322786,4.152014595460383,0.12770152751235073,0.8467146382424133
2447,1722661998,1722662484,486,0.5877301366587557,3.6497679936589322,0.7272553220757612,0.7149558279271309
2448,1722665598,1722665891,293,0.8212615069131637,3.456635781992271,0.40394876227315657,0.6360361336631436
2449,1722669198,1722669892,694,1.097997906164602,4.15638488736975,0.5138842733604595,0.7786511569018555
2450,1722672798,1722676398,3600,0.4484176578189434,3.127774746872278,0.1,0.1
2451,1722676398,1722676462,64,0.9724227908335943,3.571323452191744,0.7808831756545126,0.9049419785126871
2452,1722679998,1722680584,586,0.6642016811821504,3.378102284935064,0.13801136123612734,0.27835425330981023
2453,1722683598,1722687198,3600,0.24019319451870869,3.12557569534325,0.1,0.1
2454,1722687198,1722690287,3089,1.8021763664597674,4.516639073927374,0.14365944608907255,0.454605892914726
2455,1722690798,1722694398,3600,0.1774676853830798,3.071809798943882,0.1,0.1
2456,1722694398,1722697434,3036,2.4728737656211726,4.314723113747932,0.5230682033671964,0.2726259722066578
2457,1722697998,1722701598,3600,0.2877927571224421,3.142162795841898,0.1,0.1
2458,1722701598,1722705198,3600,0.2873296622821091,3.0122760215125495,0.1,0.1
2459,1722705198,1722707419,2221,2.3349409930741976,4.581948861269345,0.5785825404880627,0.5667417498713652
2460,1722708798,1722710742,1944,2.464960099256901,4.505067602593341,0.7066436961299121,0.6465399464725783
2461,1722712398,1722713872,1474,1.1951487138552561,4.184210042414198,0.31917710579905806,0.3561156626973192
2462,1722715998,1722719598,3600,0.21419493161696557,3.0981166179739112,0.1,0.1
2463,1722719598,1722723198,3600,0.2599875269833256,3.0643702663217005,0.1,0.1
2464,1722723198,1722725213,2015,1.7948719791635175,4.638204033680686,0.9246200015926686,0.29892446886412205
2465,1722726798,1722730398,3600,0.39808824205462345,3.0010868337365464,0.1,0.1
2466,1722730398,1722733197,2799,2.309337245119699,4.38831397612905,0.1365534737439768,0.49893619501484054
2467,1722733998,1722735620,1622,1.4168752928724393,3.8905680770564732,0.7173630878949048,0.6773544727575135
2468,1722737598,1722741077,3479,2.418669466127781,4.551015847316912,0.37722734479769426,0.8248760790449572
2469,1722741198,1722744798,3600,0.1624011901127892,3.0600142740371394,0.1,0.1
2470,1722744798,1722746314,1516,1.2690374077832387,4.013494331445049,0.5801594660210798,0.7027049918224528
2471,1722748398,1722751998,3600,0.19372219338923935,3.001049863798009,0.1,0.1
2472,1722751998,1722752462,464,0.5718299883472797,3.6114668455605723,0.7802835449530082,0.479205552072265
2473,1722755598,1722759198,3600,0.24325893544861496,3.084734697239177,0.1,0.1
2474,1722759198,1722762798,3600,0.29953326282354326,3.0919990650345373,0.1,0.1
2475,1722762798,1722764678,1880,1.8412047916905707,4.414771583848544,0.17524626934867343,0.9863012574794973
2476,1722766398,1722767669,1271,1.1288005802980805,3.976568097710007,0.7369649423120176,0.8160321732988852
2477,1722769998,1722770442,444,0.8921592911988829,3.544181958123314,0.27924176779058374,0.25746359607063857
2478,1722773598,1722773830,232,0.8048902805964764,3.5420123875104634,0.7669555608114156,0.5898659872647276
2479,1722777198,1722777649,451,0.8040876801647715,3.4329211252437526,0.33188088587476494,0.3479250439475773
2480,1722780798,1722781055,257,0.8962767994791672,3.3449420050956222,0.30043902524215205,0.44034256328980037
2481,1722784398,1722785621,1223,1.2224534112174084,4.07168578488134,0.6944097271399217,0.514276715341318
2482,1722787998,1722790507,2509,1.9042407206138143,4.525395875072692,0.9027248161051463,0.6656684352310239
2483,1722791598,1722795124,3526,2.403887055605507,4.69591545292019,0.9835596048271316,0.6731846793852273
2484,1722795198,1722798798,3600,0.37026414792228646,3.0001623798721635,0.1,0.1
2485,1722798798,1722802398,3600,0.2739277261585975,3.0481415399325646,0.1,0.1
2486,1722802398,1722803411,1013,1.4502907852134328,3.995137179387427,0.15531570406223288,0.8947036648444231
2487,1722805998,1722808875,2877,1.9021359738365369,4.511711336666877,0.6675053291583539,0.36288119336463887
2488,1722809598,1722813198,3600,0.4448645191103333,3.1746514138167305,0.1,0.1
2489,1722813198,1722816798,3600,0.48316826720078454,3.0853574167557625,0.1,0.1
2490,1722816798,1722818021,1223,1.2503396171829806,4.17527966084246,0.8707292618333985,0.7392575336367363
2491,1722820398,1722821475,1077,1.4114595270622368,4.159727409164442,0.5491136815313061,0.1340414225557282
2492,1722823998,1722826111,2113,2.2128678258413714,4.611127811881616,0.7191655193639164,0.7751785191958401
2493,1722827598,1722831198,3600,0.40983117693390725,3.0270453518314375,0.1,0.1
2494,1722831198,1722832943,1745,1.0083681860428588,3.9375505935472765,0.146549512978987,0.25883841747603537
2495,1722834798,1722838398,3600,0.23559082520802335,3.1414829250527614,0.1,0.1
2496,1722838398,1722840482,2084,1.6102226531937882,4.31094119023285,0.17882948539239574,0.2982471942613071
2497,1722841998,1722842171,173,0.7974561094002872,3.368733927007262,0.19323836028143682,0.43942438892139757
2498,1722845598,1722848064,2466,1.728742667774617,4.303844586181466,0.4470633034369803,0.9099567842483721
2499,1722849198,1722852128,2930,2.157986267535572,4.633719912885442,0.23260825447370626,0.29357010737392053
2500,1722852798,1722856398,3600,0.13322012715613785,3.1914441631806607,0.1,0.1
2501,1722856398,1722859998,3600,0.2745859817579236,3.0898735623391915,0.1,0.1
2502,1722859998,1722863598,3600,0.14403435360434336,3.0968324978330193,0.1,0.1
2503,1722863598,1722866851,3253,1.5912112704997496,4.372832005211217,0.37313248522750453,0.800424397734326
2504,1722867198,1722870777,3579,2.0656374522221195,4.4734252009750275,0.9951515116767436,0.35120700570280583
2505,1722870798,1722871959,1161,1.3143985944492549,3.8305701420970752,0.2826709875422105,0.4497984734710192
2506,1722874398,1722877049,2651,2.0023582605510954,4.647931244334863,0.8097709921964749,0.6607346620423151
2507,1722877998,1722879778,1780,1.4287084368617893,3.939212750174332,0.9715992318465883,0.1102772873949873
2508,1722881598,1722884610,3012,1.9610696028578043,4.641670921988911,0.21775172979431462,0.6905588894665426
2509,1722885198,1722885540,342,0.9726722147308916,3.4707150254064363,0.29339391629801437,0.8893304131651508
2510,1722888798,1722892398,3600,0.4841625786787186,3.0004177746121723,0.1,0.1
2511,1722892398,1722895998,3600,0.12828941297943763,3.014495117845781,0.1,0.1
2512,1722895998,1722896906,908,1.2881131582553151,4.015775172131835,0.5867071328207994,0.2583693157407776
2513,1722899598,1722903198,3600,0.4994562148210674,3.0268662218619267,0.1,0.1
2514,1722903198,1722904373,1175,1.358065104296835,4.1686184386841765,0.6605508142684648,0.8735535782766851
2515,1722906798,1722910398,3600,0.34966060395149867,3.182622695959347,0.1,0.1
2516,1722910398,1722913998,3600,0.42428134002163387,3.0458825472837407,0.1,0.1
2517,1722913998,1722917598,3600,0.36298197246622965,3.0985708596233854,0.1,0.1
2518,1722917598,1722920608,3010,2.316940841670944,4.584097242957689,0.88592260300852,0.8843481145248232
2519,1722921198,1722924451,3253,2.044489100317322,4.634403851622858,0.11940443877683529,0.8096854130345272
2520,1722924798,1722925678,880,1.378342506135252,4.010782895284025,0.6184472241307423,0.5570728384255044
2521,1722928398,1722931998,3600,0.245589297743378,3.053798072126215,0.1,0.1
2522,1722931998,1722934877,2879,2.108646544744182,4.52406646101154,0.6270909569530793,0.5311054121610317
2523,1722935598,1722938239,2641,2.0846646978484573,4.679124815960287,0.7591189966078481,0.19374887085951256
2524,1722939198,1722942798,3600,0.408220640632568,3.1230010269062354,0.1,0.1
2525,1722942798,1722946398,3600,0.22843901359784127,3.0975804221252,0.1,0.1
2526,1722946398,1722949670,3272,1.584438605359093,4.5760998431806446,0.9330847543814812,0.1578714070145729
2527,1722949998,1722953531,3533,1.768868629684725,4.503121557381462,0.17349512435793463,0.9798728883360581
2528,1722953598,1722955544,1946,2.3599871300569597,4.482305792549509,0.6546348805512023,0.6795772757198062
2529,1722957198,1722957608,410,0.6041414303885229,3.4879201048707484,0.938071252520924,0.4925855017670201
2530,1722960798,1722962809,2011,2.185263419970534,4.5228298296377885,0.6954488466538298,0.7971596147975188
2531,1722964398,1722967998,3600,0.4122018355011905,3.169854683925812,0.1,0.1
2532,1722967998,1722971598,3600,0.3219501478794865,3.0588747124442177,0.1,0.1
2533,1722971598,1722975198,3600,0.19882452324658298,3.019739870214316,0.1,0.1
2534,1722975198,1722978798,3600,0.3316430475006744,3.1366794504213145,0.1,0.1
2535,1722978798,1722982398,3600,0.18094027210766372,3.0043036191240597,0.1,0.1
2536,1722982398,1722983192,794,1.2948008519960699,4.008273790802788,0.16386443317728877,0.942855369053783
2537,1722985998,1722986162,164,0.53168031342953,3.5341277907985167,0.11850759157947535,0.7629406027516809
2538,1722989598,1722993198,3600,0.49177542006111574,3.0021894586004323,0.1,0.1
2539,1722993198,1722994710,1512,1.1723444402547347,4.139027321074701,0.10270814737800976,0.6491168152743771
2540,1722996798,1723000398,3600,0.11097877098085279,3.1971269947899956,0.1,0.1
2541,1723000398,1723003998,3600,0.16828312579116084,3.1634461892216112,0.1,0.1
2542,1723003998,1723007598,3600,0.495576945107277,3.0009262032261512,0.1,0.1
2543,1723007598,1723011198,3600,0.38539233665680905,3.061270672510616,0.1,0.1
2544,1723011198,1723014798,3600,0.25239057089051264,3.087813851852441,0.1,0.1
2545,1723014798,1723018398,3600,0.10409101593705189,3.1849630246357186,0.1,0.1
2546,1723018398,1723021998,3600,0.431400483681707,3.002220514930425,0.1,0.1
2547,1723021998,1723025598,3600,0.21424658515084533,3.0241417214816853,0.1,0.1
2548,1723025598,1723027189,1591,1.0651118604933556,4.081673227443919,0.7331792612181406,0.2709645018277183
2549,1723029198,1723029931,733,1.3184441846247985,3.9809770769423025,0.8886452955732023,0.3603205619440887
2550,1723032798,1723036398,3600,0.4215945585908465,3.1636378205275237,0.1,0.1
2551,1723036398,1723039998,3600,0.40969001358913804,3.0637362033252384,0.1,0.1
2552,1723039998,1723043598,3600,0.4054446905902622,3.1844076361681335,0.1,0.1
2553,1723043598,1723047118,3520,2.270431395418521,4.372270270172674,0.49473407136576686,0.8053180567535932
2554,1723047198,1723050798,3600,0.4542385410545967,3.19827393076077,0.1,0.1
2555,1723050798,1723054398,3600,0.17221454150887971,3.066611733536376,0.1,0.1
2556,1723054398,1723057998,3600,0.30574519660544236,3.011656884217111,0.1,0.1
2557,1723057998,1723061598,3600,0.3989543886028889,3.0780433708873978,0.1,0.1
2558,1723061598,1723062658,1060,1.171842605381391,3.8214294797744763,0.5055019968063534,0.9585018580426125
2559,1723065198,1723068798,3600,0.16069473506512122,3.10717273777594,0.1,0.1
2560,1723068798,1723072324,3526,1.968291060887573,4.401660921089916,0.8581079719032878,0.42406686131657567
2561,1723072398,1723073007,609,1.0380431401739596,3.837080165811612,0.9575510103881374,0.44169674776405343
2562,1723075998,1723079084,3086,1.716056991583071,4.667876394331744,0.20156637697259366,0.1221665052283413
2563,1723079598,1723083198,3600,0.19669436544636065,3.044628676126353,0.1,0.1
2564,1723083198,1723086798,3600,0.11789544862317554,3.169140774071978,0.1,0.1
2565,1723086798,1723088653,1855,2.433812623555318,4.534352599492678,0.12120899926929657,0.29425407582598795
2566,1723090398,1723091790,1392,1.3960910580866388,3.8279790991768454,0.2496001392880831,0.9348918706600401
2567,1723093998,1723096977,2979,1.9025603434307847,4.327840455595984,0.8800024516285025,0.4391467801517043
2568,1723097598,1723101198,3600,0.28253766290471494,3.055432790575552,0.1,0.1
2569,1723101198,1723104798,3600,0.4347793109817494,3.097793125362034,0.1,0.1
2570,1723104798,1723108398,3600,0.3015611931416693,3.0086001758459737,0.1,0.1
2571,1723108398,1723111998,3600,0.11521139841052493,3.053044446519668,0.1,0.1
2572,1723111998,1723113943,1945,2.0711695737164044,4.473996288078777,0.4072316753845918,0.6886867312292969
2573,1723115598,1723117180,1582,1.1596590139353973,4.13847502945153,0.834849884790795,0.7293232756511759
2574,1723119198,1723122798,3600,0.17893126128056067,3.0807261390993568,0.1,0.1
2575,1723122798,1723124336,1538,1.0162253420096818,4.180985910247514,0.9936586508684779,0.3662818298957945
2576,1723126398,1723126557,159,0.8830561721877235,3.4803997537139257,0.4385048232272637,0.33233092658611807
2577,1723129998,1723133598,3600,0.1671739990727421,3.1649324195087476,0.1,0.1
2578,1723133598,1723134616,1018,1.0136085686363328,3.9804374276352705,0.3186697297729171,0.19238303116838357
2579,1723137198,1723140798,3600,0.2954515006891943,3.1785690867468275,0.1,0.1
2580,1723140798,1723141776,978,1.3424189794727857,3.8123765387011392,0.18241404679390688,0.8567998850411593
2581,1723144398,1723147165,2767,2.458210440879621,4.646126499630259,0.31420681522738664,0.17485914215928827
2582,1723147998,1723151598,3600,0.2238563412816162,3.078011961134903,0.1,0.1
2583,1723151598,1723155198,3600,0.42894031453934645,3.014514888700455,0.1,0.1
2584,1723155198,1723158798,3600,0.3557211574179877,3.198500671847114,0.1,0.1
2585,1723158798,1723159995,1197,1.0132788169804563,3.936405055447866,0.28842038611043663,0.2906045861514517
2586,1723162398,1723165397,2999,2.334863194229308,4.571011068010905,0.8838366680081443,0.20475816294086255
2587,1723165998,1723166537,539,0.8649283269763286,3.524361161638625,0.997539253175548,0.7392989197636426
2588,1723169598,1723171482,1884,2.431339628797306,4.375068122899487,0.6960268441933519,0.5523364695856426
2589,1723173198,1723176779,3581,2.4228784321055676,4.4790478052615965,0.6273487188943264,0.13732149619258233
2590,1723176798,1723180398,3600,0.12487824402027532,3.1662098198600357,0.1,0.1
2591,1723180398,1723183998,3600,0.34336469775452316,3.1674705922727155,0.1,0.1
2592,1723183998,1723184997,999,1.4191154037012992,4.060641413646395,0.1841904405947092,0.23212771888618147
2593,1723187598,1723189858,2260,2.0156682741025365,4.602369498156622,0.7113380936042244,0.4604089721113569
2594,1723191198,1723194663,3465,1.9424882428424115,4.483436557118485,0.20389662867623426,0.9692725195913829
2595,1723194798,1723198398,3600,0.15597350708112936,3.090227328328465,0.1,0.1
2596,1723198398,1723201998,3600,0.4158340118558411,3.0431762682389607,0.1,0.1
2597,1723201998,1723205598,3600,0.1971884695259546,3.1017136203984954,0.1,0.1
2598,1723205598,1723207871,2273,1.7151103776482504,4.3092386493239925,0.6343908109924271,0.1912506701084795
2599,1723209198,1723210652,1454,1.1222417727457528,4.1776488523345225,0.6745783843545944,0.31009997052128524
2600,1723212798,1723216398,3600,0.43166292375056425,3.0113718545848767,0.1,0.1
2601,1723216398,1723219998,3600,0.28813781146154943,3.197231220305197,0.1,0.1
2602,1723219998,1723221188,1190,1.0664349588464628,3.822380094613436,0.5437922963833893,0.9934046233131787
2603,1723223598,1723224611,1013,1.0125463669353292,3.9118799342185406,0.41072069619744833,0.5369138354410345
2604,1723227198,1723230798,3600,0.17685184479177474,3.095176359322401,0.1,0.1
2605,1723230798,1723232979,2181,2.2662998062425657,4.660546735523682,0.3062499329444055,0.2040632653829902
2606,1723234398,1723237998,3600,0.4487478185786794,3.1523234897810894,0.1,0.1
2607,1723237998,1723241598,3600,0.15976740240738452,3.0639739686134684,0.1,0.1
2608,1723241598,1723243608,2010,2.249792492940752,4.612860827008085,0.2983853984330299,0.27663150721215857
2609,1723245198,1723247338,2140,2.4486503994966435,4.329942715151984,0.39578915962383465,0.13482038900838592
2610,1723248798,1723251967,3169,2.047655766395853,4.556995231492807,0.36301687640180935,0.6589867034149142
2611,1723252398,1723253398,1000,1.2371154512087532,4.1914629435219775,0.5696445127174198,0.9277203368982254
2612,1723255998,1723259598,3600,0.4550337015206668,3.1488557292966806,0.1,0.1
2613,1723259598,1723263198,3600,0.32556636852858,3.1637671899811832,0.1,0.1
2614,1723263198,1723264641,1443,1.027897288591691,4.123212194600241,0.8950270343605301,0.9363625689450119
2615,1723266798,1723270398,3600,0.3564915833377157,3.1971681862847703,0.1,0.1
2616,1723270398,1723273998,3600,0.4706793577757957,3.1597609642814044,0.1,0.1
2617,1723273998,1723277598,3600,0.21595908077337567,3.160559925867556,0.1,0.1
2618,1723277598,1723279937,2339,2.2881442502118614,4.617614325147146,0.8745764284798575,0.4095461054378593
2619,1723281198,1723284798,3600,0.4608216319672165,3.090803361759862,0.1,0.1
2620,1723284798,1723288398,3600,0.21381703656997209,3.0587723709143715,0.1,0.1
2621,1723288398,1723291998,3600,0.2887994973499982,3.0902602753102824,0.1,0.1
2622,1723291998,1723295095,3097,1.9918830006917414,4.449047147318355,0.31303455292495846,0.48495750180451136
2623,1723295598,1723298911,3313,2.044692101609155,4.682067210900297,0.30438295417262734,0.2496093265438003
2624,1723299198,1723302798,3600,0.3183651007654009,3.1891707973387473,0.1,0.1
2625,1723302798,1723306398,3600,0.4464203982426661,3.1222204714953783,0.1,0.1
2626,1723306398,1723309998,3600,0.2155131738491398,3.1988056729143306,0.1,0.1
2627,1723309998,1723313598,3600,0.45371132462886943,3.084503172719058,0.1,0.1
2628,1723313598,1723315468,1870,1.7787888006530155,4.502015474852524,0.302252418054646,0.9725968505444579
2629,1723317198,1723318339,1141,1.3357149476538035,4.089192414759759,0.7396038253288272,0.9966339924063489
2630,1723320798,1723324398,3600,0.4813720409636273,3.134355069793466,0.1,0.1
2631,1723324398,1723325264,866,1.471793973245128,4.108222812729091,0.39408419932288263,0.24524953013696196
2632,1723327998,1723328540,542,0.6430530345545717,3.6523090746227043,0.21485603081529558,0.8023429301941845
2633,1723331598,1723335198,3600,0.18320610325328743,3.197350663983603,0.1,0.1
2634,1723335198,1723337870,2672,1.9288370173219678,4.688478390670675,0.49900933576310813,0.35642874798701785
2635,1723338798,1723342398,3600,0.36576441633931345,3.017758249624579,0.1,0.1
2636,1723342398,1723345998,3600,0.47809982214101676,3.1144477814713176,0.1,0.1
2637,1723345998,1723349476,3478,2.4860707275452545,4.525673648027097,0.3060119703714822,0.8951522994922378
2638,1723349598,1723353198,3600,0.13120125883846648,3.146920225110389,0.1,0.1
2639,1723353198,1723355443,2245,2.1655296415315792,4.51061467066541,0.1133816339192956,0.2756672447326961
2640,1723356798,1723360398,3600,0.3995041103376188,3.1886273839792656,0.1,0.1
2641,1723360398,1723363998,3600,0.35530066031275076,3.188386686861559,0.1,0.1
2642,1723363998,1723367598,3600,0.3630306012737925,3.110911355605112,0.1,0.1
2643,1723367598,1723370626,3028,1.6242734343893699,4.439637988608322,0.48702933121128966,0.5693459448489657
2644,1723371198,1723374798,3600,0.40868332431229315,3.150026747232336,0.1,0.1
2645,1723374798,1723375770,972,1.2719453149141902,3.9609398235919597,0.20735965647362198,0.19364267849884648
2646,1723378398,1723381787,3389,1.9927120377807535,4.433936858323348,0.7414627086512333,0.30088966375700077
2647,1723381998,1723383624,1626,1.300331573832767,3.9614373735523283,0.6282302978643327,0.1729593031903373
2648,1723385598,1723386245,647,1.1916712787732466,4.024815733406311,0.36693607888745405,0.2701340137122754
2649,1723389198,1723390720,1522,1.0220217255339548,3.975559226809154,0.7927250458862382,0.9759320747981349
2650,1723392798,1723396398,3600,0.10205372571813137,3.1224571943836517,0.1,0.1
2651,1723396398,1723399518,3120,2.2958373161580483,4.380201148998192,0.36182250150721396,0.7188614067961167
2652,1723399998,1723403481,3483,2.1361971902490087,4.612528407015486,0.27244262467657965,0.1667839414607722
2653,1723403598,1723407198,3600,0.46243932726087045,3.0766974336747936,0.1,0.1
2654,1723407198,1723409014,1816,1.925506259518777,4.458289282406562,0.9019992895531942,0.5900907343169723
2655,1723410798,1723413925,3127,2.472601833025724,4.387779720936576,0.936383864820932,0.41470168363732074
2656,1723414398,1723416371,1973,2.2744018027992805,4.5875777570756116,0.2736558823273734,0.5877724292149139
2657,1723417998,1723420406,2408,2.423667164150903,4.528166443232325,0.4215623422162801,0.15898051188505574
2658,1723421598,1723425198,3600,0.47593386500530455,3.021122945522076,0.1,0.1
2659,1723425198,1723428798,3600,0.10763752335574886,3.040688007430916,0.1,0.1
2660,1723428798,1723428880,82,0.62702018105062,3.58411548522628,0.33762791517857804,0.6593899944903729
2661,1723432398,1723435833,3435,1.6268092870592237,4.591004450297741,0.4451813257281101,0.6559022644518255
2662,1723435998,1723439201,3203,2.4445202428653037,4.423505383991125,0.19090906235555488,0.5546844956593686
2663,1723439598,1723442427,2829,2.004029233874422,4.384003556811464,0.12462738184773231,0.49155680551236447
2664,1723443198,1723446435,3237,2.3621585214855454,4.53500660868088,0.7928035389364247,0.377500365374412
2665,1723446798,1723448281,1483,1.078545416700756,3.9693766296640334,0.178930027441502,0.8274856913177222
2666,1723450398,1723453998,3600,0.23902222695897432,3.1072338611381816,0.1,0.1
2667,1723453998,1723456668,2670,1.7477987562857127,4.596121252992624,0.6828657473154499,0.15392230220623918
2668,1723457598,1723459085,1487,1.2480645442986207,4.187109898118273,0.669304236280442,0.17781643495712623
2669,1723461198,1723464798,3600,0.4465606870001967,3.034750986696668,0.1,0.1
2670,1723464798,1723464981,183,0.6772885316207133,3.5576608317402956,0.31067780344367946,0.7836633860497071
2671,1723468398,1723471998,3600,0.4359848101802959,3.1687695201489188,0.1,0.1
2672,1723471998,1723475598,3600,0.3941372830787133,3.0974937749623224,0.1,0.1
2673,1723475598,1723475887,289,0.7794672727246876,3.5553038642086245,0.43159241641501245,0.44019567432873963
2674,1723479198,1723480992,1794,1.294184527288061,4.0697178854167895,0.4621072379312059,0.4610217758286317
2675,1723482798,1723486398,3600,0.3256134381778948,3.063719646862555,0.1,0.1
2676,1723486398,1723489159,2761,1.8426549565045596,4.5031863093420235,0.5522058319908539,0.24213274209420776
2677,1723489998,1723493598,3600,0.39083540951052764,3.0664788375385434,0.1,0.1
2678,1723493598,1723497198,3600,0.2855849850950623,3.0877704822816674,0.1,0.1
2679,1723497198,1723500798,3600,0.21389180386292753,3.1089234691888743,0.1,0.1
2680,1723500798,1723501977,1179,1.1757515374320053,3.992219536894103,0.26269139965751365,0.5350305045640696
2681,1723504398,1723507998,3600,0.4457329494509449,3.0446489536682972,0.1,0.1
2682,1723507998,1723509969,1971,2.4526721609465247,4.428600261565166,0.10111051454212129,0.7215967324143101
2683,1723511598,1723515198,3600,0.33511078977676656,3.062300763264179,0.1,0.1
2684,1723515198,1723518798,3600,0.23224015290942673,3.17990912263943,0.1,0.1
2685,1723518798,1723522398,3600,0.4029043815705916,3.1163456635533895,0.1,0.1
2686,1723522398,1723524763,2365,1.999035910212087,4.598431088287076,0.8332397510968214,0.8586800214262662
2687,1723525998,1723528550,2552,1.782892079502121,4.467804747225002,0.7023941002067673,0.948414424158508
2688,1723529598,1723532992,3394,1.582535302359879,4.660962726826756,0.251496613554102,0.49509105716267743
2689,1723533198,1723536798,3600,0.2131935810441967,3.1789741232973037,0.1,0.1
2690,1723536798,1723540398,3600,0.287783043328908,3.1518829698364947,0.1,0.1
2691,1723540398,1723540760,362,0.5582823479484657,3.314856152688835,0.28356035144080477,0.7593486032348364
2692,1723543998,1723547598,3600,0.4154396228720837,3.1725624765416303,0.1,0.1
2693,1723547598,1723551198,3600,0.2801577309529391,3.072003892831182,0.1,0.1
2694,1723551198,1723554798,3600,0.21497169794622628,3.040958746039285,0.1,0.1
2695,1723554798,1723558398,3600,0.14355306025201917,3.0325747502407734,0.1,0.1
2696,1723558398,1723560538,2140,2.173415116236148,4.575897348218156,0.4921505611825234,0.35679805700920497
2697,1723561998,1723565598,3600,0.3116178199919052,3.0476467893591748,0.1,0.1
2698,1723565598,1723565786,188,0.6684702444621686,3.332569582083531,0.413658365480544,0.5881137241162098
2699,1723569198,1723572798,3600,0.4691014995739652,3.147706803270499,0.1,0.1
2700,1723572798,1723573005,207,0.7650871413079696,3.518247799836919,0.9252142290489118,0.3324754703988262
2701,1723576398,1723579998,3600,0.4536408448386626,3.169041867874806,0.1,0.1
2702,1723579998,1723583598,3600,0.30023821924070093,3.1364540811273796,0.1,0.1
2703,1723583598,1723585817,2219,1.8606775704122014,4.674399037656135,0.8751722555746438,0.7321886890525824
2704,1723587198,1723589355,2157,2.4871890541435966,4.677107900081801,0.8529050242717127,0.5670967989030418
2705,1723590798,1723594322,3524,1.6229366549919644,4.470812141535802,0.2551635353748421,0.5787595518788191
2706,1723594398,1723597836,3438,1.9582779440205211,4.511789320238175,0.31666844597622557,0.8424894054689648
2707,1723597998,1723601598,3600,0.10106294730570396,3.1684112284931825,0.1,0.1
2708,1723601598,1723605198,3600,0.14343875136740564,3.13065192166366,0.1,0.1
2709,1723605198,1723606579,1381,1.1881190566499629,3.875875295824409,0.45592376976645455,0.16086252218793534
2710,1723608798,1723612398,3600,0.17949553333268145,3.0929273501842927,0.1,0.1
2711,1723612398,1723615587,3189,2.243195723989506,4.4026542637624795,0.2890827084983796,0.28299005022309975
2712,1723615998,1723619598,3600,0.12089574601058924,3.035567791584276,0.1,0.1
2713,1723619598,1723623198,3600,0.26894477878969103,3.0564227236951225,0.1,0.1
2714,1723623198,1723624838,1640,1.0690300424202999,3.9301893231698823,0.6474412302695246,0.619253119731395
2715,1723626798,1723628348,1550,1.3992106997678777,3.889712564311743,0.42976377959671574,0.5164014332649437
2716,1723630398,1723631174,776,1.0314398575769317,3.9635808050679646,0.8546314741802169,0.27732201568837844
2717,1723633998,1723637598,3600,0.35484393348386534,3.1276650966464343,0.1,0.1
2718,1723637598,1723641198,3600,0.1598468270802581,3.193317084689593,0.1,0.1
2719,1723641198,1723643960,2762,1.8614405604714794,4.398589127479589,0.5483026145281614,0.23092481668626702
2720,1723644798,1723648398,3600,0.4964541201571758,3.1861643274541582,0.1,0.1
2721,1723648398,1723651052,2654,2.2370845329527524,4.357955507574355,0.766075524931861,0.5450899009125909
2722,1723651998,1723655598,3600,0.3006062543784767,3.1911560016751093,0.1,0.1
2723,1723655598,1723659198,3600,0.41610346406034326,3.0658699240836715,0.1,0.1
2724,1723659198,1723662798,3600,0.49830497284493613,3.065500222025083,0.1,0.1
2725,1723662798,1723666398,3600,0.33129569859211905,3.0526785267288794,0.1,0.1
2726,1723666398,1723669462,3064,1.6826000485045713,4.5846197786359415,0.60975072988371,0.8583249843145124
2727,1723669998,1723673598,3600,0.4693361939073718,3.196664460334666,0.1,0.1
2728,1723673598,1723677198,3600,0.33313159517718227,3.1865771687190447,0.1,0.1
2729,1723677198,1723677646,448,0.9440927184600165,3.3695835364879816,0.5951594066436142,0.2147901844468723
2730,1723680798,1723684398,3600,0.41333884949731137,3.1675155550740866,0.1,0.1
2731,1723684398,1723686060,1662,1.3343473384278135,4.022120229243848,0.9661532316384978,0.4132053839464317
2732,1723687998,1723689519,1521,1.2022360501641727,3.9371852518517407,0.8101615964778637,0.8651670369003258
2733,1723691598,1723695198,3600,0.4752901941019432,3.1947190335444273,0.1,0.1
2734,1723695198,1723698798,3600,0.24898721585736616,3.1057388205261067,0.1,0.1
2735,1723698798,1723702398,3600,0.43250684248030413,3.08300155843949,0.1,0.1
2736,1723702398,1723705998,3600,0.28986210429883996,3.1211298658868802,0.1,0.1
2737,1723705998,1723709598,3600,0.44119678561876374,3.007850043072174,0.1,0.1
2738,1723709598,1723713198,3600,0.1534244065741518,3.0989034897905614,0.1,0.1
2739,1723713198,1723716798,3600,0.23230586384224394,3.054710088600048,0.1,0.1
2740,1723716798,1723720398,3600,0.1420337127724939,3.117924771398624,0.1,0.1
2741,1723720398,1723723998,3600,0.2777460779599785,3.000124862957027,0.1,0.1
2742,1723723998,1723727598,3600,0.2631001799206927,3.1394249220155364,0.1,0.1
2743,1723727598,1723731198,3600,0.288852652837244,3.1162511452660127,0.1,0.1
2744,1723731198,1723733797,2599,2.138354794298226,4.383773388539964,0.48708006862409314,0.49432747721312054
2745,1723734798,1723738398,3600,0.32302574123605365,3.176057308427437,0.1,0.1
2746,1723738398,1723741078,2680,2.2992383206158413,4.652894505182408,0.6673503534478291,0.651989970244144
2747,1723741998,1723745598,3600,0.44923592808348267,3.1545262348269953,0.1,0.1
2748,1723745598,1723749198,3600,0.3022472899339457,3.0616088255337135,0.1,0.1
2749,1723749198,1723752798,3600,0.40909531039459834,3.1643554505464837,0.1,0.1
2750,1723752798,1723755720,2922,2.127716450724246,4.563237296278355,0.1782840899198983,0.4134754044213723
2751,1723756398,1723759998,3600,0.2626744013491348,3.037941659057485,0.1,0.1
2752,1723759998,1723763598,3600,0.44790191166739324,3.1290017105009613,0.1,0.1
2753,1723763598,1723765873,2275,1.6617791223962244,4.426251274614828,0.9802895455828712,0.2791483916382005
2754,1723767198,1723770798,3600,0.3247796511578971,3.188312289179741,0.1,0.1
2755,1723770798,1723774398,3600,0.39729822636160883,3.027914342284973,0.1,0.1
2756,1723774398,1723777998,3600,0.354114867554281,3.1352064955590473,0.1,0.1
2757,1723777998,1723781598,3600,0.26922347761254245,3.087275037198205,0.1,0.1
2758,1723781598,1723785198,3600,0.34125638572205474,3.1658008058745364,0.1,0.1
2759,1723785198,1723788798,3600,0.48931397608733473,3.159398900121885,0.1,0.1
2760,1723788798,1723791167,2369,1.983306743417304,4.668608530830275,0.8046181835834514,0.5154413711120864
2761,1723792398,1723795998,3600,0.25994999994767964,3.132355805522104,0.1,0.1
2762,1723795998,1723797826,1828,1.6319485497392763,4.454043233217495,0.8624156918565373,0.19430452649852778
2763,1723799598,1723803198,3600,0.18039147468553152,3.1250926448224585,0.1,0.1
2764,1723803198,1723805283,2085,2.2977735685379637,4.642892014228465,0.4127216321312617,0.10151762289622934
2765,1723806798,1723808247,1449,1.2195031765857944,4.0321959433683165,0.24484762522748457,0.8432006301460536
2766,1723810398,1723812456,2058,2.0208165113044645,4.440148864073791,0.6301266713060301,0.6150876977575447
2767,1723813998,1723814698,700,1.3276435695177438,4.157958698390236,0.31072233276647565,0.8516967626768874
2768,1723817598,1723818210,612,1.4992548231036533,4.059053471027378,0.6896815144882958,0.4790845082955062
2769,1723821198,1723824798,3600,0.2609287637111173,3.070896151512666,0.1,0.1
2770,1723824798,1723827501,2703,2.3816188750078098,4.690321867522723,0.6387668233772205,0.35213175188224166
2771,1723828398,1723831998,3600,0.16687335073586135,3.0574949771891604,0.1,0.1
2772,1723831998,1723833059,1061,1.0503818338990216,4.054129939055812,0.35717006639554005,0.7004577782282958
2773,1723835598,1723839198,3600,0.35278766313231613,3.075783976670356,0.1,0.1
2774,1723839198,1723840286,1088,1.1002201647731902,4.010282264874005,0.8343809235386994,0.6838727547738523
2775,1723842798,1723843992,1194,1.314345848327107,3.9204084809204236,0.4427939914551804,0.3744036538997667
2776,1723846398,1723849998,3600,0.21107919639432748,3.1184068481036267,0.1,0.1
2777,1723849998,1723853598,3600,0.23062529990868263,3.067872330567637,0.1,0.1
2778,1723853598,1723854179,581,0.7073363018886518,3.3797606759825456,0.38005804841951385,0.558334309846444
2779,1723857198,1723859709,2511,2.3550493247477835,4.660475195151305,0.5242641354974784,0.2702320675193388
2780,1723860798,1723864398,3600,0.17517633792023923,3.041520854454298,0.1,0.1
2781,1723864398,1723865528,1130,1.2167834313341133,3.8677314467895574,0.16542372372842784,0.9289404525573158
2782,1723867998,1723870923,2925,1.5532230155448177,4.387381517537678,0.9104088249213713,0.6709935353100578
2783,1723871598,1723875198,3600,0.4770559350183585,3.17367627338795,0.1,0.1
2784,1723875198,1723878798,3600,0.4000000620094809,3.1423839563902773,0.1,0.1
2785,1723878798,1723882236,3438,1.7696061331066004,4.301823366121714,0.5592645699645777,0.7490922616792562
2786,1723882398,1723885998,3600,0.1867435679408622,3.154319712922847,0.1,0.1
2787,1723885998,1723888740,2742,2.2052856775135217,4.407638044662237,0.15136647998349403,0.8009383735489182
2788,1723889598,1723889969,371,0.6964271149732953,3.3188694596469204,0.9921133039406287,0.7506412018989798
2789,1723893198,1723896798,3600,0.19896607002132602,3.182610427018564,0.1,0.1
2790,1723896798,1723900398,3600,0.19393224294528874,3.1892320803044356,0.1,0.1
2791,1723900398,1723902651,2253,1.7173245255206369,4.656478385372105,0.397924056692717,0.5508175080014381
2792,1723903998,1723904592,594,0.993600769312158,3.505562322979153,0.7347090142745751,0.7233367638909085
2793,1723907598,1723910188,2590,1.6329533068866517,4.54553114683961,0.2958651961949258,0.6073233718245019
2794,1723911198,1723913588,2390,2.460088977077415,4.578996443257223,0.4452512208557654,0.9730568574990535
2795,1723914798,1723917929,3131,2.333576919698068,4.336775370228241,0.6443260256519108,0.8455845920150632
2796,1723918398,1723921998,3600,0.22407347858118812,3.1886821030112404,0.1,0.1
2797,1723921998,1723925302,3304,1.735458398570912,4.5190380007766455,0.582635823140704,0.15663503444203924
2798,1723925598,1723929198,3600,0.4075407719835691,3.0933968996169003,0.1,0.1
2799,1723929198,1723932413,3215,2.0751723834727187,4.601652709410264,0.23458514288603433,0.3433668439246569
2800,1723932798,1723935726,2928,2.2871817514903854,4.315581741552644,0.3447809887759593,0.2374912292586753
2801,1723936398,1723939998,3600,0.20560523100762979,3.060919089710464,0.1,0.1
2802,1723939998,1723940112,114,0.5357467782230119,3.4373934813441527,0.3110412705375005,0.803312473946459
2803,1723943598,1723947198,3600,0.49307826857915626,3.1642614879133486,0.1,0.1
2804,1723947198,1723947369,171,0.7672650341027929,3.413300091000321,0.794766817171569,0.3459735945650304
2805,1723950798,1723952879,2081,1.8867712560203116,4.465641464360097,0.4673197390797009,0.3733344972458278
2806,1723954398,1723957998,3600,0.4054437094960005,3.0310963031321116,0.1,0.1
2807,1723957998,1723960638,2640,1.8602809846578385,4.491124753043646,0.9606867000122232,0.7206420193231532
2808,1723961598,1723965198,3600,0.2238806044961329,3.132574303972214,0.1,0.1
2809,1723965198,1723968798,3600,0.3589266103097234,3.0873760192549273,0.1,0.1
2810,1723968798,1723972398,3600,0.2610995331167204,3.0612586097139127,0.1,0.1
2811,1723972398,1723975998,3600,0.4486980314029472,3.0514925645869826,0.1,0.1
2812,1723975998,1723978526,2528,1.9052766033098014,4.344896497152502,0.36265700065843554,0.24961664626886249
2813,1723979598,1723981933,2335,2.159580045744273,4.645461956398844,0.5907444911164802,0.7528202548165862
2814,1723983198,1723986798,3600,0.11028055503373731,3.1798745770483294,0.1,0.1
2815,1723986798,1723987826,1028,1.3416562731442552,4.028302788808876,0.22612008080819673,0.5292081523654396
2816,1723990398,1723993998,3600,0.3256468300259357,3.1840789201292483,0.1,0.1
2817,1723993998,1723996307,2309,1.7835616608964031,4.5206996115811044,0.1519133369580842,0.8830376705845262
2818,1723997598,1724001198,3600,0.16051724308767146,3.017402963414046,0.1,0.1
2819,1724001198,1724001331,133,0.5283406472690949,3.410670170369558,0.5263552656102968,0.18655703694538028
2820,1724004798,1724007873,3075,1.816469014269976,4.389742753950543,0.19395355750862947,0.2517565708321867
2821,1724008398,1724011998,3600,0.1892581742989668,3.1508667448878525,0.1,0.1
2822,1724011998,1724015162,3164,1.9801435405742942,4.450427925727317,0.4004086436787938,0.46682602898161785
2823,1724015598,1724019198,3600,0.31215100825398046,3.0513171771343526,0.1,0.1
2824,1724019198,1724022798,3600,0.30091748855566025,3.1519263626671483,0.1,0.1
2825,1724022798,1724026398,3600,0.3027024678671252,3.019567461732068,0.1,0.1
2826,1724026398,1724029998,3600,0.34192327702934106,3.194218390542961,0.1,0.1
2827,1724029998,1724033598,3600,0.11010126940473484,3.00377045541219,0.1,0.1
2828,1724033598,1724034582,984,1.0714827268070812,4.0351096588063164,0.6517767123739844,0.8687727289361098
2829,1724037198,1724040798,3600,0.4713694067058284,3.032681111494666,0.1,0.1
2830,1724040798,1724044398,3600,0.4137913509611828,3.1001089042067074,0.1,0.1
2831,1724044398,1724047201,2803,2.096538236256774,4.6612469243011,0.8360440512342285,0.7733433690222554
2832,1724047998,1724049065,1067,1.1942197317342031,4.104204739972409,0.4069745961435317,0.8699017477625066
2833,1724051598,1724055198,3600,0.19008727371411746,3.062606109682064,0.1,0.1
2834,1724055198,1724058798,3600,0.11871882470827409,3.071354433178037,0.1,0.1
2835,1724058798,1724059799,1001,1.001848225145897,4.055627922840742,0.6742993571785999,0.14464859534459426
2836,1724062398,1724065998,3600,0.2010207786087892,3.1238502355708024,0.1,0.1
2837,1724065998,1724069598,3600,0.4084051273740662,3.0563424632378617,0.1,0.1
2838,1724069598,1724073198,3600,0.1669712777513436,3.1056437497205223,0.1,0.1
2839,1724073198,1724073963,765,1.3492301605346888,3.8235814915887167,0.2936598171451178,0.48561109806159386
2840,1724076798,1724078927,2129,1.5556873893274936,4.602466755009069,0.46423492316631365,0.9900849285157094
2841,1724080398,1724083998,3600,0.23275939209025884,3.0237291179837738,0.1,0.1
2842,1724083998,1724087598,3600,0.4395819694495505,3.0824185411115055,0.1,0.1
2843,1724087598,1724089968,2370,2.1444390180546558,4.590659617884065,0.2061496096458364,0.17779893448006162
2844,1724091198,1724094798,3600,0.3723758239332414,3.195033012284009,0.1,0.1
2845,1724094798,1724098398,3600,0.43498754618226676,3.1307192951724523,0.1,0.1
2846,1724098398,1724101998,3600,0.49297596138059163,3.1735102642677475,0.1,0.1
2847,1724101998,1724104275,2277,1.9287285885603516,4.325751968559436,0.18511560275728273,0.5604361815816329
2848,1724105598,1724109198,3600,0.19864781115235758,3.0094047314907892,0.1,0.1
2849,1724109198,1724109655,457,0.5243484945639558,3.6910716688510274,0.10973159217794769,0.7217266141152247
2850,1724112798,1724114790,1992,2.3042443578251524,4.5805814991809095,0.623738759693479,0.7934441584812854
2851,1724116398,1724119998,3600,0.3562522107999022,3.0358367788083487,0.1,0.1
2852,1724119998,1724122595,2597,2.3620918297112197,4.4626005182379185,0.9784792055831211,0.3787704189808965
2853,1724123598,1724127198,3600,0.14055377501036898,3.117755997132038,0.1,0.1
2854,1724127198,1724128882,1684,1.0996868857113467,3.926589781888021,0.4368465184816438,0.11010658009898282
2855,1724130798,1724134398,3600,0.43992465612926435,3.0907586030466248,0.1,0.1
2856,1724134398,1724136871,2473,2.327265082724595,4.534489504373675,0.42490298524751335,0.2267248889612244
2857,1724137998,1724141598,3600,0.2934021866522921,3.034458787692915,0.1,0.1
2858,1724141598,1724145198,3600,0.3337442473108718,3.1748998852123416,0.1,0.1
2859,1724145198,1724147799,2601,1.524292637881161,4.477946038226331,0.19529822731882157,0.8681126452506571
2860,1724148798,1724152398,3600,0.32004955310172023,3.023517721560485,0.1,0.1
2861,1724152398,1724155588,3190,1.8636360112317922,4.543662024739707,0.21774807539202834,0.9133598661712025
2862,1724155998,1724158413,2415,2.419350819046439,4.53241369685729,0.6619094716380446,0.6641368321956087
2863,1724159598,1724163198,3600,0.13082799784203478,3.134845042399318,0.1,0.1
2864,1724163198,1724165643,2445,1.5941622823828894,4.504289144088414,0.853926765987708,0.3555843503079553
2865,1724166798,1724166970,172,0.8491519885006389,3.559733109493395,0.4234522937375066,0.35440486922809955
2866,1724170398,1724172781,2383,1.5704822945139252,4.556762159777616,0.2875997321172588,0.49718259245421204
2867,1724173998,1724176259,2261,2.206173272710315,4.621733270479872,0.5596123379579814,0.11832443029089307
2868,1724177598,1724181198,3600,0.328204373733214,3.1911913054730228,0.1,0.1
2869,1724181198,1724182853,1655,1.4150548220587256,4.182860600171521,0.5330778584742217,0.30246696593475225
2870,1724184798,1724186447,1649,1.0198451861750684,4.157772875561548,0.5860548163431113,0.29366837281775937
2871,1724188398,1724191998,3600,0.19734460534065745,3.178180475128646,0.1,0.1
2872,1724191998,1724195598,3600,0.21085748697145063,3.028750314566734,0.1,0.1
2873,1724195598,1724199198,3600,0.1587247770347645,3.137366474561231,0.1,0.1
2874,1724199198,1724202798,3600,0.3976873413745141,3.1036624372526602,0.1,0.1
2875,1724202798,1724206040,3242,1.6042212184390476,4.591711912044658,0.3010968839819487,0.5421532732799963
2876,1724206398,1724209998,3600,0.3858226379588877,3.1639153129264255,0.1,0.1
2877,1724209998,1724213598,3600,0.2676277713084664,3.131364789706221,0.1,0.1
2878,1724213598,1724216132,2534,1.894076323138639,4.331053976145131,0.263009917428666,0.8710421592280727
2879,1724217198,1724220798,3600,0.307786566120115,3.048699203333182,0.1,0.1
2880,1724220798,1724224398,3600,0.3657855946160524,3.023708926535224,0.1,0.1
2881,1724224398,1724227998,3600,0.15656619183958434,3.0882491010137185,0.1,0.1
2882,1724227998,1724228114,116,0.7917640529458793,3.5900684741528806,0.7849044573718804,0.16321970779246342
2883,1724231598,1724233996,2398,2.1879071645319117,4.649335600467358,0.976988875533122,0.7066301585080361
2884,1724235198,1724235690,492,0.7884547417114696,3.6112378770472358,0.8541471871573723,0.26062870092146334
2885,1724238798,1724242398,3600,0.32914676660346764,3.042294847423928,0.1,0.1
2886,1724242398,1724244062,1664,1.216542533988198,4.066897950228471,0.24036172067714515,0.6871300804363601
2887,1724245998,1724247630,1632,1.44791560230112,4.107360154014623,0.5449467264314463,0.3339503932661022
2888,1724249598,1724253198,3600,0.3036515809310705,3.055430879313918,0.1,0.1
2889,1724253198,1724256798,3600,0.11269636415817388,3.04140201004077,0.1,0.1
2890,1724256798,1724260398,3600,0.24885008699233244,3.130425542068063,0.1,0.1
2891,1724260398,1724260534,136,0.9092762554195797,3.319242379871903,0.5379659679313757,0.3165426464663762
2892,1724263998,1724264864,866,1.2211433516620176,4.023904535366704,0.7093351510431072,0.1174076770947599
2893,1724267598,1724271198,3600,0.2128181714522197,3.1825031914835744,0.1,0.1
2894,1724271198,1724271549,351,0.9511721492409664,3.6146411183391907,0.7733280939796564,0.7772014834679682
2895,1724274798,1724275292,494,0.6573228181898219,3.3063093139449147,0.7850706184681807,0.679713994169739
2896,1724278398,1724281288,2890,2.392280090304457,4.678056363854667,0.6308629563197775,0.17587960542938164
2897,1724281998,1724285598,3600,0.26234424561073855,3.1435391665892825,0.1,0.1
2898,1724285598,1724289198,3600,0.2481302380841707,3.185864853218722,0.1,0.1
2899,1724289198,1724292798,3600,0.11617602126358727,3.184761153823559,0.1,0.1
2900,1724292798,1724296398,3600,0.4117592920905925,3.087594113963805,0.1,0.1
2901,1724296398,1724299912,3514,2.046484311427005,4.411859410718323,0.2162004559642403,0.48432040612466265
2902,1724299998,1724303598,3600,0.37255279401814045,3.126074202742057,0.1,0.1
2903,1724303598,1724306848,3250,2.3273483995611306,4.475307286138744,0.9238684479478615,0.5804040921539286
2904,1724307198,1724309697,2499,2.208858095663331,4.662248993785967,0.6212772534818704,0.5137784151110902
2905,1724310798,1724312691,1893,1.8831534222080628,4.613385070714529,0.5846521870228915,0.12988065220598352
2906,1724314398,1724314847,449,0.9008222059100772,3.469961147673139,0.11517610044276301,0.5482007532386999
2907,1724317998,1724321598,3600,0.2163691939578905,3.1036119333920746,0.1,0.1
2908,1724321598,1724325198,3600,0.4451000610892938,3.175510868127724,0.1,0.1
2909,1724325198,1724328798,3600,0.4752368933945088,3.1322471514669137,0.1,0.1
2910,1724328798,1724332398,3600,0.15012920469473023,3.0612729579008695,0.1,0.1
2911,1724332398,1724334381,1983,2.350478422952722,4.380622947842204,0.5947388544966993,0.8335845552735489
2912,1724335998,1724337218,1220,1.1015945853910654,4.09765688890083,0.4262880428174858,0.5414645042171704
2913,1724339598,1724343198,3600,0.43794064748109507,3.113372077290328,0.1,0.1
2914,1724343198,1724346798,3600,0.19005131290036556,3.1031104536557037,0.1,0.1
2915,1724346798,1724350398,3600,0.168121682724225,3.005032722144655,0.1,0.1
2916,1724350398,1724353845,3447,1.5908045752718474,4.502115723514581,0.5715924276148344,0.45657466952703274
2917,1724353998,1724357598,3600,0.3889003381372672,3.095005200543975,0.1,0.1
2918,1724357598,1724357873,275,0.9653054941621082,3.335705698530352,0.48851573882267507,0.10778339160028214
2919,1724361198,1724364798,3600,0.12679758836444793,3.1484365314444314,0.1,0.1
2920,1724364798,1724368398,3600,0.4694972546590983,3.161953249865794,0.1,0.1
2921,1724368398,1724370448,2050,1.5695870798766904,4.526380169921229,0.6313239025407172,0.8444045002671301
2922,1724371998,1724373429,1431,1.320318286259245,3.949553784849686,0.467966183368028,0.3523303267974851
2923,1724375598,1724378227,2629,1.8657772703613507,4.470019585928233,0.7950848678124061,0.9803255689513185
2924,1724379198,1724379490,292,0.8972211150445457,3.6924100715092063,0.21042915334019086,0.1808277088796969
2925,1724382798,1724383867,1069,1.0292450018585346,3.9845879238145505,0.35094730858499246,0.9377644611228221
2926,1724386398,1724386548,150,0.8590973387539644,3.3504989942184222,0.9357836510249368,0.6189098279713556
2927,1724389998,1724393598,3600,0.3186953959329526,3.126050508915185,0.1,0.1
2928,1724393598,1724396694,3096,1.9026781237614432,4.410785163003625,0.864394953309681,0.163143745653697
2929,1724397198,1724397881,683,1.275727426824466,3.90695017788387,0.6669824629439902,0.6710512916586155
2930,1724400798,1724404398,3600,0.4472726089008855,3.0805777106231997,0.1,0.1
2931,1724404398,1724406105,1707,1.1482733519468424,4.155773238947675,0.5065678127699947,0.14967989106007956
2932,1724407998,1724411598,3600,0.33576242730190975,3.160012056391608,0.1,0.1
2933,1724411598,1724412802,1204,1.1563605018150704,3.938963860841883,0.5881539482418549,0.8832946496838394
2934,1724415198,1724418798,3600,0.37188146060649097,3.0019505545845377,0.1,0.1
2935,1724418798,1724422398,3600,0.33844243810479935,3.081764699994412,0.1,0.1
2936,1724422398,1724425998,3600,0.24668092379211148,3.197680969226815,0.1,0.1
2937,1724425998,1724429598,3600,0.3219891705720731,3.0941602376363275,0.1,0.1
2938,1724429598,1724431836,2238,1.8993780591846692,4.51422493596916,0.789620328132867,0.2950812061105158
2939,1724433198,1724434057,859,1.0651096773898034,4.188756300924171,0.8363257073841516,0.861718645072154
2940,1724436798,1724440398,3600,0.23875850731861462,3.054975858072119,0.1,0.1
2941,1724440398,1724443998,3600,0.2961318075731348,3.0499445235203675,0.1,0.1
2942,1724443998,1724447598,3600,0.4514275885370601,3.1142471970810215,0.1,0.1
2943,1724447598,1724451198,3600,0.49499866630891876,3.1659829281032144,0.1,0.1
2944,1724451198,1724452776,1578,1.0944906594845258,4.172341448410496,0.5004463130044885,0.6705104025479431
2945,1724454798,1724455316,518,0.8975477113625197,3.3966607895588616,0.6924026682360795,0.15206593534859406
2946,1724458398,1724461998,3600,0.22634345940106929,3.0542562419131616,0.1,0.1
2947,1724461998,1724464693,2695,1.6445744918820309,4.416912495572554,0.982551184485932,0.2301857748556384
2948,1724465598,1724468220,2622,1.7921229265581873,4.329796569095439,0.6951480380859141,0.7253391677668551
2949,1724469198,1724472798,3600,0.329010003633993,3.172163576671216,0.1,0.1
2950,1724472798,1724476398,3600,0.26811905646676437,3.174698589154807,0.1,0.1
2951,1724476398,1724476837,439,0.8929086684971472,3.646486200158556,0.7403781142034825,0.7209858525385735
2952,1724479998,1724483598,3600,0.4476799174819146,3.164183166676757,0.1,0.1
2953,1724483598,1724486769,3171,1.880625252973306,4.562685248274513,0.5559496705355901,0.18190458349948774
2954,1724487198,1724487315,117,0.609916755885385,3.520123010126572,0.5168530230556152,0.5667799108213708
2955,1724490798,1724494398,3600,0.19694155397787239,3.0196072717404965,0.1,0.1
2956,1724494398,1724497998,3600,0.17869840566300949,3.1037021528083075,0.1,0.1
2957,1724497998,1724500239,2241,2.400533920843326,4.311496305786909,0.3514306716459773,0.3344259988267906
2958,1724501598,1724505198,3600,0.3512492914562745,3.1533933250839525,0.1,0.1
2959,1724505198,1724508798,3600,0.17929119841076818,3.126197180856455,0.1,0.1
2960,1724508798,1724510096,1298,1.455884885340757,3.905713216979823,0.2910717547208366,0.9966716767974035
2961,1724512398,1724515998,3600,0.32262154274826804,3.1750859701947594,0.1,0.1
2962,1724515998,1724517354,1356,1.405252533082506,3.962120803121022,0.4060394290122281,0.6118591687107778
2963,1724519598,1724520347,749,1.4308504245944218,3.9881374487413317,0.8548356686322863,0.8093735279758918
2964,1724523198,1724526798,3600,0.3847256538213373,3.1283628524140807,0.1,0.1
2965,1724526798,1724529322,2524,1.9670043247007483,4.378203890903754,0.6945674199891809,0.9916829767238553
2966,1724530398,1724531027,629,1.3245128930324805,4.091978689653216,0.33033495598698925,0.35792867187281074
2967,1724533998,1724537598,3600,0.17054123133250743,3.1323784051454417,0.1,0.1
2968,1724537598,1724540725,3127,2.467180006740392,4.439804101394339,0.8194594877365151,0.5565778497319099
2969,1724541198,1724544798,3600,0.40472677555456105,3.1388215187436344,0.1,0.1
2970,1724544798,1724546193,1395,1.1802290975935885,3.9984797074471814,0.18746740192663475,0.2583848985252735
2971,1724548398,1724551998,3600,0.412253801938112,3.1067501046269674,0.1,0.1
2972,1724551998,1724555598,3600,0.1561250882104432,3.0947568863206194,0.1,0.1
2973,1724555598,1724556897,1299,1.0857361649299517,3.8026195153280806,0.43788261144834095,0.29532440322381215
2974,1724559198,1724561545,2347,2.009589004086408,4.678257312194427,0.22720025494656684,0.2071447020781548
2975,1724562798,1724566398,3600,0.4875612403719711,3.103544366455809,0.1,0.1
2976,1724566398,1724569998,3600,0.3810221641991993,3.048713987180998,0.1,0.1
2977,1724569998,1724573598,3600,0.45510905038213834,3.0775702942569647,0.1,0.1
2978,1724573598,1724577198,3600,0.415726149037567,3.1938786380431052,0.1,0.1
2979,1724577198,1724578196,998,1.019689933274278,4.005611247472519,0.6996495639106273,0.7439871330713855
2980,1724580798,1724582919,2121,2.0656081979305956,4.399423137281039,0.2827193835363498,0.6826260420069349
2981,1724584398,1724587376,2978,1.7685327996797031,4.470901916789197,0.7066963877750502,0.4849375046750678
2982,1724587998,1724591244,3246,2.3877550174611706,4.63332280659756,0.9708635710016819,0.5093212434906731
2983,1724591598,1724595198,3600,0.11187523220405377,3.1840080117107825,0.1,0.1
2984,1724595198,1724598798,3600,0.28276647395932214,3.169682334453947,0.1,0.1
2985,1724598798,1724602398,3600,0.20340709740296603,3.029614156160612,0.1,0.1
2986,1724602398,1724605113,2715,1.7993342199723301,4.69516186822041,0.8571306686852243,0.33062124000650817
2987,1724605998,1724609440,3442,1.641912875489106,4.632932234400652,0.44834225766015257,0.4875288019669006
2988,1724609598,1724613198,3600,0.35093519511625915,3.057947799512571,0.1,0.1
2989,1724613198,1724616798,3600,0.206547917012115,3.0398093663933565,0.1,0.1
2990,1724616798,1724618465,1667,1.4255012863379588,3.899370952382705,0.7123501288244476,0.4438128383082066
2991,1724620398,1724623428,3030,1.5722265958053394,4.3130540555394425,0.10078537988772353,0.2929843002241822
2992,1724623998,1724627598,3600,0.4259637570679632,3.1472894817114927,0.1,0.1
2993,1724627598,1724629033,1435,1.1913325293735908,4.0207055730143235,0.5117093466840454,0.41641468924369685
2994,1724631198,1724634798,3600,0.4357461480026322,3.1752296184644857,0.1,0.1
2995,1724634798,1724638398,3600,0.14757447723771566,3.0309766362639334,0.1,0.1
2996,1724638398,1724639519,1121,1.2299518664641322,4.01897069632093,0.9406126395304276,0.1931324892391632
2997,1724641998,1724645598,3600,0.27135889488007053,3.1020122495024705,0.1,0.1
2998,1724645598,1724648566,2968,1.9221498601431062,4.649663710701407,0.45610067238207863,0.59972116228955
2999,1724649198,1724652798,3600,0.1822696390189824,3.0957948552984007,0.1,0.1
3000,1724652798,1724656398,3600,0.4026895965982914,3.013748843803813,0.1,0.1
3001,1724656398,1724659998,3600,0.48151724025819365,3.1901578553130214,0.1,0.1
3002,1724659998,1724663598,3600,0.27517640976597524,3.0846200410976605,0.1,0.1
3003,1724663598,1724667198,3600,0.15284521271469878,3.1628820789832846,0.1,0.1
3004,1724667198,1724667624,426,0.6357635034214246,3.3246059859549097,0.18559012966897653,0.6398364087602728
3005,1724670798,1724672380,1582,1.063977299247861,3.8337212278667727,0.15110255433003103,0.23974531295661816
3006,1724674398,1724676690,2292,1.9188353312617592,4.45651456800395,0.3935317939207198,0.4240310150487444
3007,1724677998,1724681598,3600,0.17911011002004687,3.106653315571805,0.1,0.1
3008,1724681598,1724681858,260,0.892565045586184,3.388171350885206,0.183961838352396,0.7634750851075996
3009,1724685198,1724688798,3600,0.22786393526724302,3.1990394514402825,0.1,0.1
3010,1724688798,1724691870,3072,2.2421175073995236,4.31988571666428,0.34385473663644267,0.5118670223657847
3011,1724692398,1724695998,3600,0.20627023678340262,3.1083817073606905,0.1,0.1
3012,1724695998,1724697867,1869,2.006082356808287,4.3195441863838795,0.705116130121875,0.5114275580828499
3013,1724699598,1724703198,3600,0.4560641561309249,3.0070194844661735,0.1,0.1
3014,1724703198,1724706798,3600,0.22961409669268665,3.1875657843696104,0.1,0.1
3015,1724706798,1724708107,1309,1.3543562040636719,4.112081887401267,0.6000047665183968,0.6028467663839008
3016,1724710398,1724713998,3600,0.16995113528772599,3.1479534428110134,0.1,0.1
3017,1724713998,1724717598,3600,0.4931224271857537,3.198568192141051,0.1,0.1
3018,1724717598,1724721198,3600,0.3900177093436775,3.19024102519838,0.1,0.1
3019,1724721198,1724724741,3543,2.3644970884157495,4.499390569844225,0.675303906408755,0.9368014794004207
3020,1724724798,1724724957,159,0.6878724457967714,3.302585939146769,0.812407944923775,0.8958960217953902
3021,1724728398,1724730497,2099,1.8524861410332818,4.67084345462347,0.23298417963628276,0.4871034757475522
3022,1724731998,1724735598,3600,0.43252259031885176,3.147618096513874,0.1,0.1
3023,1724735598,1724739198,3600,0.26509867845372,3.0039008921251136,0.1,0.1
3024,1724739198,1724740604,1406,1.1497415525355716,4.046334912391197,0.23906043722821468,0.5383383726829297
3025,1724742798,1724746398,3600,0.4765018325422228,3.1558051328188386,0.1,0.1
3026,1724746398,1724748494,2096,2.4620639312542263,4.347242615623134,0.32276225476358555,0.9855787082701051
3027,1724749998,1724753598,3600,0.32673165439162877,3.060974366671045,0.1,0.1
3028,1724753598,1724754074,476,0.9153330914604426,3.458143493104918,0.15400466445452937,0.3786385756274089
3029,1724757198,1724758161,963,1.012479808008485,3.9378856955429327,0.5899061372595106,0.6007999612364907
3030,1724760798,1724764398,3600,0.4457964744003279,3.1342362856489467,0.1,0.1
3031,1724764398,1724767376,2978,2.3087295024099483,4.655885532113934,0.7793543660787714,0.7579336996447884
3032,1724767998,1724768215,217,0.792985224015915,3.4856748927425114,0.6215212842287702,0.8720475324128782
3033,1724771598,1724774322,2724,1.6271663471423965,4.6078014714805615,0.9371214135908835,0.9872089676690758
3034,1724775198,1724778798,3600,0.19045135981297068,3.1299805614633933,0.1,0.1
3035,1724778798,1724782398,3600,0.4300902710924628,3.086515305714395,0.1,0.1
3036,1724782398,1724784351,1953,1.7523851710595926,4.375783935971385,0.871190016127756,0.12297752307248508
3037,1724785998,1724789458,3460,2.4939887913207386,4.592046457430273,0.7537014618529458,0.2618901178617065
3038,1724789598,1724793198,3600,0.27751276621473986,3.0280295660755896,0.1,0.1
3039,1724793198,1724796798,3600,0.3786456317602407,3.186119508906504,0.1,0.1
3040,1724796798,1724800398,3600,0.18137767537695498,3.1542726043780998,0.1,0.1
3041,1724800398,1724802464,2066,1.713294161947096,4.4414157277224415,0.8800846831869462,0.7282708715719757
3042,1724803998,1724807598,3600,0.1655066638610442,3.183596835356932,0.1,0.1
3043,1724807598,1724808433,835,1.43228206885233,3.838454989604164,0.10659804017047031,0.6472607787951138
3044,1724811198,1724814798,3600,0.2296511193963402,3.1041161416162364,0.1,0.1
3045,1724814798,1724817871,3073,2.382896663437357,4.395067802699307,0.935390644622584,0.8712438031564147
3046,1724818398,1724821998,3600,0.1400156842423634,3.0764123218787125,0.1,0.1
3047,1724821998,1724824821,2823,1.6889390571931742,4.563765905772791,0.5768812873215028,0.7187301240755103
3048,1724825598,1724827406,1808,2.3813508133469967,4.6388571755840315,0.47071271145001503,0.45680374258193324
3049,1724829198,1724832798,3600,0.4965880517861382,3.101452748220551,0.1,0.1
3050,1724832798,1724836398,3600,0.2753060409002249,3.085938304934721,0.1,0.1
3051,1724836398,1724839998,3600,0.449499931298187,3.140303503832914,0.1,0.1
3052,1724839998,1724843598,3600,0.37824756297009254,3.1050793429322874,0.1,0.1
3053,1724843598,1724847198,3600,0.35081354612183524,3.0860054193008275,0.1,0.1
3054,1724847198,1724850798,3600,0.1868272937675558,3.0720340029954873,0.1,0.1
3055,1724850798,1724854398,3600,0.10522152511358113,3.1687143200501926,0.1,0.1
3056,1724854398,1724857998,3600,0.10766765330703452,3.055698338970611,0.1,0.1
3057,1724857998,1724859727,1729,1.07005650413949,4.1451439895202835,0.3064372578265182,0.4022605999124038
3058,1724861598,1724862417,819,1.4225302392088481,4.104206136487049,0.8649889511470902,0.5725718898308717
3059,1724865198,1724865669,471,0.904632151430138,3.5353163211934318,0.47676190933789175,0.771351524628159
3060,1724868798,1724872398,3600,0.20592612876751104,3.0876671513323926,0.1,0.1
3061,1724872398,1724873494,1096,1.2951918957908084,3.831249031628754,0.8425736324264544,0.7899393791629461
3062,1724875998,1724877898,1900,1.5188735405686944,4.5082624727384175,0.24460142568845397,0.6901285856239759
3063,1724879598,1724880107,509,0.9566043527598025,3.5644558200017156,0.6946846104161817,0.7311680586430137
3064,1724883198,1724886798,3600,0.267814113769183,3.093324337310827,0.1,0.1
3065,1724886798,1724889006,2208,1.707642677697709,4.581079342382769,0.7324030879601182,0.7843732908243413
3066,1724890398,1724892704,2306,2.0524692568198644,4.630023913468719,0.18932197039726206,0.3470568166439605
3067,1724893998,1724895222,1224,1.049963868766676,4.007810305356082,0.5500240609605227,0.16802639748260015
3068,1724897598,1724901198,3600,0.26331523486410746,3.0169676532904264,0.1,0.1
3069,1724901198,1724904798,3600,0.43980453185374624,3.096823268978234,0.1,0.1
3070,1724904798,1724908398,3600,0.4638903226726253,3.1939091221315974,0.1,0.1
3071,1724908398,1724909367,969,1.24211974226121,3.889374810279972,0.2929794158755104,0.47250121987456994
3072,1724911998,1724913789,1791,1.3770872533165985,4.0190533515558675,0.24901705338425495,0.1832035244875767
3073,1724915598,1724919198,3600,0.10032107106499236,3.0485240140649363,0.1,0.1
3074,1724919198,1724921542,2344,2.4162023682328346,4.397939143944571,0.9394061554628083,0.32623486699586224
3075,1724922798,1724924528,1730,1.3385942052669588,3.9154176463737715,0.8010339849950624,0.564045118419402
3076,1724926398,1724929998,3600,0.4134313964377764,3.04364594924476,0.1,0.1
3077,1724929998,1724933598,3600,0.25378652118588496,3.081670349662909,0.1,0.1
3078,1724933598,1724936914,3316,1.8177987640826907,4.4862845850121404,0.7615907957688934,0.9176918205796353
3079,1724937198,1724940798,3600,0.2759330883939508,3.1674383561698667,0.1,0.1
3080,1724940798,1724944398,3600,0.15314301340409614,3.055609174539707,0.1,0.1
3081,1724944398,1724944907,509,0.753164097882334,3.442178806500666,0.34399781291457565,0.8479329488954215
3082,1724947998,1724951598,3600,0.15828315213943786,3.011619968094379,0.1,0.1
3083,1724951598,1724955198,3600,0.19486120976951984,3.186060287655915,0.1,0.1
3084,1724955198,1724955427,229,0.6688002420334427,3.611322353022276,0.3099630093515194,0.3733336547774537
3085,1724958798,1724962398,3600,0.42106479596308266,3.082283486824293,0.1,0.1
3086,1724962398,1724963954,1556,1.0361935987385849,3.8204015539197846,0.13463723378548936,0.898721964458438
3087,1724965998,1724969190,3192,1.8964204848847233,4.514133606149906,0.4173769899018115,0.5288464626885763
3088,1724969598,1724973198,3600,0.14980716480229242,3.047126503011516,0.1,0.1
3089,1724973198,1724976778,3580,1.9534895775148133,4.3963473629669805,0.23341617345821283,0.31006592092997176
3090,1724976798,1724980398,3600,0.3567289584542894,3.1160278649327244,0.1,0.1
3091,1724980398,1724983998,3600,0.3770482193736254,3.1319478941881083,0.1,0.1
3092,1724983998,1724987576,3578,1.8121946527703816,4.397305649979756,0.17168557539103274,0.35688394897580844
3093,1724987598,1724991198,3600,0.22657587240573362,3.01108302811687,0.1,0.1
3094,1724991198,1724994798,3600,0.1424260667386363,3.138860738993269,0.1,0.1
3095,1724994798,1724998398,3600,0.4203011407936059,3.0789219585575847,0.1,0.1
3096,1724998398,1724998866,468,0.6101196788400125,3.6169987164924464,0.49447233645373523,0.3274434780973424
3097,1725001998,1725005269,3271,2.1258919195352095,4.390755155682433,0.4863746495146418,0.17419439591650643
3098,1725005598,1725009198,3600,0.10560405920288063,3.0838400872672382,0.1,0.1
3099,1725009198,1725012798,3600,0.4134070061856956,3.0750420313149327,0.1,0.1
3100,1725012798,1725013764,966,1.4422867366449754,4.102683724317038,0.4562748940822311,0.5350085968237634
3101,1725016398,1725019998,3600,0.29651737283543406,3.011531199911412,0.1,0.1
3102,1725019998,1725022217,2219,2.071133970402186,4.532653599081788,0.5733425204014104,0.37424286967229825
3103,1725023598,1725027198,3600,0.10216441601273583,3.0861896575939647,0.1,0.1
3104,1725027198,1725030798,3600,0.4410638879333927,3.1910678075355214,0.1,0.1
3105,1725030798,1725032961,2163,1.9115877142207616,4.610151733217161,0.8282788154857154,0.686873566536852
3106,1725034398,1725034590,192,0.7650663399921633,3.357094987360558,0.6730104178629032,0.8331245268396082
3107,1725037998,1725040885,2887,2.3351321109568626,4.391190797050017,0.6313651368161074,0.907066024775515
3108,1725041598,1725045198,3600,0.35961456200574105,3.130369946683472,0.1,0.1
3109,1725045198,1725045430,232,0.5808056939015506,3.58354851923669,0.1814621786120037,0.5275998307254627
3110,1725048798,1725052398,3600,0.42157362368879736,3.141896123878047,0.1,0.1
3111,1725052398,1725055998,3600,0.18663709986296295,3.0469313864218117,0.1,0.1
3112,1725055998,1725057058,1060,1.097257719806516,3.968920719052853,0.16432929320566914,0.7094113124799379
3113,1725059598,1725063198,3600,0.16599054164063543,3.0201590202088067,0.1,0.1
3114,1725063198,1725063957,759,1.1820672583419976,4.117671327447651,0.8639458393633475,0.8987363435984074
3115,1725066798,1725070398,3600,0.2862433561046862,3.042089169428527,0.1,0.1
3116,1725070398,1725073998,3600,0.4823874579682953,3.09486692347948,0.1,0.1
3117,1725073998,1725077517,3519,1.9481675638053222,4.522208098708298,0.4582444880062321,0.39339933017577877
3118,1725077598,1725079768,2170,1.784743621045828,4.414720875246104,0.22429684969853098,0.20903873539672452
3119,1725081198,1725081542,344,0.7646250716911547,3.3168767363428286,0.8943444024919158,0.8374920642191529
3120,1725084798,1725088398,3600,0.3348927750945554,3.0413786808217234,0.1,0.1
3121,1725088398,1725091998,3600,0.4442593398977548,3.171026503343491,0.1,0.1
3122,1725091998,1725094035,2037,2.0266524039379235,4.658952769861726,0.12097657775116365,0.8020169155417888
3123,1725095598,1725099198,3600,0.1855980426801178,3.1717745085551035,0.1,0.1
3124,1725099198,1725100935,1737,1.211624063523273,4.038791739014333,0.5267867808835623,0.3982856634236024
3125,1725102798,1725106398,3600,0.14124024664847817,3.186735692765577,0.1,0.1
3126,1725106398,1725108934,2536,1.977877498782954,4.699619917747403,0.339227767900739,0.7171230264542259
3127,1725109998,1725113598,3600,0.16275777014033377,3.1014725707485384,0.1,0.1
3128,1725113598,1725117198,3600,0.39035249734481803,3.0212567222649707,0.1,0.1
3129,1725117198,1725119293,2095,1.696348812815967,4.638837244607172,0.6043865245803004,0.15207142688089983
3130,1725120798,1725121701,903,1.2047424799378894,3.8574338628796343,0.3573150747444974,0.9142135053047327
3131,1725124398,1725127629,3231,1.5244593088825775,4.426968835278321,0.9877509526071663,0.1715430896994909
3132,1725127998,1725131598,3600,0.21988838293928184,3.0210439195003955,0.1,0.1
3133,1725131598,1725134845,3247,2.0976385808391242,4.6294377352325045,0.38032594538519204,0.7322144444935557
3134,1725135198,1725138798,3600,0.31646979374546813,3.1869199983917182,0.1,0.1
3135,1725138798,1725140157,1359,1.2370295910922788,3.9152254840817937,0.23142619763686179,0.1969375629211052
3136,1725142398,1725145117,2719,2.447180915488593,4.593622427187682,0.5940441017705522,0.7985119781089796
3137,1725145998,1725148703,2705,1.5472726169170512,4.661871925916487,0.32714174396160717,0.7631726997654603
3138,1725149598,1725153198,3600,0.4529846664750655,3.1420281204713443,0.1,0.1
3139,1725153198,1725156798,3600,0.43933024389347164,3.144903668158332,0.1,0.1
3140,1725156798,1725160398,3600,0.43266035043394846,3.1627249014629855,0.1,0.1
3141,1725160398,1725163998,3600,0.3305628344416705,3.128555847032898,0.1,0.1
3142,1725163998,1725167598,3600,0.4493506206628285,3.0390566314903644,0.1,0.1
3143,1725167598,1725171198,3600,0.14066089576330798,3.0088933957606794,0.1,0.1
3144,1725171198,1725174798,3600,0.4700331558850125,3.1255380478074763,0.1,0.1
3145,1725174798,1725175389,591,0.8281005508605466,3.340231421293187,0.5452045161490718,0.33910135949142106
3146,1725178398,1725181219,2821,2.4847457895974654,4.424163433167622,0.5410895072914728,0.8396637456462368
3147,1725181998,1725183204,1206,1.072168850428484,4.111040976212963,0.40753012713193326,0.9152146781185765
3148,1725185598,1725188134,2536,2.283782335214462,4.5486827168659065,0.5983443657434736,0.6147029595550679
3149,1725189198,1725192798,3600,0.443031977547905,3.1946508773796074,0.1,0.1
3150,1725192798,1725196398,3600,0.4788541669311801,3.037063865421887,0.1,0.1
3151,1725196398,1725199998,3600,0.2623991545580193,3.099958760366756,0.1,0.1
3152,1725199998,1725203598,3600,0.3588316209167156,3.048607552724024,0.1,0.1
3153,1725203598,1725207198,3600,0.24673700358396014,3.071028273591501,0.1,0.1
3154,1725207198,1725208987,1789,1.4513055150625647,3.955291069283333,0.22056837371838084,0.13870088400284697
3155,1725210798,1725213255,2457,2.045265555574311,4.649048319172853,0.7736899291491381,0.4827621353913629
3156,1725214398,1725217998,3600,0.2673087772837941,3.151769583089579,0.1,0.1
3157,1725217998,1725221598,3600,0.39937056320520037,3.00781967709924,0.1,0.1
3158,1725221598,1725225198,3600,0.14283395898614898,3.143848008383185,0.1,0.1
3159,1725225198,1725225977,779,1.3038542615366187,4.080402098626097,0.35670633758199455,0.8167578934080791
3160,1725228798,1725232398,3600,0.4645954750222694,3.1338623345399332,0.1,0.1
3161,1725232398,1725234063,1665,1.0183800715614895,4.111877287964315,0.3312001824488071,0.6183090636817876
3162,1725235998,1725237079,1081,1.4082603292343876,3.9724505576929796,0.7927461053819231,0.4706624935955558
3163,1725239598,1725241913,2315,1.5394493186225853,4.519002914316252,0.535620042583936,0.44834915081304805
3164,1725243198,1725246798,3600,0.18781707568665446,3.050848997280097,0.1,0.1
3165,1725246798,1725247453,655,1.032130941069432,4.04959650552428,0.6728475822689052,0.9708184337600719
3166,1725250398,1725253998,3600,0.1652597232326396,3.1463342203626974,0.1,0.1
3167,1725253998,1725254789,791,1.0848214163836662,3.840938416041771,0.7068696369916584,0.936176333553157
3168,1725257598,1725261198,3600,0.15799024534164985,3.1592049612527853,0.1,0.1
3169,1725261198,1725264798,3600,0.49592737754697414,3.17087930489106,0.1,0.1
3170,1725264798,1725268398,3600,0.36755674782778136,3.120732156908216,0.1,0.1
3171,1725268398,1725271998,3600,0.3022494520718253,3.1609720688607146,0.1,0.1
3172,1725271998,1725275598,3600,0.2271634309909143,3.1828282016938636,0.1,0.1
3173,1725275598,1725279198,3600,0.4337342808847806,3.1474915776187418,0.1,0.1
3174,1725279198,1725282798,3600,0.19263880595826943,3.1149772913457947,0.1,0.1
3175,1725282798,1725283564,766,1.3688124975980727,4.080309942475056,0.11999845627048111,0.8793922761695503
3176,1725286398,1725289998,3600,0.2983803510720968,3.1512617058922943,0.1,0.1
3177,1725289998,1725292642,2644,2.2646930344481584,4.601546012630645,0.2856550493542981,0.16119855520438842
3178,1725293598,1725297142,3544,2.1742279397240236,4.423806287706985,0.5131587087273992,0.8904473612765991
3179,1725297198,1725300373,3175,1.9968605883467259,4.5180202081694905,0.6696974716628652,0.5399375696658517
3180,1725300798,1725301161,363,0.7029851427984394,3.6215366938430766,0.8515993352202159,0.4339774073672984
3181,1725304398,1725307998,3600,0.43813577918751756,3.172937858217916,0.1,0.1
3182,1725307998,1725311598,3600,0.3606809587949106,3.1506488491338445,0.1,0.1
3183,1725311598,1725314490,2892,2.4090753368181383,4.519743829505595,0.2591019558751746,0.5567281489289744
3184,1725315198,1725318798,3600,0.4561205364280324,3.011227063265614,0.1,0.1
3185,1725318798,1725322398,3600,0.24946750629527076,3.030007168278177,0.1,0.1
3186,1725322398,1725325998,3600,0.10014758314611072,3.1881624445395063,0.1,0.1
3187,1725325998,1725327889,1891,2.4174938534055217,4.426665390998395,0.5296424134021663,0.15875684960422662
3188,1725329598,1725331550,1952,1.8727130788837623,4.654228040467686,0.8053278133798815,0.8138664524908497
3189,1725333198,1725336798,3600,0.3094909141386928,3.1668930392106454,0.1,0.1
3190,1725336798,1725340398,3600,0.4194442298268741,3.018226228045402,0.1,0.1
3191,1725340398,1725343998,3600,0.2515758453071518,3.1542683247755603,0.1,0.1
3192,1725343998,1725347598,3600,0.11520828292626728,3.1746857933125625,0.1,0.1
3193,1725347598,1725351198,3600,0.3267071966653605,3.120903631035143,0.1,0.1
3194,1725351198,1725352909,1711,1.14882013052018,3.967566730768797,0.16636643329770223,0.724910295036587
3195,1725354798,1725358398,3600,0.15529298334648953,3.161392753372518,0.1,0.1
3196,1725358398,1725361698,3300,1.891129772979875,4.605993290346427,0.6788816453715014,0.7245467049647347
3197,1725361998,1725365348,3350,1.7684412735972592,4.564975020512002,0.1955074376116515,0.24695228806638625
3198,1725365598,1725367719,2121,2.0221626309102447,4.688587327730559,0.9921267394396409,0.9419542101401568
3199,1725369198,1725371168,1970,2.2863800376783234,4.533791593439727,0.4597922608369892,0.7481556827251126
3200,1725372798,1725376398,3600,0.1655683876810667,3.160263832162257,0.1,0.1
3201,1725376398,1725379998,3600,0.3183569025266916,3.180409327737957,0.1,0.1
3202,1725379998,1725383598,3600,0.26341262408093,3.1167151305514422,0.1,0.1
3203,1725383598,1725387198,3600,0.26584467815253754,3.153878282851182,0.1,0.1
3204,1725387198,1725390798,3600,0.26726889717667446,3.0343086569912825,0.1,0.1
3205,1725390798,1725391818,1020,1.4727761568418716,3.845761102729249,0.25970039799538225,0.501562284277847
3206,1725394398,1725395013,615,1.040763788075077,4.157105559469912,0.5530918889092148,0.7556643792086641
3207,1725397998,1725399718,1720,1.164197374884286,3.8096166807816996,0.16007047897960233,0.9466328167994092
3208,1725401598,1725402166,568,0.7396583061088657,3.6511802238888964,0.9911543757975985,0.5546732984576351
3209,1725405198,1725408798,3600,0.30824629945980875,3.0391964064129025,0.1,0.1
3210,1725408798,1725412398,3600,0.22064663584728833,3.187119124370401,0.1,0.1
3211,1725412398,1725415998,3600,0.2805527937466517,3.0192957071815356,0.1,0.1
3212,1725415998,1725419598,3600,0.1699397451992632,3.1805424007964747,0.1,0.1
3213,1725419598,1725423198,3600,0.3067013574686646,3.1070930789516154,0.1,0.1
3214,1725423198,1725426798,3600,0.3588104404732114,3.12971485119681,0.1,0.1
3215,1725426798,1725427927,1129,1.4568476940446091,4.162627153869128,0.9935886654246033,0.5189582634355292
3216,1725430398,1725430572,174,0.6512064395287931,3.468384104170983,0.6168646089212546,0.9046927487754458
3217,1725433998,1725437598,3600,0.1939171769740804,3.128751473659208,0.1,0.1
3218,1725437598,1725441198,3600,0.14197305066227162,3.1426921710649873,0.1,0.1
3219,1725441198,1725444503,3305,2.1612119169248265,4.41270749534475,0.7714356173962165,0.9029435294658349
3220,1725444798,1725448398,3600,0.31467907125170613,3.1853084902266695,0.1,0.1
3221,1725448398,1725451998,3600,0.18984671658189436,3.0816678502121104,0.1,0.1
3222,1725451998,1725455598,3600,0.4151539664058268,3.1405357361965414,0.1,0.1
3223,1725455598,1725458659,3061,1.5393880403609048,4.481634229390621,0.5000014472034805,0.5508254759698173
3224,1725459198,1725461599,2401,1.8383157886811143,4.33756256188968,0.9309718607239887,0.5174632627915579
3225,1725462798,1725465193,2395,2.3996456866618354,4.400833072206789,0.5468812801152428,0.3492717439448173
3226,1725466398,1725468394,1996,1.7481818195326695,4.314224421212029,0.6773984535480757,0.3722933675159412
3227,1725469998,1725473598,3600,0.20633019315956533,3.04812138771868,0.1,0.1
3228,1725473598,1725476336,2738,1.7080485066916924,4.510944334771109,0.259213563150893,0.8580894269401265
3229,1725477198,1725477589,391,0.9377335714273798,3.57260474904639,0.7108922747559165,0.32324366389192694
3230,1725480798,1725484398,3600,0.3529916554026149,3.147609967883803,0.1,0.1
3231,1725484398,1725486426,2028,1.5516313841872527,4.547766512318265,0.9686397499448592,0.9824079050345913
3232,1725487998,1725489623,1625,1.0602154512093047,4.0295038746134235,0.7416690228028502,0.7143305010362664
3233,1725491598,1725494990,3392,2.1685406427554357,4.5698936878624306,0.7863608029123057,0.9827311401317038
3234,1725495198,1725498798,3600,0.47592351018475787,3.0322902981051514,0.1,0.1
3235,1725498798,1725502398,3600,0.3962065088604444,3.1141273229606465,0.1,0.1
3236,1725502398,1725505998,3600,0.3857679213675823,3.003850676338242,0.1,0.1
3237,1725505998,1725509598,3600,0.23133868717427242,3.1023754024923726,0.1,0.1
3238,1725509598,1725513113,3515,1.5352815226938605,4.697881559082633,0.9186221587046235,0.8447062603709529
3239,1725513198,1725516798,3600,0.12084893227308369,3.1222286228542933,0.1,0.1
3240,1725516798,1725520398,3600,0.35132484318462764,3.01525721013534,0.1,0.1
3241,1725520398,1725523998,3600,0.4908527805984142,3.123846577252812,0.1,0.1
3242,1725523998,1725527416,3418,1.7417047884531849,4.51910824514079,0.500802576691656,0.1886024878530248
3243,1725527598,1725528296,698,1.1274540535487017,3.9233651593782715,0.1874709225496165,0.6083250320614523
3244,1725531198,1725534798,3600,0.4455506932174579,3.1425205129940816,0.1,0.1
3245,1725534798,1725538398,3600,0.3741862902065748,3.179523906942719,0.1,0.1
3246,1725538398,1725541998,3600,0.4545283680932084,3.0419794012099146,0.1,0.1
3247,1725541998,1725545242,3244,1.6441018172703792,4.396404974457562,0.7516634840715485,0.2307305409909446
3248,1725545598,1725545965,367,0.9417695585007619,3.345371408931536,0.6094667455609099,0.9588089624970988
3249,1725549198,1725552798,3600,0.40808999230130993,3.048843464446692,0.1,0.1
3250,1725552798,1725556398,3600,0.19314932789927255,3.0893927409026736,0.1,0.1
3251,1725556398,1725558237,1839,2.1210477945528177,4.34155989230523,0.16333324780684438,0.2489255937607539
3252,1725559998,1725563598,3600,0.3267827998056512,3.0937888952564205,0.1,0.1
3253,1725563598,1725563799,201,0.8226138915148414,3.6548829509948364,0.8432995840787129,0.6468070126433048
3254,1725567198,1725570798,3600,0.4966659708661568,3.033397338197548,0.1,0.1
3255,1725570798,1725573332,2534,1.6426040839640483,4.4029161853603735,0.3173884546087082,0.9121633231882721
3256,1725574398,1725577111,2713,1.5995322448134401,4.477989239206128,0.4967140977967398,0.2733190437986221
3257,1725577998,1725580029,2031,2.326880177938708,4.362321445670992,0.8996030087564979,0.4098422067571934
3258,1725581598,1725585198,3600,0.12389921186231585,3.0961462502574095,0.1,0.1
3259,1725585198,1725588798,3600,0.3123242162969023,3.0994645114272674,0.1,0.1
3260,1725588798,1725592398,3600,0.2784621198715984,3.151672224642698,0.1,0.1
3261,1725592398,1725595998,3600,0.10928069085787864,3.125589962719888,0.1,0.1
3262,1725595998,1725599598,3600,0.21177472185880852,3.0766381278742787,0.1,0.1
3263,1725599598,1725600927,1329,1.0153279930495862,4.065031954496597,0.6248530885934928,0.1780371438799634
3264,1725603198,1725606798,3600,0.3179488291769703,3.050155307142109,0.1,0.1
3265,1725606798,1725609446,2648,2.466041606747849,4.613639447184519,0.5558346758233591,0.5920874131483801
3266,1725610398,1725613998,3600,0.22842224960712865,3.0975602103643936,0.1,0.1
3267,1725613998,1725614573,575,0.5371409106573124,3.3881347362608114,0.4458794532340832,0.7873633487047452
3268,1725617598,1725620871,3273,1.9151579781728787,4.588617591242976,0.9150912019105808,0.874572710820124
3269,1725621198,1725621888,690,1.273356584414434,4.009839098935735,0.2771253949897168,0.9465137524820734
3270,1725624798,1725628398,3600,0.3414111369862277,3.1135340416818793,0.1,0.1
3271,1725628398,1725631998,3600,0.2034310982694188,3.1712260040497275,0.1,0.1
3272,1725631998,1725635391,3393,2.4087252977221008,4.54391292965664,0.4347775319964359,0.8983145513460098
3273,1725635598,1725637645,2047,2.3526968661096306,4.458230775684038,0.17819841395116554,0.8126696121847218
3274,1725639198,1725642798,3600,0.36581436446898374,3.130228053106599,0.1,0.1
3275,1725642798,1725643538,740,1.466447862789662,4.163219850747772,0.6914713052354946,0.38590960062038493
3276,1725646398,1725649998,3600,0.19722930388979,3.1182428697900724,0.1,0.1
3277,1725649998,1725653598,3600,0.3832253126409563,3.0037294555547644,0.1,0.1
3278,1725653598,1725657198,3600,0.39017387963037664,3.1508157943529236,0.1,0.1
3279,1725657198,1725660798,3600,0.129413503180841,3.1100298559664084,0.1,0.1
3280,1725660798,1725664398,3600,0.24247402099092158,3.168327514674864,0.1,0.1
3281,1725664398,1725667998,3600,0.43488060377767046,3.0644622347650046,0.1,0.1
3282,1725667998,1725671598,3600,0.4311744943172817,3.0286238069598235,0.1,0.1
3283,1725671598,1725671867,269,0.8692971955617566,3.630220427125143,0.767821425175679,0.6304855236951503
3284,1725675198,1725677020,1822,1.6559123277848373,4.658255270075937,0.7323179292699832,0.7807030768882971
3285,1725678798,1725681626,2828,2.12016583647699,4.581584442308194,0.5322807022374174,0.9194877963911869
3286,1725682398,1725685998,3600,0.17798922955302526,3.0414584857447626,0.1,0.1
3287,1725685998,1725689598,3600,0.32553353722539746,3.1914782120664666,0.1,0.1
3288,1725689598,1725693198,3600,0.2874625701946916,3.055827386914291,0.1,0.1
3289,1725693198,1725696798,3600,0.3190383604279714,3.004448598193384,0.1,0.1
3290,1725696798,1725700398,3600,0.2988781491808862,3.0539874206207864,0.1,0.1
3291,1725700398,1725703998,3600,0.1776906664973019,3.072326257376589,0.1,0.1
3292,1725703998,1725705402,1404,1.1404387916985277,3.950509442402516,0.19280981684210036,0.5673393442846222
3293,1725707598,1725707839,241,0.8769612077851558,3.4323976887117245,0.34943763639998326,0.8808992064099562
3294,1725711198,1725713152,1954,1.720355301839715,4.564083606407457,0.22279135226373897,0.10926410535490225
3295,1725714798,1725715139,341,0.5052872976558889,3.5487973488197495,0.3566792704139542,0.9815248529030679
3296,1725718398,1725718497,99,0.9010387586883379,3.5580417173655725,0.36985372516821935,0.6128718722104098
3297,1725721998,1725725598,3600,0.2286255231374268,3.038536189306718,0.1,0.1
3298,1725725598,1725729198,3600,0.17498759490950705,3.1794521886401492,0.1,0.1
3299,1725729198,1725732798,3600,0.4362231208195233,3.0725799869743127,0.1,0.1
3300,1725732798,1725734900,2102,1.9560929877413404,4.356491165435187,0.5053895700441154,0.47919844848991233
3301,1725736398,1725737122,724,1.0642829950403696,3.961277541407439,0.4723239334587518,0.1345763552481768
3302,1725739998,1725743598,3600,0.30229160872632194,3.0090876646105014,0.1,0.1
3303,1725743598,1725743733,135,0.805701844100867,3.385451372183532,0.9359245047477085,0.5804773839871618
3304,1725747198,1725749272,2074,2.3049338640436154,4.331088431084805,0.978859382982958,0.18855222398361127
3305,1725750798,1725753243,2445,2.0058214998017094,4.638107041914837,0.8265147371832892,0.50008229926097
3306,1725754398,1725757998,3600,0.2871351259983652,3.129215813890349,0.1,0.1
3307,1725757998,1725761598,3600,0.11700864828106328,3.172887870076611,0.1,0.1
3308,1725761598,1725762355,757,1.0469935380260498,4.177713256499857,0.17694708953843136,0.46341275419604866
3309,1725765198,1725768798,3600,0.30723178214553704,3.0286818341209187,0.1,0.1
3310,1725768798,1725772398,3600,0.20025726307292502,3.0458475412603407,0.1,0.1
3311,1725772398,1725773117,719,1.1221546986314452,4.105926979831361,0.7908278922198557,0.523967599276239
3312,1725775998,1725779598,3600,0.12809309165607022,3.1303730290043883,0.1,0.1
3313,1725779598,1725781403,1805,2.3823888177944035,4.345838119010783,0.8485027122672669,0.9697643601043867
3314,1725783198,1725786160,2962,2.19693007561387,4.645463664423752,0.7113512235978942,0.7164591912764767
3315,1725786798,1725790398,3600,0.11171582285376513,3.054249468202942,0.1,0.1
3316,1725790398,1725793998,3600,0.22428427572412107,3.1493496644408507,0.1,0.1
3317,1725793998,1725797598,3600,0.3353902159192983,3.1222699896481907,0.1,0.1
3318,1725797598,1725801198,3600,0.4975983292856918,3.096386015226471,0.1,0.1
3319,1725801198,1725804798,3600,0.32071708083081896,3.0998445816413875,0.1,0.1
3320,1725804798,1725804887,89,0.6549385914931545,3.434888027395113,0.7065589961585947,0.473734099462916
3321,1725808398,1725811998,3600,0.2009293664767487,3.0566193618390876,0.1,0.1
3322,1725811998,1725815598,3600,0.36453615720722643,3.085720194644384,0.1,0.1
3323,1725815598,1725819198,3600,0.3929041960654104,3.0528556019311863,0.1,0.1
3324,1725819198,1725819448,250,0.5504705809915138,3.356227121651993,0.4548885339544475,0.2322121894266695
3325,1725822798,1725826398,3600,0.13158136216197122,3.1152175623381866,0.1,0.1
3326,1725826398,1725829998,3600,0.2952400755397242,3.1685078486300546,0.1,0.1
3327,1725829998,1725833598,3600,0.2866675197781813,3.158436564685412,0.1,0.1
3328,1725833598,1725837198,3600,0.29818520407083193,3.1235761588661686,0.1,0.1
3329,1725837198,1725840798,3600,0.15254166460656002,3.0624368196349336,0.1,0.1
3330,1725840798,1725844058,3260,2.3740416498527925,4.366365827017778,0.6316355723137064,0.7808885879832941
3331,1725844398,1725845703,1305,1.0962725085373934,3.982577521919923,0.6705809463123755,0.8028349085870881
3332,1725847998,1725849277,1279,1.0111257226323462,4.027683569429764,0.8845408113345257,0.9293983243219729
3333,1725851598,1725851701,103,0.6454365804482279,3.4470028203581164,0.22036808070537467,0.4298640625539988
3334,1725855198,1725857876,2678,2.3046113458556854,4.575868768799444,0.9746633390365879,0.879937104065982
3335,1725858798,1725862398,3600,0.4269332965610926,3.1025968992854165,0.1,0.1
3336,1725862398,1725865998,3600,0.41093167322439883,3.0126157737412957,0.1,0.1
3337,1725865998,1725869598,3600,0.2920878252510895,3.1041245229077994,0.1,0.1
3338,1725869598,1725873198,3600,0.472653624468367,3.071456922872914,0.1,0.1
3339,1725873198,1725873380,182,0.5114814540288539,3.314352382966515,0.8741990569106931,0.47926623589412465
3340,1725876798,1725880398,3600,0.48727944857679795,3.025053732267871,0.1,0.1
3341,1725880398,1725883998,3600,0.45787708963092133,3.1230632090649673,0.1,0.1
3342,1725883998,1725887598,3600,0.39243354559438737,3.149126860450565,0.1,0.1
3343,1725887598,1725891198,3600,0.35032355815093685,3.1364564931757513,0.1,0.1
3344,1725891198,1725891468,270,0.5782677498367514,3.4805601473060066,0.3869442553149953,0.37164708122277557
3345,1725894798,1725898015,3217,1.8111621886473932,4.59077267034407,0.3225527451629699,0.7690126730268485
3346,1725898398,1725901998,3600,0.3420226977703352,3.0437639170621655,0.1,0.1
3347,1725901998,1725905598,3600,0.1673326065606161,3.0993195015761823,0.1,0.1
3348,1725905598,1725906124,526,0.7591244223122038,3.491599831123238,0.8325995845252484,0.7266089269483005
3349,1725909198,1725911200,2002,2.2866490505763806,4.432795082705437,0.2395908036268195,0.49404271121213406
3350,1725912798,1725915020,2222,1.9893336954584317,4.337891210777698,0.5493994606115535,0.6313924905171496
3351,1725916398,1725917707,1309,1.434906401901408,4.11126378783022,0.6261487536646015,0.7907818941324378
3352,1725919998,1725920617,619,1.4832768637838871,4.025218337613314,0.26087782180367314,0.5618497130807018
3353,1725923598,1725924383,785,1.3740840595612072,3.896057492996428,0.6494054835177406,0.8250018672097704
3354,1725927198,1725929558,2360,1.902998172488314,4.491093426014556,0.5717652619010761,0.33676107248396875
3355,1725930798,1725932504,1706,1.4781578707018759,4.068343084454287,0.597421643278058,0.19083611106500925
3356,1725934398,1725934484,86,0.7847227648531057,3.4589559183173706,0.60738952213088,0.6308941127733982
3357,1725937998,1725941598,3600,0.14316562536418745,3.194972781419387,0.1,0.1
3358,1725941598,1725945198,3600,0.15061160938910878,3.0860910533965553,0.1,0.1
3359,1725945198,1725947939,2741,1.8713249253664423,4.428930948786782,0.7584446284686377,0.5115147679157354
3360,1725948798,1725952289,3491,2.191841065800428,4.425216044364631,0.13208764959153624,0.22025177935539095
3361,1725952398,1725954094,1696,1.436480430734705,4.071564055418614,0.5135553860128319,0.3123087119799451
3362,1725955998,1725959029,3031,2.029245964392418,4.592780810190137,0.5920473362526341,0.7106690858822095
3363,1725959598,1725963198,3600,0.47344790024905714,3.072675922844934,0.1,0.1
3364,1725963198,1725966798,3600,0.20017030547193082,3.080582505050659,0.1,0.1
3365,1725966798,1725970398,3600,0.28807284597359084,3.195444855164988,0.1,0.1
3366,1725970398,1725973998,3600,0.3662953945122629,3.1982245119685646,0.1,0.1
3367,1725973998,1725976075,2077,1.7800596501737385,4.4951332263910855,0.44531001886453314,0.44384710260524585
3368,1725977598,1725979299,1701,1.1435144907721613,3.964936695127985,0.14061688028638838,0.6482169449006138
3369,1725981198,1725984798,3600,0.35954779196834474,3.032109826572289,0.1,0.1
3370,1725984798,1725988398,3600,0.3722176630773034,3.078275798807793,0.1,0.1
3371,1725988398,1725988837,439,0.975645681773952,3.698447412015652,0.9672581911725648,0.15913129786344282
3372,1725991998,1725995241,3243,1.8454406002551909,4.348234227815562,0.5487917034325593,0.6540845000469375
3373,1725995598,1725999198,3600,0.2678893350837517,3.0226831393647164,0.1,0.1
3374,1725999198,1726002798,3600,0.26196069231786173,3.095120813686051,0.1,0.1
3375,1726002798,1726003430,632,1.4481629176502482,4.151729623575738,0.6922552614317262,0.8774763096260266
3376,1726006398,1726009998,3600,0.11945616004407143,3.095190500522258,0.1,0.1
3377,1726009998,1726013598,3600,0.10349627867994414,3.1574769092049957,0.1,0.1
3378,1726013598,1726016308,2710,2.0439686123174132,4.559036513384194,0.9725000927108761,0.29475603032051845
3379,1726017198,1726020798,3600,0.413572383626587,3.1324465230850436,0.1,0.1
3380,1726020798,1726023304,2506,1.7006363628181358,4.59723368547936,0.9359152807301682,0.7243992824999601
3381,1726024398,1726027679,3281,1.6036786533578826,4.6266298782453505,0.16469654896556768,0.7776061522294022
3382,1726027998,1726031598,3600,0.13275369013928717,3.0051917008142737,0.1,0.1
3383,1726031598,1726035198,3600,0.29721646166854027,3.1197281981866944,0.1,0.1
3384,1726035198,1726038798,3600,0.29882621724444847,3.097530238901804,0.1,0.1
3385,1726038798,1726042398,3600,0.3782969358071194,3.1096304950141267,0.1,0.1
3386,1726042398,1726045998,3600,0.2697516976704256,3.1953858103269557,0.1,0.1
3387,1726045998,1726049377,3379,2.4149274032577486,4.5611038186201736,0.7685408562696355,0.27750100590424137
3388,1726049598,1726053198,3600,0.22772313336238215,3.12380779684001,0.1,0.1
3389,1726053198,1726056798,3600,0.227168442411842,3.040494086393116,0.1,0.1
3390,1726056798,1726058246,1448,1.085829706355713,4.075148023761303,0.5702523306234464,0.8759626009004389
3391,1726060398,1726063998,3600,0.4757010321320654,3.0891689448029482,0.1,0.1
3392,1726063998,1726065166,1168,1.3070891739903927,3.843024248066824,0.43903406850676385,0.809853629438317
3393,1726067598,1726069181,1583,1.179474866094795,4.184235329874027,0.32985386431320673,0.6309546726954878
3394,1726071198,1726073764,2566,2.3350295572915987,4.342010306665546,0.27288598997685065,0.6763392881083083
3395,1726074798,1726076217,1419,1.0258120821610615,4.175052065982414,0.29859059887216755,0.5639267295448763
3396,1726078398,1726081803,3405,2.44839307545639,4.620371685245037,0.2855405191956067,0.15643634347913138
3397,1726081998,1726083505,1507,1.078802250037586,3.9828858223787424,0.7982557568990004,0.18509855902571057
3398,1726085598,1726088607,3009,1.9164420221662273,4.321521822021066,0.8032752512871165,0.905158155976969
3399,1726089198,1726092361,3163,2.1521463506518668,4.679172549489698,0.6849616004135689,0.2837974155363849
3400,1726092798,1726096398,3600,0.2738504179591582,3.0324350443550223,0.1,0.1
3401,1726096398,1726099241,2843,2.265788586555661,4.616857895086353,0.1818351887033698,0.27294700871897426
3402,1726099998,1726103598,3600,0.17104894452335997,3.198885232713989,0.1,0.1
3403,1726103598,1726107198,3600,0.47462230047698795,3.129496357796965,0.1,0.1
3404,1726107198,1726110798,3600,0.19484842764650565,3.195684029804778,0.1,0.1
3405,1726110798,1726114398,3600,0.48146566701207616,3.1633462413731617,0.1,0.1
3406,1726114398,1726117998,3600,0.35239744672598183,3.072950939865092,0.1,0.1
3407,1726117998,1726121598,3600,0.4204805006794289,3.1395300734349036,0.1,0.1
3408,1726121598,1726125198,3600,0.30195384404612785,3.065696219265401,0.1,0.1
3409,1726125198,1726128798,3600,0.43480757363924694,3.16517255306628,0.1,0.1
3410,1726128798,1726131677,2879,2.04612195795279,4.494816642753492,0.7832527603067827,0.9506319338278706
3411,1726132398,1726134389,1991,1.661527276179802,4.384032738129848,0.35922161244422257,0.12894253468208566
3412,1726135998,1726139598,3600,0.3319061916811794,3.1751796091357947,0.1,0.1
3413,1726139598,1726142515,2917,2.033030803422081,4.46690524745517,0.9625742871759865,0.7356491768462624
3414,1726143198,1726144889,1691,1.3146668206218801,4.05383924998879,0.9454401728514489,0.8153048510216939
3415,1726146798,1726150154,3356,1.506181047813504,4.3177707844183955,0.19355538909040748,0.5312681391644694
3416,1726150398,1726153998,3600,0.10223751817496383,3.0310992364886524,0.1,0.1
3417,1726153998,1726155060,1062,1.4488396401739723,3.8955667325092334,0.7623935602441927,0.48906998212275776
3418,1726157598,1726161086,3488,1.6268318232202374,4.575037480122495,0.22485415461778546,0.45040618828689927
3419,1726161198,1726164798,3600,0.1679728251686829,3.0617879657341964,0.1,0.1
3420,1726164798,1726164949,151,0.5793231110717258,3.553523284064024,0.10178383636342202,0.3743975871115953
3421,1726168398,1726171998,3600,0.12210451764204318,3.1738189772268215,0.1,0.1
3422,1726171998,1726172073,75,0.8356799732641739,3.5541449264034695,0.9199641032428248,0.6553570781609351
3423,1726175598,1726179198,3600,0.3771992070801534,3.0855811233241335,0.1,0.1
3424,1726179198,1726180505,1307,1.1427115539226715,4.024031383020896,0.25457102580068924,0.3806854727136789
3425,1726182798,1726185116,2318,2.0830741847961103,4.362424847061279,0.2778891874530727,0.5965752023493437
3426,1726186398,1726189602,3204,1.551818929958297,4.462351312799537,0.24443590860194098,0.7319286505769567
3427,1726189998,1726193598,3600,0.3760641395731985,3.0634303038383064,0.1,0.1
3428,1726193598,1726196396,2798,1.8201482070105017,4.469100614643558,0.4083855604170522,0.15369655250120576
3429,1726197198,1726200681,3483,1.8021662177489213,4.468263802837438,0.5941132998899457,0.4239207245402953
3430,1726200798,1726204398,3600,0.17172516812982086,3.0369718502475327,0.1,0.1
3431,1726204398,1726206028,1630,1.0063457649714573,4.163367767701866,0.4364696021573571,0.6162372093393488
3432,1726207998,1726211598,3600,0.39925893548555913,3.183649363067926,0.1,0.1
3433,1726211598,1726214117,2519,2.3484793288122257,4.679072738423767,0.41885932007909266,0.9367465769324195
3434,1726215198,1726216238,1040,1.4796286547983324,4.00967525480211,0.4056788229111271,0.9584676406579361
3435,1726218798,1726222398,3600,0.487269123174375,3.0294845074435357,0.1,0.1
3436,1726222398,1726224962,2564,1.979103498438509,4.323091845196169,0.5391797146566982,0.7071656904255048
3437,1726225998,1726227029,1031,1.3837085847630237,3.8537872530093336,0.7514203741594406,0.2575347602641275
3438,1726229598,1726233198,3600,0.36334410570905573,3.150307135496704,0.1,0.1
3439,1726233198,1726235767,2569,1.652521827744232,4.378209667889994,0.8091341448655833,0.555578784637263
3440,1726236798,1726240398,3600,0.3520938676996298,3.1833564867867095,0.1,0.1
3441,1726240398,1726243998,3600,0.3166463602558529,3.04761115148191,0.1,0.1
3442,1726243998,1726247598,3600,0.410408740064075,3.0978554653580948,0.1,0.1
3443,1726247598,1726251198,3600,0.29907161873435395,3.0323363162847365,0.1,0.1
3444,1726251198,1726254798,3600,0.2018966760936677,3.070769881854947,0.1,0.1
3445,1726254798,1726257975,3177,1.9546022261440674,4.607545336083386,0.26744198624150606,0.12083506866973501
3446,1726258398,1726260220,1822,2.3400305197101128,4.549273237958306,0.7050574301245452,0.9521887468769726
3447,1726261998,1726263433,1435,1.3106520581635,3.8513969344380694,0.2756887900369307,0.7651378692488453
3448,1726265598,1726269198,3600,0.2459219902645836,3.05379595142801,0.1,0.1
3449,1726269198,1726272028,2830,1.5904808286091534,4.4225643042423926,0.18139434483224642,0.5282273834581434
3450,1726272798,1726274832,2034,2.3004869429793118,4.3788011147946655,0.6586703550850017,0.7889465331688494
3451,1726276398,1726279998,3600,0.26179884232502176,3.0889845470410435,0.1,0.1
3452,1726279998,1726283598,3600,0.1332488938740089,3.131580382150113,0.1,0.1
3453,1726283598,1726287198,3600,0.38272425638801355,3.0732855348565216,0.1,0.1
3454,1726287198,1726290798,3600,0.29957694270529,3.1993235406048197,0.1,0.1
3455,1726290798,1726294398,3600,0.12505788464699102,3.1640144826857926,0.1,0.1
3456,1726294398,1726294528,130,0.6884661546628927,3.4000571263318706,0.46023919999912677,0.31621874326789323
3457,1726297998,1726301598,3600,0.47202362957617616,3.119607272028568,0.1,0.1
3458,1726301598,1726305198,3600,0.48682225022183656,3.0565105163329713,0.1,0.1
3459,1726305198,1726307061,1863,1.7403201829755828,4.497218445026046,0.6382370397967181,0.23626850067031005
3460,1726308798,1726312398,3600,0.2506322944767121,3.1644482912207854,0.1,0.1
3461,1726312398,1726314097,1699,1.0797425847909354,3.954781443423368,0.17390673764900216,0.9622354212454429
3462,1726315998,1726319598,3600,0.2469139821528401,3.146695263129043,0.1,0.1
3463,1726319598,1726323037,3439,1.5691167018901022,4.515245352419679,0.3748356499919083,0.618769746219081
3464,1726323198,1726325505,2307,2.337200019471595,4.532685368135511,0.3908561343661673,0.2898468762390985
3465,1726326798,1726329335,2537,1.6310111930792168,4.4216153859504095,0.6656376342187826,0.6201503670246232
3466,1726330398,1726333998,3600,0.4965841382322769,3.1509282819948354,0.1,0.1
3467,1726333998,1726337598,3600,0.2235830703946442,3.0073345551072443,0.1,0.1
3468,1726337598,1726341198,3600,0.11600329290979766,3.1393788601053685,0.1,0.1
3469,1726341198,1726344798,3600,0.3413412629659814,3.0404375741753813,0.1,0.1
3470,1726344798,1726345846,1048,1.0936950157089071,4.1463041360985295,0.8305135458054065,0.9823665048655323
3471,1726348398,1726351998,3600,0.285486124389214,3.0949111636256377,0.1,0.1
3472,1726351998,1726355516,3518,1.926426044385891,4.384188973402301,0.786255367868842,0.35501009956006135
3473,1726355598,1726359198,3600,0.4463003364705965,3.0532838387599415,0.1,0.1
3474,1726359198,1726362798,3600,0.2590016776092562,3.1180693366255796,0.1,0.1
3475,1726362798,1726364036,1238,1.3566140110502332,4.077409531116873,0.5400864054384985,0.2586916914651061
3476,1726366398,1726368506,2108,1.8370608980337166,4.506979378772413,0.9226691863564349,0.4057351100796014
3477,1726369998,1726373598,3600,0.3864819914543194,3.055477692994672,0.1,0.1
3478,1726373598,1726375482,1884,1.774322097263601,4.388714233644679,0.9906660199798464,0.6753731534620581
3479,1726377198,1726380798,3600,0.40635655973331863,3.0442836823247443,0.1,0.1
3480,1726380798,1726382880,2082,2.223350105306859,4.584073231264598,0.13142417841309514,0.9135644942104245
3481,1726384398,1726385758,1360,1.2645967733972896,4.129200326714262,0.3105156030240089,0.7140939673267508
3482,1726387998,1726391598,3600,0.30365855876362613,3.178540288334287,0.1,0.1
3483,1726391598,1726395198,3600,0.17207917615260895,3.000559835258984,0.1,0.1
3484,1726395198,1726398798,3600,0.13988458979637383,3.1919287064553927,0.1,0.1
3485,1726398798,1726401294,2496,2.464879887519771,4.547343460659449,0.37191330607441286,0.7658239633156737
3486,1726402398,1726404324,1926,1.7182843669593386,4.581952924561128,0.7829399595366712,0.9738912034146262
3487,1726405998,1726409598,3600,0.48730908697710784,3.1462770071155703,0.1,0.1
3488,1726409598,1726413198,3600,0.4864906989422313,3.151557984279978,0.1,0.1
3489,1726413198,1726414126,928,1.4696819859914632,4.103938058292212,0.24064411080055276,0.13716623878914863
3490,1726416798,1726419058,2260,1.7200841376252534,4.509926932805039,0.9730942934766931,0.9537085430200698
3491,1726420398,1726423998,3600,0.24798224933064228,3.104293376279715,0.1,0.1
3492,1726423998,1726424328,330,0.8420632969029025,3.638089011658197,0.7815942118033687,0.47854038751003636
3493,1726427598,1726431198,3600,0.40449233364678994,3.0569764184857937,0.1,0.1
3494,1726431198,1726432893,1695,1.0420779099004494,3.9981406860955984,0.9918268789520738,0.41063608301330745
3495,1726434798,1726438398,3600,0.34518644842781254,3.199167555436868,0.1,0.1
3496,1726438398,1726440957,2559,1.8997956105198912,4.646175281209398,0.41568096674130683,0.9188551691170458
3497,1726441998,1726445598,3600,0.31740209996950586,3.0854812144321286,0.1,0.1
3498,1726445598,1726447365,1767,1.4281393121342016,4.080927627603531,0.98433747730021,0.6647954319155909
3499,1726449198,1726452798,3600,0.4737734169177956,3.1077515616329956,0.1,0.1
3500,1726452798,1726452937,139,0.5925021084005636,3.417770382735889,0.10208990560683733,0.4887243090717912
3501,1726456398,1726457190,792,1.2355331291044578,3.9265900661088162,0.9742789500322435,0.3738264969159768
3502,1726459998,1726463598,3600,0.19948710993877083,3.1479365363621,0.1,0.1
3503,1726463598,1726467198,3600,0.1801768680691167,3.168957901229317,0.1,0.1
3504,1726467198,1726470798,3600,0.2667012834870872,3.1798825064491316,0.1,0.1
3505,1726470798,1726471311,513,0.8722613696889734,3.640350340776604,0.39250773318531174,0.14903904295392226
3506,1726474398,1726477998,3600,0.32544776129562625,3.117643932698283,0.1,0.1
3507,1726477998,1726481598,3600,0.12471743068560986,3.1351193584308086,0.1,0.1
3508,1726481598,1726485198,3600,0.4093469483150133,3.0943552748375374,0.1,0.1
3509,1726485198,1726488546,3348,2.1234729492596887,4.356558210908089,0.5551900679017174,0.7689547789842816
3510,1726488798,1726492398,3600,0.310429783763822,3.136114663424016,0.1,0.1
3511,1726492398,1726492998,600,1.0730050749245377,4.059626457806047,0.7273209671306212,0.5925430545290749
3512,1726495998,1726499598,3600,0.22405179987209933,3.010762370894178,0.1,0.1
3513,1726499598,1726503198,3600,0.29157061071277673,3.138687507835704,0.1,0.1
3514,1726503198,1726506798,3600,0.35004685776278066,3.030594023883236,0.1,0.1
3515,1726506798,1726508978,2180,2.1784205066414106,4.405617218557325,0.43716908158710044,0.1830196033584518
3516,1726510398,1726511659,1261,1.0070560033295737,4.128402291012254,0.2350752726684746,0.9289628854225978
3517,1726513998,1726517598,3600,0.13454949214436784,3.093590940804296,0.1,0.1
3518,1726517598,1726517971,373,0.8221657094339114,3.569931529980158,0.9983332178789511,0.771318712879578
3519,1726521198,1726524798,3600,1.698895793328222,4.599989453245771,0.7991260797371421,0.43520404979022664
3520,1726524798,1726525826,1028,1.0807783955613435,3.8524049117790846,0.5553172124518936,0.991182236524013
3521,1726528398,1726531998,3600,0.3362638577390753,3.1932421689433403,0.1,0.1
3522,1726531998,1726535598,3600,0.1413611676470206,3.1771573811358453,0.1,0.1
3523,1726535598,1726538072,2474,2.3790527941911566,4.471964869618234,0.6934468916843766,0.1230621257095138
3524,1726539198,1726540783,1585,1.2314807367717284,4.002165792139875,0.45557810968860646,0.46743274133054347
3525,1726542798,1726543538,740,1.111858145629458,4.034832208805649,0.5531434464818188,0.8309183166371744
3526,1726546398,1726548008,1610,1.3702410843805668,3.8731758800134304,0.9276050680012542,0.9326322753633404
3527,1726549998,1726550593,595,0.9983446733009009,3.340102441467796,0.5255577740816414,0.3205046147213015
3528,1726553598,1726557198,3600,0.23488497853001988,3.0187760210558885,0.1,0.1
3529,1726557198,1726557563,365,0.6153446164182454,3.4987532425603822,0.10752734446168404,0.4638858395209098
3530,1726560798,1726564398,3600,0.22698446976627118,3.1891630340785517,0.1,0.1
3531,1726564398,1726567998,3600,0.17907877213957277,3.0962707902804794,0.1,0.1
3532,1726567998,1726570160,2162,2.0661324230930855,4.325064922977643,0.8427230312739653,0.1274784063867846
3533,1726571598,1726575198,3600,0.4068208149461495,3.064998042404317,0.1,0.1
3534,1726575198,1726578798,3600,0.4660555059168111,3.1336760379990474,0.1,0.1
3535,1726578798,1726580091,1293,1.4719781389075834,3.998329580997498,0.3287081816182569,0.8029083454770984
3536,1726582398,1726585998,3600,0.3862716001068869,3.0869684999639904,0.1,0.1
3537,1726585998,1726586990,992,1.207761229979269,3.954019442637494,0.8088920009553306,0.6913131932606482
3538,1726589598,1726591656,2058,1.5184204807421247,4.602248437223008,0.5286287056774817,0.24140774399086376
3539,1726593198,1726596798,3600,0.48090043932890103,3.043869207436823,0.1,0.1
3540,1726596798,1726600398,3600,0.29892657844902115,3.004719224237562,0.1,0.1
3541,1726600398,1726603998,3600,0.3894542481031157,3.0102447158478878,0.1,0.1
3542,1726603998,1726607598,3600,0.41172356706562685,3.124080013721575,0.1,0.1
3543,1726607598,1726610327,2729,2.2395068449105047,4.478293727884126,0.30298800640112844,0.9327281474057774
3544,1726611198,1726614798,3600,0.39265503296066606,3.0472280187738687,0.1,0.1
3545,1726614798,1726618398,3600,0.47059696311385757,3.1064616551904747,0.1,0.1
3546,1726618398,1726621998,3600,0.44782212801672927,3.1998491862596237,0.1,0.1
3547,1726621998,1726625098,3100,1.8945078536221351,4.341558687469192,0.32529476879599617,0.4884452149371844
3548,1726625598,1726629198,3600,0.29100249327192046,3.123901485613338,0.1,0.1
3549,1726629198,1726632661,3463,2.0068777650150236,4.490561348731216,0.9213213393575853,0.709122717372477
3550,1726632798,1726634421,1623,1.1348320634818974,4.079579096712983,0.4767955526530282,0.1762738813639449
3551,1726636398,1726637955,1557,1.4910895285972952,4.096897733488445,0.6639742645937824,0.16830653447275462
3552,1726639998,1726643598,3600,0.2707523838409474,3.0569604630608285,0.1,0.1
3553,1726643598,1726647198,3600,0.2533536966017792,3.013777124845718,0.1,0.1
3554,1726647198,1726650798,3600,0.37105387014329805,3.181114064100733,0.1,0.1
3555,1726650798,1726654398,3600,0.24673737448656152,3.196047666288168,0.1,0.1
3556,1726654398,1726657998,3600,0.3396367501850191,3.100678539066601,0.1,0.1
3557,1726657998,1726661049,3051,1.7632152337961027,4.625807534128813,0.43236426370990555,0.28950301626368324
3558,1726661598,1726664529,2931,2.02228279469249,4.603849104453235,0.8128503574422054,0.8740936488560214
3559,1726665198,1726668798,3600,0.19845067009345568,3.102083879348573,0.1,0.1
3560,1726668798,1726672398,3600,0.3943807047340222,3.122129898105059,0.1,0.1
3561,1726672398,1726672706,308,0.6259332149831123,3.3617446162050104,0.17728378059278344,0.6442295648186442
3562,1726675998,1726677732,1734,1.2326698923804473,3.869107004068583,0.1324789394849568,0.21055501616721323
3563,1726679598,1726683198,3600,0.13972166957851817,3.1978072632437535,0.1,0.1
3564,1726683198,1726685929,2731,1.6811671133920751,4.330505545461886,0.9768252905448561,0.8446145972305076
3565,1726686798,1726690398,3600,0.32577017696467847,3.0755772951847375,0.1,0.1
3566,1726690398,1726692754,2356,2.159754762353055,4.35629105129708,0.14347745015841962,0.8579820696919286
3567,1726693998,1726697598,3600,0.10562176727659495,3.1270825274472203,0.1,0.1
3568,1726697598,1726701198,3600,0.41841336539197627,3.109793799039731,0.1,0.1
3569,1726701198,1726704798,3600,0.4408652031831166,3.1048680543262392,0.1,0.1
3570,1726704798,1726708398,3600,0.373809071876512,3.042407441998746,0.1,0.1
3571,1726708398,1726711998,3600,0.24708339381960018,3.174608252890336,0.1,0.1
3572,1726711998,1726715598,3600,0.12196280119582502,3.049537950032108,0.1,0.1
3573,1726715598,1726719198,3600,0.44418769642531963,3.1836512173707416,0.1,0.1
3574,1726719198,1726722798,3600,0.12051047494281773,3.147675504877052,0.1,0.1
3575,1726722798,1726726398,3600,0.46256820666551557,3.133832528369931,0.1,0.1
3576,1726726398,1726728530,2132,1.8681134014584004,4.695774570743532,0.38925989893018986,0.3649009212978438
3577,1726729998,1726731972,1974,2.3718921214286044,4.469936871651704,0.8737485148486633,0.8312918207251165
3578,1726733598,1726737198,3600,0.30321231650069924,3.1397273933866185,0.1,0.1
3579,1726737198,1726740727,3529,1.9525755163514429,4.453300585986117,0.33753747841336984,0.7416639282841532
3580,1726740798,1726744009,3211,2.3803211795030443,4.54130060384173,0.8902654767967673,0.6004878482432363
3581,1726744398,1726747998,3600,0.21940654676681595,3.1284374130266306,0.1,0.1
3582,1726747998,1726749187,1189,1.191937093009635,3.8002153765834965,0.10933263036709481,0.3250698683306542
3583,1726751598,1726755198,3600,0.36459422646830164,3.1835743148696873,0.1,0.1
3584,1726755198,1726756213,1015,1.171161747110417,3.8934631909726165,0.6002161785460084,0.2493129351731052
3585,1726758798,1726762398,3600,0.29903428460558784,3.1194611005523574,0.1,0.1
3586,1726762398,1726762736,338,0.8364709706583231,3.3618748103723535,0.9457853757648416,0.2508677816364209
3587,1726765998,1726769598,3600,0.34989526505583857,3.1769669076337648,0.1,0.1
3588,1726769598,1726770150,552,0.887315904478887,3.659998050005416,0.792399134831371,0.2264586246373388
3589,1726773198,1726776266,3068,2.4087260327055584,4.36642617746438,0.3747000808598068,0.5298759785781447
3590,1726776798,1726780398,3600,0.15336473264628203,3.0859479725061485,0.1,0.1
3591,1726780398,1726782543,2145,2.40980998085253,4.373634992870063,0.21880582655468006,0.13099995289438565
3592,1726783998,1726787598,3600,0.24697694789669572,3.0861020030945467,0.1,0.1
3593,1726787598,1726788633,1035,1.3854820617844144,4.073243094786827,0.5024062906791468,0.5803047667673018
3594,1726791198,1726792977,1779,1.4824164102040078,4.1737493799615395,0.8179867343151751,0.43338486036351875
3595,1726794798,1726796710,1912,1.8539769481029755,4.541046563031094,0.28238769542768594,0.501202891688416
3596,1726798398,1726801998,3600,0.4421210432337991,3.1601837871799736,0.1,0.1
3597,1726801998,1726805215,3217,1.8268264617151986,4.406874250711623,0.3394540202764037,0.5854518930633591
3598,1726805598,1726807332,1734,1.2589668428126704,3.876685561116125,0.6147052088432418,0.20155545452502677
3599,1726809198,1726811995,2797,2.1756241277518455,4.612132026061205,0.5147680975752709,0.6758167606769971
3600,1726812798,1726816398,3600,0.10755975892212236,3.137164288933065,0.1,0.1
3601,1726816398,1726816905,507,0.9615680664525653,3.5196212038055474,0.5538729089731037,0.6849392934289856
3602,1726819998,1726822118,2120,2.4129507227312152,4.568127776034563,0.7913840300010363,0.1641242692983162
3603,1726823598,1726827198,3600,0.2683229435936794,3.173099854729867,0.1,0.1
3604,1726827198,1726830798,3600,0.4946911463471214,3.0453104803180717,0.1,0.1
3605,1726830798,1726834176,3378,2.057981759829372,4.632921902729812,0.8804657366953276,0.517871326928673
3606,1726834398,1726835153,755,1.3636758824490383,3.9491442419753042,0.5040286059441927,0.5517892548664268
3607,1726837998,1726841598,3600,0.2485948448499048,3.119005518746186,0.1,0.1
3608,1726841598,1726842276,678,1.000497670315371,3.850246224382518,0.7245725492423136,0.5859424306399513
3609,1726845198,1726847319,2121,1.7484656304191255,4.376610546174913,0.27984718012831056,0.4418304825453162
3610,1726848798,1726852398,3600,0.26925986914004746,3.152773798228495,0.1,0.1
3611,1726852398,1726855998,3600,0.16885614485921713,3.042702186541377,0.1,0.1
3612,1726855998,1726859598,3600,0.10737664517130772,3.010468588733029,0.1,0.1
3613,1726859598,1726862617,3019,2.261017853408392,4.320928547379209,0.5591239083154299,0.38001641513415096
3614,1726863198,1726866798,3600,0.15708117381778208,3.0242918542302535,0.1,0.1
3615,1726866798,1726868505,1707,1.4492724712437157,4.153922095990296,0.5427619411092584,0.10267409512120595
3616,1726870398,1726873998,3600,0.20079923330204585,3.1839851457600767,0.1,0.1
3617,1726873998,1726875854,1856,1.7037038249432688,4.609276031665587,0.6845940262008702,0.6965790700159793
3618,1726877598,1726881198,3600,0.3929080211001591,3.0270892824362305,0.1,0.1
3619,1726881198,1726882208,1010,1.3569605801199502,4.045744077812491,0.33650630889301303,0.2669261880657682
3620,1726884798,1726887876,3078,2.0629260256959157,4.693332294146235,0.158718312182166,0.46842726900677456
3621,1726888398,1726890236,1838,2.261958101430736,4.48656010595118,0.7748828428193628,0.8861944822043308
3622,1726891998,1726895598,3600,0.3189791467486426,3.1342438859571944,0.1,0.1
3623,1726895598,1726899198,3600,0.10765684727221672,3.1494525856195805,0.1,0.1
3624,1726899198,1726902798,3600,0.21465781577344678,3.013787804371101,0.1,0.1
3625,1726902798,1726906398,3600,0.15192900244513938,3.0095169347921273,0.1,0.1
3626,1726906398,1726909998,3600,0.17854418413392975,3.1938876634600986,0.1,0.1
3627,1726909998,1726913598,3600,0.33242452426931635,3.1917780481508125,0.1,0.1
3628,1726913598,1726917160,3562,2.270522547490243,4.3649309158493805,0.9877325707849705,0.3209999869229915
3629,1726917198,1726919789,2591,1.9040265599111346,4.668855739979286,0.8635944983246554,0.3331821074148127
3630,1726920798,1726924398,3600,0.36553372622490277,3.0780624569741595,0.1,0.1
3631,1726924398,1726927998,3600,0.3354568519236883,3.066403941166535,0.1,0.1
3632,1726927998,1726931598,3600,0.40087460137432873,3.136973605488019,0.1,0.1
3633,1726931598,1726932907,1309,1.0398109639657127,4.102822956649115,0.6321781931847326,0.791413777902582
3634,1726935198,1726938172,2974,2.274395796300976,4.3634331279442,0.3114223693472093,0.23386716161332113
3635,1726938798,1726939739,941,1.298213372858174,4.196018266666459,0.386457540022476,0.313846924769429
3636,1726942398,1726945998,3600,0.23720510191716865,3.0706800846297337,0.1,0.1
3637,1726945998,1726946312,314,0.6448472151108293,3.4330834018488665,0.5146107362246586,0.7742204010605068
3638,1726949598,1726953198,3600,0.35834490521529416,3.094098322246864,0.1,0.1
3639,1726953198,1726956675,3477,2.310951173047556,4.607921097708155,0.2887511197054604,0.9433765217189423
3640,1726956798,1726960398,3600,0.36248994207629226,3.0540744074803823,0.1,0.1
3641,1726960398,1726960483,85,0.7340812757209287,3.6324265994174927,0.5401889868563472,0.9643696279276323
3642,1726963998,1726967598,3600,0.4339055966622003,3.1095193433995703,0.1,0.1
3643,1726967598,1726971198,3600,0.12941972377158018,3.0016380101711495,0.1,0.1
3644,1726971198,1726973269,2071,2.2465146851177464,4.5548275553166375,0.9655212814148858,0.1053856448330132
3645,1726974798,1726977808,3010,1.9713062325356108,4.686826447297457,0.8471684920524533,0.25977905046689637
3646,1726978398,1726981998,3600,0.42938339766793754,3.058917486086182,0.1,0.1
3647,1726981998,1726983505,1507,1.260901550561159,4.1820726515990305,0.3902918664161902,0.8777349636909677
3648,1726985598,1726985670,72,0.8062321415254029,3.3286901851193686,0.768586913335605,0.10151371829215108
3649,1726989198,1726992641,3443,2.4348349306033628,4.43410939837083,0.37224211439653254,0.22247411699717146
3650,1726992798,1726996175,3377,2.0750012498804917,4.610910885895857,0.27642652069448337,0.19751632806849384
3651,1726996398,1726998806,2408,1.8804823154300687,4.52597689797717,0.3280273326263411,0.12641640902991075
3652,1726999998,1727000594,596,0.521324201984211,3.5114320326281243,0.7412374851524981,0.6170806093834476
3653,1727003598,1727006578,2980,2.0322199212765826,4.4345427532990565,0.7404158633014103,0.11430016166682738
3654,1727007198,1727010034,2836,1.7578106259666506,4.494336978914262,0.7859658472203469,0.7444015858283834
3655,1727010798,1727011275,477,0.6955327541881717,3.672380418557003,0.28992497832769637,0.6087865300530947
3656,1727014398,1727017998,3600,0.2913108286478097,3.020614633100276,0.1,0.1
3657,1727017998,1727020446,2448,2.032404849956225,4.63187866910705,0.9999487788639978,0.41061445219217696
3658,1727021598,1727025198,3600,0.4557338383805537,3.191563673616353,0.1,0.1
3659,1727025198,1727027945,2747,1.545302159358989,4.357680131575703,0.4139253257343114,0.27056488777872
3660,1727028798,1727030186,1388,1.215211420605004,3.9080107519890306,0.28495427768575077,0.24977178344696369
3661,1727032398,1727035998,3600,0.4392981622051222,3.166044488937314,0.1,0.1
3662,1727035998,1727039598,3600,0.1334420842048194,3.0503523995054542,0.1,0.1
3663,1727039598,1727043198,3600,0.43975525888695055,3.1309834846543856,0.1,0.1
3664,1727043198,1727046798,3600,0.3078314435663271,3.001997958027491,0.1,0.1
3665,1727046798,1727047024,226,0.8943388837278112,3.5036366567417505,0.14392287271923937,0.34223204536536356
3666,1727050398,1727052863,2465,2.3550641893819266,4.62962124044722,0.6457666079623342,0.6790528493097667
3667,1727053998,1727057598,3600,0.22071076224801633,3.0624600208234094,0.1,0.1
3668,1727057598,1727061198,3600,0.3743622622601098,3.0819337697297167,0.1,0.1
3669,1727061198,1727064798,3600,0.44267850808528764,3.132066110802621,0.1,0.1
3670,1727064798,1727066893,2095,2.187919028360241,4.543253443882047,0.24251615942064,0.22253438851804025
3671,1727068398,1727071998,3600,0.2617901940468675,3.0836195288141535,0.1,0.1
3672,1727071998,1727075047,3049,2.0817823330322303,4.441105051146798,0.8935499898069421,0.4555051554665561
3673,1727075598,1727079198,3600,0.12274407179827991,3.1510115786064845,0.1,0.1
3674,1727079198,1727082798,3600,0.3927026671393721,3.0674278855318637,0.1,0.1
3675,1727082798,1727084170,1372,1.3946786678731968,4.087134538011401,0.40933231162403416,0.5838877448320006
3676,1727086398,1727089998,3600,0.478068304190433,3.1555242819237015,0.1,0.1
3677,1727089998,1727092299,2301,2.1091691553222125,4.494821995881622,0.21699344053085126,0.7457112371183094
3678,1727093598,1727097198,3600,0.3804450145130791,3.0521212792940657,0.1,0.1
3679,1727097198,1727098962,1764,1.2536639798729685,3.923277158942215,0.8462584435963566,0.42346029535766905
3680,1727100798,1727104398,3600,0.3017913100132959,3.03373721153139,0.1,0.1
3681,1727104398,1727107998,3600,0.3347459472701329,3.031327623411517,0.1,0.1
3682,1727107998,1727111598,3600,0.2952740044094105,3.029026595286875,0.1,0.1
3683,1727111598,1727115198,3600,0.32693695107397247,3.188672496116485,0.1,0.1
3684,1727115198,1727118798,3600,0.28485484393849436,3.004810486790789,0.1,0.1
3685,1727118798,1727122398,3600,0.10210518246125494,3.03154565885722,0.1,0.1
3686,1727122398,1727125998,3600,0.2532611159670465,3.016458647516134,0.1,0.1
3687,1727125998,1727129598,3600,0.18844284388351765,3.195685459025059,0.1,0.1
3688,1727129598,1727133198,3600,0.3317304105250192,3.075969862991923,0.1,0.1
3689,1727133198,1727134820,1622,1.0157045511930312,3.9192677490449213,0.4503471926879258,0.6255834323730096
3690,1727136798,1727140174,3376,2.4635946093586165,4.4519435715013875,0.7105608744978543,0.14359642073994022
3691,1727140398,1727143998,3600,0.32548897370061114,3.073057647821373,0.1,0.1
3692,1727143998,1727147033,3035,2.1825437262410845,4.46558937449154,0.11239781980302485,0.3186008854067971
3693,1727147598,1727151198,3600,0.3884829201910215,3.095255377686357,0.1,0.1
3694,1727151198,1727154030,2832,2.0009627720357708,4.496714474881611,0.6284733717465952,0.1497047057774154
3695,1727154798,1727156673,1875,1.5844070522370002,4.581306508912503,0.30080082048864176,0.4193034882346639
3696,1727158398,1727161064,2666,2.4050217913617162,4.343256114292648,0.8143733395358107,0.4092107697239378
3697,1727161998,1727164988,2990,1.5953783617509785,4.587117951039355,0.8029698455920743,0.2542117200822931
3698,1727165598,1727169198,3600,0.3554502989942647,3.1114057824424353,0.1,0.1
3699,1727169198,1727170428,1230,1.4311881295920132,4.1269628029760534,0.6626197092750462,0.2248842615937205
3700,1727172798,1727176398,3600,0.1613550745268913,3.0222549621998613,0.1,0.1
3701,1727176398,1727178271,1873,1.61082495000568,4.534218376219891,0.6280404496637294,0.15188040646708584
3702,1727179998,1727181091,1093,1.2953080481169028,4.074372935558312,0.29327590563608524,0.7188524602856174
3703,1727183598,1727187198,3600,0.48196215501313167,3.0842236930091285,0.1,0.1
3704,1727187198,1727190798,3600,0.2612359452860965,3.1614011893775453,0.1,0.1
3705,1727190798,1727194398,3600,0.12471802864544346,3.1983122862164266,0.1,0.1
3706,1727194398,1727197374,2976,2.2404228068632035,4.323148907153937,0.6897955011842434,0.12317695627818659
3707,1727197998,1727201484,3486,1.53567513072507,4.451834980044857,0.762616784219049,0.5003806673043785
3708,1727201598,1727205198,3600,0.16006947707541916,3.1884795984735783,0.1,0.1
3709,1727205198,1727207823,2625,2.2615334143971575,4.556501769743031,0.6813916516982891,0.576360061039457
3710,1727208798,1727211985,3187,2.2154930598795133,4.604111406657985,0.6673011721308573,0.9289889765571276
3711,1727212398,1727213163,765,1.1066013527249192,4.177082325306132,0.41145778120031495,0.6112625339048228
3712,1727215998,1727217727,1729,1.2956941614350082,3.900888832952948,0.11976156040842013,0.1651352929978035
3713,1727219598,1727223198,3600,0.11566430583246588,3.0921758749810646,0.1,0.1
3714,1727223198,1727224033,835,1.0785611267089248,3.835942412192508,0.5518764955179847,0.463417507072465
3715,1727226798,1727230398,3600,0.24978891104831466,3.131312511355122,0.1,0.1
3716,1727230398,1727233686,3288,2.374968074060538,4.680002497244666,0.9507812472190909,0.5210599738683297
3717,1727233998,1727237561,3563,2.0648156777550786,4.565368090094701,0.7198981691450019,0.859896512517192
3718,1727237598,1727241198,3600,0.4153490156591192,3.1443632112109494,0.1,0.1
3719,1727241198,1727242745,1547,1.3580591811450402,3.8015812815916226,0.17698670378524306,0.4733603833777634
3720,1727244798,1727247431,2633,1.9751889151337514,4.671168337767906,0.3387007647756098,0.7950920987401932
3721,1727248398,1727251998,3600,0.15530493853613594,3.043830218009924,0.1,0.1
3722,1727251998,1727255598,3600,0.18213305794745535,3.068717556417479,0.1,0.1
3723,1727255598,1727259198,3600,0.22586196091419045,3.07472780760063,0.1,0.1
3724,1727259198,1727261585,2387,2.419034039501721,4.316623505748522,0.5842544944798954,0.118843972790746
3725,1727262798,1727263234,436,0.6152696522169768,3.5553319573009508,0.9878975982256448,0.13556814607932643
3726,1727266398,1727268331,1933,1.6239959067681138,4.547393253408631,0.128441429059136,0.8984503127260077
3727,1727269998,1727273598,3600,0.23654855050989176,3.193488416665234,0.1,0.1
3728,1727273598,1727276094,2496,1.524652994561952,4.3367985878974356,0.6296399984468299,0.7021146545283656
3729,1727277198,1727280798,3600,0.48517389789055887,3.080544134846485,0.1,0.1
3730,1727280798,1727284398,3600,0.1842053134543051,3.1925532485990535,0.1,0.1
3731,1727284398,1727287998,3600,0.4654889518286546,3.080574036385371,0.1,0.1
3732,1727287998,1727291598,3600,0.47211151713532085,3.0991711795200074,0.1,0.1
3733,1727291598,1727295198,3600,0.2959545614696835,3.147025425922018,0.1,0.1
3734,1727295198,1727298798,3600,0.3739675737747502,3.002331324278941,0.1,0.1
3735,1727298798,1727299660,862,1.4160321365262747,4.179798386439471,0.8874365020710306,0.2565524788815004
3736,1727302398,1727305998,3600,0.49238223384065816,3.1617689544563095,0.1,0.1
3737,1727305998,1727308341,2343,2.209053732513082,4.381979032002825,0.6945221138694678,0.7591347223883631
3738,1727309598,1727310706,1108,1.0901092452339791,4.139743664589169,0.5836598953595268,0.2475891346869079
3739,1727313198,1727316798,3600,0.15260518986754287,3.1365194042766285,0.1,0.1
3740,1727316798,1727320398,3600,0.3931760924083548,3.0232301171810985,0.1,0.1
3741,1727320398,1727323998,3600,0.17048838392443522,3.1335134358201784,0.1,0.1
3742,1727323998,1727327598,3600,0.10827478615448212,3.1520181630224524,0.1,0.1
3743,1727327598,1727329234,1636,1.0137589443242225,4.167280821986988,0.8350586520660598,0.8970121025156698
3744,1727331198,1727332354,1156,1.4399808279398187,3.8107973320685677,0.3215695724483262,0.30854082962930124
3745,1727334798,1727338398,3600,0.4856724450811659,3.0137105207875443,0.1,0.1
3746,1727338398,1727341998,3600,0.37427719847204066,3.0010053378410744,0.1,0.1
3747,1727341998,1727344244,2246,1.53119785903945,4.42876191956317,0.979825477006703,0.9602733237068436
3748,1727345598,1727348795,3197,1.8931092276589576,4.698672395328943,0.8868150738904483,0.7511324251120639
3749,1727349198,1727351664,2466,1.7695721756858722,4.637236018113274,0.2868431727765132,0.7051894704515824
3750,1727352798,1727355255,2457,2.3205604957814163,4.313167665388647,0.7718124083846363,0.29658007822896787
3751,1727356398,1727359788,3390,1.720810845654184,4.68602664199017,0.3988417579847401,0.8450480657126659
3752,1727359998,1727363598,3600,0.30665287263645225,3.1096843135845904,0.1,0.1
3753,1727363598,1727365553,1955,1.7282259487960694,4.686351440312734,0.20996917355821282,0.23269586606777462
3754,1727367198,1727369957,2759,2.3299473527485723,4.348771216989185,0.8506712713314675,0.9719702232076385
3755,1727370798,1727374398,3600,0.4172975403808993,3.0206007866325777,0.1,0.1
3756,1727374398,1727377200,2802,1.5331474942961454,4.495293795638702,0.1568496852592038,0.6401939771716556
3757,1727377998,1727380497,2499,2.1218672178527496,4.479135183842194,0.7278532744337316,0.6934642880171341
3758,1727381598,1727383915,2317,1.8222459070182246,4.416538036575653,0.5943182758446697,0.2527729814544911
3759,1727385198,1727388798,3600,0.2087364276700647,3.011160636456453,0.1,0.1
3760,1727388798,1727389120,322,0.661343923169204,3.434316269494594,0.6733701859751405,0.14559153862119187
3761,1727392398,1727392576,178,0.6191142253798001,3.663226625083603,0.3339164121404592,0.1953307650606137
3762,1727395998,1727399598,3600,0.2639723770436413,3.062221231977494,0.1,0.1
3763,1727399598,1727400802,1204,1.2103737298108188,4.10068025682248,0.9749717496201058,0.6800935866664205
3764,1727403198,1727403412,214,0.837739595517027,3.6886455726812475,0.9135298899033047,0.5259512192987579
3765,1727406798,1727410398,3600,0.2927476160273449,3.000026922837729,0.1,0.1
3766,1727410398,1727411936,1538,1.4726162822379338,4.075436280079468,0.14099563158157474,0.3034311592421146
3767,1727413998,1727416100,2102,1.5246032421335831,4.3356074528399695,0.32880465615016646,0.4649792639305924
3768,1727417598,1727421198,3600,0.410154668629356,3.1724318943373464,0.1,0.1
3769,1727421198,1727422287,1089,1.1176098182216134,3.953571756865403,0.2124155222578557,0.9240814915492559
3770,1727424798,1727428398,3600,0.2602037283824579,3.1435718069737715,0.1,0.1
3771,1727428398,1727431998,3600,0.17272925379226345,3.0138532881654907,0.1,0.1
3772,1727431998,1727435598,3600,0.3634230676615655,3.043263774174619,0.1,0.1
3773,1727435598,1727436509,911,1.3070880832221303,4.047740979079205,0.8493641004655242,0.3941747522917657
3774,1727439198,1727441334,2136,2.252855937516302,4.444886132512081,0.7774745532669275,0.5353367035798143
3775,1727442798,1727443770,972,1.3879281221667987,4.055605718039839,0.3242584633346177,0.679269738508196
3776,1727446398,1727449091,2693,2.1378429084929453,4.369048615747491,0.4595136109673592,0.6558268488947532
3777,1727449998,1727453598,3600,0.4023653192204878,3.1122702281275383,0.1,0.1
3778,1727453598,1727456190,2592,1.9145084966451729,4.473338838533535,0.49352749827603104,0.2955299259354427
3779,1727457198,1727458137,939,1.4003032931004307,4.190178766810973,0.7502330616745759,0.13951138070440666
3780,1727460798,1727464398,3600,0.4280132381515299,3.0007860064375063,0.1,0.1
3781,1727464398,1727467866,3468,1.8890247392003015,4.382081685494108,0.5354316584220495,0.7593483406773294
3782,1727467998,1727468304,306,0.7527521126690053,3.4323694367329165,0.4648003793539176,0.30765045480657827
3783,1727471598,1727475198,3600,0.3246160989402075,3.095249261494108,0.1,0.1
3784,1727475198,1727477523,2325,1.66615036590246,4.624779890359345,0.4842159434615828,0.6488251391620712
3785,1727478798,1727481725,2927,2.4795649079647846,4.628461506809587,0.259531968998518,0.7805225654937954
3786,1727482398,1727483237,839,1.4226131996224067,4.077627739715499,0.9055877827012081,0.6983308165326136
3787,1727485998,1727487703,1705,1.2406802827184253,4.199206506397707,0.4936946956918127,0.5006416736176764
3788,1727489598,1727493198,3600,0.20229697803249383,3.085582655443161,0.1,0.1
3789,1727493198,1727493515,317,0.7020205791348004,3.4282093877142605,0.3507821153559363,0.7733548897384646
3790,1727496798,1727500398,3600,0.18052549868246734,3.041529746286274,0.1,0.1
3791,1727500398,1727503998,3600,0.41343207274737914,3.1567645301442626,0.1,0.1
3792,1727503998,1727507598,3600,0.2221428754865158,3.0494114617832953,0.1,0.1
3793,1727507598,1727511198,3600,0.3552194333361661,3.1814132999343796,0.1,0.1
3794,1727511198,1727514798,3600,0.2605553812274174,3.1669344724378443,0.1,0.1
3795,1727514798,1727518398,3600,0.4356875043041454,3.0806285440123973,0.1,0.1
3796,1727518398,1727519070,672,1.3753020351295575,3.9235582307999954,0.8379263869843583,0.9929728912682461
3797,1727521998,1727522194,196,0.6644718494960652,3.4710709322013473,0.6130691748353527,0.4954489271897339
3798,1727525598,1727529198,3600,0.2616019343666006,3.1845959115306877,0.1,0.1
3799,1727529198,1727529432,234,0.850827193077675,3.5392853158355386,0.260298350080245,0.41183493511919667
3800,1727532798,1727535705,2907,1.632514753696679,4.577610359100352,0.9344081094939974,0.12556499072561117
3801,1727536398,1727538424,2026,1.9315847036250477,4.343321787422489,0.3342518080943303,0.1615960703807488
3802,1727539998,1727542267,2269,2.2119456564086306,4.559595736203177,0.5866991367751916,0.31044838879707043
3803,1727543598,1727547198,3600,0.3613762190575325,3.099462841500613,0.1,0.1
3804,1727547198,1727550798,3600,0.47866662727357223,3.148097043373547,0.1,0.1
3805,1727550798,1727551727,929,1.2891992133438068,3.863606631334132,0.601969438377066,0.9484861632212473
3806,1727554398,1727557998,3600,0.4517471952394837,3.0893099913875126,0.1,0.1
3807,1727557998,1727560646,2648,1.6907950337151814,4.562239817094119,0.7658843106834252,0.5336325231564825
3808,1727561598,1727564402,2804,2.1994479498745285,4.432379778586209,0.2236219974191521,0.6594782161772653
3809,1727565198,1727568798,3600,0.46365425654878034,3.013796279173822,0.1,0.1
3810,1727568798,1727571416,2618,2.148436540711243,4.610333657467799,0.38947796358001263,0.7302577501445823
3811,1727572398,1727573380,982,1.3274673064435263,4.0795394894267085,0.4231447471938091,0.5541411506778756
3812,1727575998,1727576175,177,0.9699355047951117,3.601713748693336,0.2416771080573089,0.9564837894578379
3813,1727579598,1727583198,3600,0.3913334384658326,3.0325266934103805,0.1,0.1
3814,1727583198,1727586798,3600,0.43423585580907764,3.0465487358440355,0.1,0.1
3815,1727586798,1727590398,3600,0.3788142485061915,3.0740400162784476,0.1,0.1
3816,1727590398,1727593998,3600,0.2947891113736717,3.0634782071480826,0.1,0.1
3817,1727593998,1727597426,3428,1.9214729491723492,4.31596026591247,0.27803335591195,0.17253961593809003
3818,1727597598,1727601198,3600,0.29891321321173114,3.1008678311626285,0.1,0.1
3819,1727601198,1727604798,3600,0.16317573062295693,3.066847632225854,0.1,0.1
3820,1727604798,1727608398,3600,0.11051276114358362,3.1896932839315664,0.1,0.1
3821,1727608398,1727609648,1250,1.051776149131222,3.8899621176228827,0.19083040709778182,0.5186653036579519
3822,1727611998,1727614487,2489,1.6455185430338668,4.452074951016294,0.5924891291947382,0.44460756667002876
3823,1727615598,1727619198,3600,0.32786994490886134,3.078902802571942,0.1,0.1
3824,1727619198,1727622798,3600,0.17707270477089965,3.0694330291775103,0.1,0.1
3825,1727622798,1727626398,3600,0.40203105447308185,3.1453373249761816,0.1,0.1
3826,1727626398,1727629432,3034,1.8413205875316183,4.421374065569882,0.47932438960585455,0.1888619756739851
3827,1727629998,1727631360,1362,1.3426772357051724,3.8853137867668335,0.7934056538873746,0.4925068977316761
3828,1727633598,1727637198,3600,0.2677568377189322,3.082545734905026,0.1,0.1
3829,1727637198,1727639403,2205,1.599324115215766,4.639166534767768,0.15524867215394994,0.9483173367246392
3830,1727640798,1727643045,2247,2.141893235852393,4.6175183396426505,0.5520690381200594,0.8047715724938
3831,1727644398,1727647998,3600,0.22095856399109778,3.119731946386001,0.1,0.1
3832,1727647998,1727651598,3600,0.2331138520168491,3.190273354422487,0.1,0.1
3833,1727651598,1727655198,3600,0.3239752427512639,3.121714181142247,0.1,0.1
3834,1727655198,1727658798,3600,0.3914893295575932,3.0255520167902596,0.1,0.1
3835,1727658798,1727662398,3600,0.32316276015637646,3.01223172672089,0.1,0.1
3836,1727662398,1727665998,3600,0.44515692392809225,3.1011835827609113,0.1,0.1
3837,1727665998,1727666998,1000,1.4090097827526722,4.01736822480983,0.9953317916218334,0.26638412998665806
3838,1727669598,1727673198,3600,0.3545941485264643,3.0628355668033476,0.1,0.1
3839,1727673198,1727676798,3600,0.40667936881284694,3.034541148803558,0.1,0.1
3840,1727676798,1727679628,2830,1.9183616437248476,4.555795881024086,0.28100709840177707,0.4254471661856809
3841,1727680398,1727683998,3600,0.1776298212264365,3.1894325313575345,0.1,0.1
3842,1727683998,1727687598,3600,0.14052347296434192,3.127403270792471,0.1,0.1
3843,1727687598,1727688852,1254,1.0025084885377735,4.12307684200965,0.932110937461143,0.2309386988146955
3844,1727691198,1727693144,1946,1.87528390350464,4.574510761822484,0.12408171288199343,0.5308185737406577
3845,1727694798,1727698398,3600,0.33710581438505716,3.0069001122623265,0.1,0.1
3846,1727698398,1727701111,2713,1.66413621542458,4.499452469447704,0.514898789917013,0.2327177326510449
3847,1727701998,1727705120,3122,2.1231082742587057,4.54812742090192,0.8290769190284774,0.43232637681256847
3848,1727705598,1727709198,3600,0.25744936370863775,3.121608131909283,0.1,0.1
3849,1727709198,1727712798,3600,0.1360204468334447,3.173159304875998,0.1,0.1
3850,1727712798,1727716398,3600,0.38637955516898426,3.1901059139541745,0.1,0.1
3851,1727716398,1727718617,2219,1.867043092183293,4.691404424784827,0.5368892699152713,0.9490571528944651
3852,1727719998,1727720165,167,0.6788267473277656,3.405182814834967,0.5635669341224092,0.37057723761284533
3853,1727723598,1727725937,2339,1.8595447085508645,4.631931753991628,0.401921168979512,0.7879372433558262
3854,1727727198,1727730798,3600,0.4880453726976891,3.1401797822874977,0.1,0.1
3855,1727730798,1727734398,3600,0.3532288703460117,3.162127497092023,0.1,0.1
3856,1727734398,1727736796,2398,2.319720173090164,4.5137630762046665,0.178256606706011,0.8511430500451286
3857,1727737998,1727741598,3600,0.3260635602742047,3.033063278118699,0.1,0.1
3858,1727741598,1727745198,3600,0.1969277732955813,3.1627527915510574,0.1,0.1
3859,1727745198,1727748268,3070,2.3800338397058436,4.31837365725126,0.19844693222773985,0.9608242796260202
3860,1727748798,1727752398,3600,0.42565561683279307,3.1842360456491665,0.1,0.1
3861,1727752398,1727755998,3600,0.29992466731443135,3.174078765599178,0.1,0.1
3862,1727755998,1727759598,3600,0.22800551457236354,3.1259261127833033,0.1,0.1
3863,1727759598,1727763198,3600,0.2568368080698509,3.093407848016923,0.1,0.1
3864,1727763198,1727766798,3600,0.374949801799229,3.180001478283171,0.1,0.1
3865,1727766798,1727770398,3600,0.2672991539473482,3.182426839186298,0.1,0.1
3866,1727770398,1727771101,703,1.4058242822785019,4.192610627544088,0.7377055822746492,0.31741698734185536
3867,1727773998,1727777598,3600,0.4180117701977897,3.042839541153031,0.1,0.1
3868,1727777598,1727778200,602,1.2184553499613098,4.182943989319877,0.7353904498073991,0.9869172844426366
3869,1727781198,1727781432,234,0.9422228770308286,3.6802599483296508,0.374489568477513,0.37876277356109467
3870,1727784798,1727788398,3600,0.20096343053483895,3.1708040996611415,0.1,0.1
3871,1727788398,1727790508,2110,1.7845138612018379,4.542429131061672,0.9718886985934878,0.6697510968821297
3872,1727791998,1727795598,3600,0.44647653075237637,3.056501111356523,0.1,0.1
3873,1727795598,1727799198,3600,0.23411854626350137,3.1921410169635105,0.1,0.1
3874,1727799198,1727802798,3600,0.34776297938185075,3.085701937329638,0.1,0.1
3875,1727802798,1727806398,3600,0.26303955164092296,3.0756810669057617,0.1,0.1
3876,1727806398,1727809998,3600,0.12610233014394848,3.0130123795401107,0.1,0.1
3877,1727809998,1727812321,2323,1.909078433060594,4.685511170266716,0.6952258045800315,0.4556568246923912
3878,1727813598,1727817198,3600,0.25769913238170183,3.171307626414773,0.1,0.1
3879,1727817198,1727819107,1909,2.491656946854284,4.602367049139913,0.30693629484730145,0.6282729300983999
3880,1727820798,1727824398,3600,0.11001773914495692,3.1815589375698328,0.1,0.1
3881,1727824398,1727827998,3600,0.492470923333838,3.1061659193894218,0.1,0.1
3882,1727827998,1727831598,3600,0.11176618002647105,3.0392084162829547,0.1,0.1
3883,1727831598,1727835198,3600,0.22877945787212892,3.094151998124549,0.1,0.1
3884,1727835198,1727838071,2873,1.6179897368728078,4.573110312525827,0.9712897989966532,0.9742331699414339
3885,1727838798,1727838872,74,0.6658748621945061,3.329863448421072,0.1156194910878533,0.14223396290137036
3886,1727842398,1727845365,2967,2.3465771172933536,4.5682554582809,0.9728861446804269,0.6686014891409473
3887,1727845998,1727849598,3600,0.38003969304275154,3.1155405337110667,0.1,0.1
3888,1727849598,1727850258,660,1.3717458518839032,3.8717860968974427,0.3668480745909105,0.38616740183119314
3889,1727853198,1727855851,2653,2.1262449602412667,4.382178878191362,0.9142539920581646,0.3193542086404941
3890,1727856798,1727859069,2271,2.4117291571977013,4.493718962019389,0.8307541145695309,0.8973597608468995
3891,1727860398,1727862731,2333,2.1829521234993674,4.461384900259403,0.7920049782019842,0.7096113173554053
3892,1727863998,1727867510,3512,1.57114828001788,4.543437260294472,0.7755127032290897,0.43659164793366423
3893,1727867598,1727871198,3600,0.43526119002381947,3.146902005227556,0.1,0.1
3894,1727871198,1727874798,3600,0.4842050670744048,3.1310259839482484,0.1,0.1
3895,1727874798,1727878398,3600,0.41579536916724424,3.056455692647024,0.1,0.1
3896,1727878398,1727879588,1190,1.233206415742616,3.8568049594832727,0.5535698199279017,0.19416641725533157
3897,1727881998,1727883351,1353,1.4907334553849492,3.826718217002793,0.8528349727433157,0.750353505488461
3898,1727885598,1727889198,3600,0.36122002948335197,3.138398075296396,0.1,0.1
3899,1727889198,1727891183,1985,1.8929661370296693,4.568265577907492,0.5934635115080366,0.50377384440341
3900,1727892798,1727896398,3600,0.44521126282975976,3.101207064462529,0.1,0.1
3901,1727896398,1727898400,2002,1.9386265903743498,4.498102104823207,0.44327325658654004,0.46663197704807435
3902,1727899998,1727901494,1496,1.0556731315052603,3.8499014186126552,0.6781308894163026,0.4118626070852083
3903,1727903598,1727907198,3600,0.3789429703036762,3.0406537113193273,0.1,0.1
3904,1727907198,1727910798,3600,0.4826569306056159,3.193131636634391,0.1,0.1
3905,1727910798,1727914398,3600,0.1074206229255891,3.1183147124006365,0.1,0.1
3906,1727914398,1727915837,1439,1.47722212608707,4.099089376679782,0.5610131063395035,0.37700424505385843
3907,1727917998,1727919251,1253,1.2174363083565116,4.1026852025671925,0.3489321746556786,0.8078520228983445
3908,1727921598,1727921945,347,0.5842182730721628,3.628687105170007,0.7555471590336764,0.302406809955061
3909,1727925198,1727928798,3600,0.2010944526641965,3.196895155951845,0.1,0.1
3910,1727928798,1727932075,3277,2.070495503797657,4.4262281080817925,0.20535708090225757,0.8659646479882883
3911,1727932398,1727933441,1043,1.2855066313413255,3.804183268389275,0.5679884968718598,0.24867996596226818
3912,1727935998,1727937399,1401,1.0230721462323953,4.01671612594212,0.35061533827585945,0.9176099258560454
3913,1727939598,1727941066,1468,1.2934951683146272,4.149557239527693,0.9788178723337794,0.2226180667385621
3914,1727943198,1727946119,2921,2.044229899959371,4.622709103809067,0.1421615396666825,0.449724458253408
3915,1727946798,1727950398,3600,0.4644638333171984,3.12986846222305,0.1,0.1
3916,1727950398,1727950467,69,0.9625664579823023,3.445674701846979,0.8597124852970555,0.7333499832249704
3917,1727953998,1727957598,3600,0.22071470249712188,3.014450011908336,0.1,0.1
3918,1727957598,1727960024,2426,2.314069453288183,4.403646441821735,0.2049279682622939,0.28414987044623385
3919,1727961198,1727961789,591,0.8489011365739487,3.50284119578449,0.8243685121567544,0.14892438394332622
3920,1727964798,1727968398,3600,0.40898077253602916,3.0225245760089203,0.1,0.1
3921,1727968398,1727971998,3600,0.457752245598112,3.0519823313544623,0.1,0.1
3922,1727971998,1727973513,1515,1.4934049360154582,3.9628934144093777,0.9296120818658816,0.96983036572458
3923,1727975598,1727975886,288,0.7343748957718066,3.603372299678491,0.7442515938600346,0.6123870476592655
3924,1727979198,1727982798,3600,0.3937898912459906,3.0896853363933228,0.1,0.1
3925,1727982798,1727986398,3600,0.2952507202765535,3.131301384917394,0.1,0.1
3926,1727986398,1727987582,1184,1.2013973327021612,3.9881025977194597,0.4082945480987984,0.8550203653451749
3927,1727989998,1727993598,3600,0.2050896575181092,3.0746522468441095,0.1,0.1
3928,1727993598,1727995461,1863,1.5952402850454535,4.474253466192451,0.9404429861719125,0.5988725333272429
3929,1727997198,1728000798,3600,0.16229935999695178,3.1814543152865657,0.1,0.1
3930,1728000798,1728001054,256,0.7056786301412421,3.4785826248264513,0.45120501919460143,0.1743139925135186
3931,1728004398,1728007998,3600,0.22791562837611729,3.190313294346625,0.1,0.1
3932,1728007998,1728011598,3600,0.1832572789120288,3.0302617610564453,0.1,0.1
3933,1728011598,1728013444,1846,1.727157922406797,4.678559722769725,0.6428175786551888,0.36368280615681936
3934,1728015198,1728018798,3600,0.2117388300177781,3.0177812454564577,0.1,0.1
3935,1728018798,1728022398,3600,0.16367255310359066,3.005066184725998,0.1,0.1
3936,1728022398,1728025754,3356,1.628645612544132,4.405125529940186,0.7614903940031966,0.5103534014039961
3937,1728025998,1728029598,3600,0.3507365208320373,3.0653391513417696,0.1,0.1
3938,1728029598,1728033198,3600,0.3428782941203217,3.180906795953203,0.1,0.1
3939,1728033198,1728033434,236,0.7128528713728037,3.6469600982245165,0.9530867024478051,0.557587096550346
3940,1728036798,1728039755,2957,1.53115164381935,4.687940655649662,0.6535778542258442,0.6365360559162325
3941,1728040398,1728042053,1655,1.126146033292926,4.06552378781024,0.32962075119282636,0.6714735055537497
3942,1728043998,1728044909,911,1.329807645405649,3.9374235809134857,0.48158841140483233,0.9108781423396787
3943,1728047598,1728051198,3600,0.18670649816586515,3.18189769968709,0.1,0.1
3944,1728051198,1728051521,323,0.9464884611566002,3.697641763029416,0.29292480943617216,0.11278284632047142
3945,1728054798,1728058398,3600,0.17132955092996316,3.1724890399626897,0.1,0.1
3946,1728058398,1728059382,984,1.3609413950903984,3.848469709834169,0.20900964143626832,0.717976595149022
3947,1728061998,1728065598,3600,0.21018308881492517,3.082231626462751,0.1,0.1
3948,1728065598,1728069198,3600,0.1587998850804525,3.1615731522902304,0.1,0.1
3949,1728069198,1728072798,3600,0.4994797044468323,3.119871098439474,0.1,0.1
3950,1728072798,1728076398,3600,0.24828782326204824,3.180401200078451,0.1,0.1
3951,1728076398,1728078631,2233,1.8606678073325162,4.433390156289565,0.24205438745170949,0.7311183983917634
3952,1728079998,1728081757,1759,1.081392626265759,3.9726121913827264,0.33575716478519874,0.39097866815043647
3953,1728083598,1728087198,3600,0.31996060557941886,3.017275985658891,0.1,0.1
3954,1728087198,1728090798,3600,0.16389081323283722,3.131298376914408,0.1,0.1
3955,1728090798,1728091242,444,0.5761965136720246,3.624533565606681,0.3915345326819798,0.8058992658566344
3956,1728094398,1728097998,3600,0.16658864853650152,3.171384561373521,0.1,0.1
3957,1728097998,1728100845,2847,2.3193577212835317,4.446980447593132,0.9929618749628719,0.9347390308678344
3958,1728101598,1728105198,3600,0.43817567728460194,3.197823442817331,0.1,0.1
3959,1728105198,1728108798,3600,0.280044330871295,3.041717015169665,0.1,0.1
3960,1728108798,1728111445,2647,1.6421170264625307,4.336524689830236,0.8332405966477389,0.45642220468261174
3961,1728112398,1728112722,324,0.9616844179202446,3.5785753115494843,0.29613141408887356,0.2584036100353585
3962,1728115998,1728119598,3600,0.17036699802142763,3.041789519226006,0.1,0.1
3963,1728119598,1728123198,3600,0.35619765858351193,3.120507254962998,0.1,0.1
3964,1728123198,1728123325,127,0.8265243060234212,3.4951629351813085,0.29946241378654836,0.9175245596705982
3965,1728126798,1728130398,3600,0.18388421975034844,3.1010727679717744,0.1,0.1
3966,1728130398,1728133998,3600,0.12093095668283596,3.0587546734607933,0.1,0.1
3967,1728133998,1728137598,3600,0.14913391986824465,3.0908692157206463,0.1,0.1
3968,1728137598,1728139136,1538,1.047087868125519,4.129573359111517,0.9117109346284424,0.7806552729154562
3969,1728141198,1728144798,3600,0.3248863062415639,3.0609567134392655,0.1,0.1
3970,1728144798,1728145801,1003,1.2763776437912544,4.166808149150432,0.5853961495538381,0.5693472033664874
3971,1728148398,1728151998,3600,0.3640858272184634,3.157671629436461,0.1,0.1
3972,1728151998,1728152805,807,1.2109379324352796,3.929725682984832,0.4846016210641142,0.41322513868843713
3973,1728155598,1728158385,2787,2.374101540487795,4.464751952178019,0.2008778249253636,0.5616309073451965
3974,1728159198,1728160771,1573,1.0087258840227775,4.066072378681757,0.8481941424137615,0.2585793266257302
3975,1728162798,1728163161,363,0.6542162685434728,3.6820542542567276,0.9521142358736621,0.9357562876743606
3976,1728166398,1728169998,3600,0.3264962251150415,3.057668731415367,0.1,0.1
3977,1728169998,1728171653,1655,1.0377788229503584,4.188708745855796,0.6301233389773025,0.7617241510654372
3978,1728173598,1728176660,3062,1.7766965326082427,4.429757444970659,0.14268501442359918,0.8670817270003973
3979,1728177198,1728180798,3600,0.1456741483234777,3.1549663076972054,0.1,0.1
3980,1728180798,1728184398,3600,0.2901820151740574,3.0810173090074713,0.1,0.1
3981,1728184398,1728187998,3600,0.19643967441507837,3.126701376989364,0.1,0.1
3982,1728187998,1728191598,3600,0.10646854260660331,3.0817791799807077,0.1,0.1
3983,1728191598,1728195198,3600,0.20649522946269847,3.038058542105497,0.1,0.1
3984,1728195198,1728195828,630,1.3854919548938354,4.105408069842149,0.9250387352853562,0.7821122423261588
3985,1728198798,1728202398,3600,0.1501089566042378,3.0853600186717847,0.1,0.1
3986,1728202398,1728205980,3582,2.09220366739173,4.6962314085856125,0.33883077895706254,0.5205569895353402
3987,1728205998,1728209598,3600,0.1926479949879433,3.1808908121187636,0.1,0.1
3988,1728209598,1728210712,1114,1.1833212413080267,4.174205549162593,0.30795505944477475,0.8883333590960161
3989,1728213198,1728216798,3600,0.4085618010559605,3.0205224197786613,0.1,0.1
3990,1728216798,1728219901,3103,1.8179486106621847,4.331725653105718,0.6401193695878853,0.32068025516191945
3991,1728220398,1728220917,519,0.5126205213981047,3.422373859924676,0.18973003895350432,0.9595332725287294
3992,1728223998,1728224743,745,1.3887280590908608,4.1852191629362965,0.6638189001203402,0.9860847786435918
3993,1728227598,1728230862,3264,2.3282956541331656,4.536516394826871,0.7373602134537225,0.21499337496720833
3994,1728231198,1728231646,448,0.8319555568155168,3.4740195962934632,0.5192799409136079,0.5156431484054292
3995,1728234798,1728237240,2442,1.7051850811434708,4.484089926660153,0.18465132160480252,0.7351164763919601
3996,1728238398,1728241998,3600,0.22320208728696236,3.007646680501519,0.1,0.1
3997,1728241998,1728242638,640,1.3688779873541919,3.949776781411695,0.47866567748993927,0.8020766657705417
3998,1728245598,1728249198,3600,0.2544047753404579,3.0622261590997892,0.1,0.1
3999,1728249198,1728250717,1519,1.0565763348377666,3.928705991075046,0.17113675638944437,0.988996774447384
4000,1728252798,1728256398,3600,0.4213243617235899,3.138090456026183,0.1,0.1
4001,1728256398,1728259998,3600,0.16306595592603562,3.0060961181107384,0.1,0.1
4002,1728259998,1728263560,3562,1.6693260233077265,4.483726997466974,0.23623248634906124,0.94657657791356
4003,1728263598,1728267198,3600,0.4948330688315786,3.0204328181869795,0.1,0.1
4004,1728267198,1728270798,3600,0.4617000639761627,3.0018914552147815,0.1,0.1
4005,1728270798,1728274398,3600,0.11931372638233372,3.194719061926911,0.1,0.1
4006,1728274398,1728277998,3600,0.32717713665083714,3.0680006505788064,0.1,0.1
4007,1728277998,1728278760,762,1.4610295798897668,3.8409870923089713,0.8620622321202007,0.42077673061568355
4008,1728281598,1728285198,3600,0.1301732765430913,3.0922537265367205,0.1,0.1
4009,1728285198,1728288798,3600,0.1651373072750767,3.074771731662824,0.1,0.1
4010,1728288798,1728292160,3362,2.332041099095466,4.591408250720761,0.20843081525123863,0.7326492927966191
4011,1728292398,1728295998,3600,0.11974501161718601,3.1112871760108707,0.1,0.1
4012,1728295998,1728299492,3494,2.323423092603285,4.365621035274521,0.9044157449308883,0.6269988339049772
4013,1728299598,1728303198,3600,0.1977681953037198,3.066308390583545,0.1,0.1
4014,1728303198,1728306325,3127,2.4333243200066432,4.580375443654945,0.6680459392218547,0.14597220126906404
4015,1728306798,1728309495,2697,2.0640993819347124,4.31214153081095,0.5818941566330511,0.8352364776773377
4016,1728310398,1728313790,3392,1.5648675465354804,4.50937926992543,0.882522714702698,0.13200034695054372
4017,1728313998,1728314336,338,0.728565307820643,3.411682931406988,0.568919539940033,0.42413291748720205
4018,1728317598,1728320872,3274,1.6967715920108306,4.501690171043615,0.7646413750785238,0.5861377467147793
4019,1728321198,1728321933,735,1.0862663945455426,4.188609800186553,0.9902292172145358,0.4141309559901232
4020,1728324798,1728328398,3600,0.18864817069124995,3.18061175277275,0.1,0.1
4021,1728328398,1728331998,3600,0.45084847640307546,3.0285118326940665,0.1,0.1
4022,1728331998,1728335565,3567,2.14974975842948,4.560301736941329,0.2719102047293905,0.19179220302116273
4023,1728335598,1728335727,129,0.9902843837756724,3.6722435325416845,0.7318389745500694,0.8117435533148994
4024,1728339198,1728341712,2514,1.6331110896988166,4.355668299574917,0.21900852277867983,0.9733390827845476
4025,1728342798,1728346398,3600,0.39884536354156963,3.0247582402604642,0.1,0.1
4026,1728346398,1728349276,2878,2.115350463213369,4.350258345677429,0.5078225379154665,0.8934298994928941
4027,1728349998,1728353598,3600,0.47500907985892515,3.0199249001661594,0.1,0.1
4028,1728353598,1728353950,352,0.8737006628851851,3.37023217770604,0.6967683104494568,0.3498701638860969
4029,1728357198,1728358004,806,1.3636006717935194,4.185229956395065,0.9195635923815122,0.9736233747056066
4030,1728360798,1728363554,2756,2.403222385396884,4.380115281912033,0.2040118335832018,0.1453385191809286
4031,1728364398,1728364604,206,0.7193550290682208,3.4447220670300043,0.5200354572380903,0.9447583342750958
4032,1728367998,1728371598,3600,0.2575972373826575,3.170501393063298,0.1,0.1
4033,1728371598,1728371930,332,0.5703557744324137,3.5050479200790834,0.17514024207633783,0.5091106346846413
4034,1728375198,1728378798,3600,0.3366181646670169,3.1104571306679136,0.1,0.1
4035,1728378798,1728382229,3431,1.829885156899095,4.41945966663173,0.32105704993809153,0.5951023024156228
4036,1728382398,1728385998,3600,0.4247543047284389,3.0497438987793544,0.1,0.1
4037,1728385998,1728389598,3600,0.350985523442212,3.167726401622722,0.1,0.1
4038,1728389598,1728391612,2014,2.31928002489877,4.565429431997513,0.7189127010845732,0.5283417007563145
4039,1728393198,1728396798,3600,0.18960291560408585,3.126455762503925,0.1,0.1
4040,1728396798,1728400253,3455,1.7480566913822382,4.354562104734913,0.9320986951946502,0.5763169552373345
4041,1728400398,1728401966,1568,1.2869880390858355,4.120117560948279,0.29651801217762447,0.4357623126197544
4042,1728403998,1728404780,782,1.1629690131415242,4.192544853249256,0.7780283225127145,0.1070960101998388
4043,1728407598,1728411198,3600,0.3352318573583495,3.0893026712988645,0.1,0.1
4044,1728411198,1728414798,3600,0.227007345248567,3.0099717724398998,0.1,0.1
4045,1728414798,1728415675,877,1.0161641302576967,3.968097160723193,0.16275064772959968,0.8573213848456006
4046,1728418398,1728419421,1023,1.3555085720706348,3.954557016220391,0.9005331535870515,0.2746942059327576
4047,1728421998,1728425598,3600,0.3443660512294917,3.0979482112945984,0.1,0.1
4048,1728425598,1728428429,2831,2.1856617212511473,4.614755695111079,0.9537831770096309,0.3585279276804567
4049,1728429198,1728432798,3600,0.34680930228600176,3.019405935564611,0.1,0.1
4050,1728432798,1728434155,1357,1.3257255682414133,4.124531194351148,0.5781687458853573,0.26992817494822907
4051,1728436398,1728439998,3600,0.378456558761746,3.047317963627288,0.1,0.1
4052,1728439998,1728443598,3600,0.36074898726332194,3.0877304296257595,0.1,0.1
4053,1728443598,1728447198,3600,0.21068838449766597,3.1203022181486957,0.1,0.1
4054,1728447198,1728450798,3600,0.49265331970816173,3.03767027141326,0.1,0.1
4055,1728450798,1728454398,3600,0.1291793718382238,3.0943355157223493,0.1,0.1
4056,1728454398,1728457998,3600,0.4981076367167928,3.0671181615766603,0.1,0.1
4057,1728457998,1728461598,3600,0.10965139180305138,3.176207882421219,0.1,0.1
4058,1728461598,1728465198,3600,0.3148083417908838,3.121297419179849,0.1,0.1
4059,1728465198,1728467300,2102,2.1745972412345522,4.518280071178353,0.7793828392917493,0.5096390775967437
4060,1728468798,1728472398,3600,0.20421358217258945,3.177539701966527,0.1,0.1
4061,1728472398,1728473724,1326,1.2077656868509825,3.970000039640082,0.3903468334570913,0.10534002483950987
4062,1728475998,1728479598,3600,0.13931575681153632,3.0614968973655676,0.1,0.1
4063,1728479598,1728481760,2162,2.009496593340367,4.341733121360409,0.1333792971340481,0.17337208342064497
4064,1728483198,1728484432,1234,1.256625187644898,4.199195389962343,0.7003367479201676,0.11625312413165133
4065,1728486798,1728490398,3600,0.49747440002514687,3.063050016608724,0.1,0.1
4066,1728490398,1728492989,2591,1.941392897964234,4.38618515809165,0.12610647679315373,0.27677712394580456
4067,1728493998,1728497598,3600,0.24857846465835576,3.0733564617961227,0.1,0.1
4068,1728497598,1728501198,3600,0.4977212092344673,3.0215336250853597,0.1,0.1
4069,1728501198,1728504658,3460,1.9583659718106152,4.411836359075814,0.15366850722355144,0.8617957783970223
4070,1728504798,1728508398,3600,0.41283690481178226,3.1605461730907027,0.1,0.1
4071,1728508398,1728509743,1345,1.0496872965494688,3.8068856196285727,0.8881030343883903,0.4106834729882861
4072,1728511998,1728515598,3600,0.3488142994186237,3.0132010655081265,0.1,0.1
4073,1728515598,1728519198,3600,0.2080453647119807,3.161843696240153,0.1,0.1
4074,1728519198,1728522116,2918,1.7706361880184076,4.409688397312584,0.5527217119030087,0.8426029246139489
4075,1728522798,1728525304,2506,2.0081566709093757,4.355189335481254,0.9447280319924557,0.6681819819642694
4076,1728526398,1728526740,342,0.6547323091621648,3.505895424050421,0.15121706621009762,0.5362156434143103
4077,1728529998,1728532002,2004,2.4364663121778,4.38122562084252,0.47173122627586694,0.45153572891853055
4078,1728533598,1728537198,3600,0.40072116198292906,3.073220280465968,0.1,0.1
4079,1728537198,1728539404,2206,2.398439895585598,4.574440734374878,0.6837063976724138,0.8589903027500138
4080,1728540798,1728543289,2491,2.1295449978140994,4.416670474400196,0.4124226150972111,0.8155433632078254
4081,1728544398,1728547998,3600,0.2689964020341842,3.1586309434432005,0.1,0.1
4082,1728547998,1728549727,1729,1.0391915269921155,4.068990252670979,0.7731459801965348,0.3870741646087963
4083,1728551598,1728555198,3600,0.35589387012173856,3.0494171858521164,0.1,0.1
4084,1728555198,1728555433,235,0.7866028826684164,3.4220475426645764,0.7692772190847827,0.6510775893344346
4085,1728558798,1728562398,3600,0.2418533654780775,3.142972795980918,0.1,0.1
4086,1728562398,1728565998,3600,0.3119476933106381,3.0511595882420965,0.1,0.1
4087,1728565998,1728566278,280,0.7294116761005944,3.6000995181113398,0.6380353232159491,0.1652365140556186
4088,1728569598,1728569785,187,0.8166156921640446,3.689404674375935,0.3860177284244175,0.9263989183145042
4089,1728573198,1728575134,1936,2.417422681516529,4.430754332517471,0.2047873722190588,0.19323533294874995
4090,1728576798,1728576926,128,0.6688185149161042,3.659305262276005,0.4671570217102847,0.8649323621699517
4091,1728580398,1728583998,3600,0.3140631385132365,3.1106899422043646,0.1,0.1
4092,1728583998,1728585769,1771,1.4550558026676566,3.934418179983872,0.9264507830439115,0.8315064535585442
4093,1728587598,1728591198,3600,0.17964880888953721,3.046192510546683,0.1,0.1
4094,1728591198,1728594798,3600,0.4429871081223783,3.1878322351041235,0.1,0.1
4095,1728594798,1728595162,364,0.8887671597438076,3.5935192448222475,0.8124615704258555,0.53112019362194
4096,1728598398,1728601998,3600,0.4076451416832405,3.083355416274957,0.1,0.1
4097,1728601998,1728605598,3600,0.3554018416505139,3.057873675433148,0.1,0.1
4098,1728605598,1728609198,3600,0.1650697786285225,3.1598540084106226,0.1,0.1
4099,1728609198,1728609504,306,0.5414747040198393,3.3425566902583297,0.11947847419953145,0.8069034911790006
4100,1728612798,1728614557,1759,1.34900181481099,3.9521508109690306,0.6753265964099538,0.2539863167606067
4101,1728616398,1728619998,3600,0.2418271631074326,3.0259332395981606,0.1,0.1
4102,1728619998,1728621927,1929,1.7059219373841032,4.329304226014897,0.915358894744925,0.9702399322233022
4103,1728623598,1728626729,3131,1.7602362600348798,4.670295090509852,0.37580297940783247,0.9757597585878912
4104,1728627198,1728629026,1828,2.063386769947804,4.557165188508012,0.9127036726384264,0.5588938748167682
4105,1728630798,1728634398,3600,0.25993499623229777,3.148991677024478,0.1,0.1
4106,1728634398,1728637998,3600,0.4454404815592602,3.130571898739571,0.1,0.1
4107,1728637998,1728641598,3600,0.36690648559207706,3.129796278582684,0.1,0.1
4108,1728641598,1728645107,3509,1.5055377120309934,4.609913042207077,0.6295422962830061,0.41395786061528406
4109,1728645198,1728645914,716,1.3506401138284168,4.184788249871841,0.81451086425696,0.4041481231846282
4110,1728648798,1728649552,754,1.4101849300095306,4.089299521814839,0.40222565964045276,0.9113331768695546
4111,1728652398,1728655998,3600,0.13023681701321987,3.013352701936107,0.1,0.1
4112,1728655998,1728659598,3600,0.2258231831726256,3.0631058495994834,0.1,0.1
4113,1728659598,1728661520,1922,2.0200089878507606,4.690084078368936,0.3412741782845771,0.9518213318384341
4114,1728663198,1728665090,1892,2.3436562162353094,4.368793513860769,0.3049523989113694,0.740730393498463
4115,1728666798,1728668105,1307,1.3252912992028425,4.137050605603752,0.5678648290542037,0.24005211018422729
4116,1728670398,1728673998,3600,0.31045402346552536,3.077037802988263,0.1,0.1
4117,1728673998,1728674302,304,0.9733659682187327,3.6730754286508183,0.4907427268389636,0.4171379844792429
4118,1728677598,1728681198,3600,0.33187385899160926,3.188622141940319,0.1,0.1
4119,1728681198,1728684798,3600,0.3068137478990106,3.009941764109128,0.1,0.1
4120,1728684798,1728688398,3600,0.25086820655210673,3.1239801118709485,0.1,0.1
4121,1728688398,1728691998,3600,0.3120138913798566,3.189652296770185,0.1,0.1
4122,1728691998,1728695598,3600,0.11125998542440452,3.007053344175845,0.1,0.1
4123,1728695598,1728699198,3600,0.1934002730995378,3.0997467016293117,0.1,0.1
4124,1728699198,1728702798,3600,0.2530501569530529,3.1588892200105816,0.1,0.1
4125,1728702798,1728706398,3600,0.19656308672563175,3.18044989487602,0.1,0.1
4126,1728706398,1728709998,3600,0.28503720972484226,3.1429762589840795,0.1,0.1
4127,1728709998,1728713494,3496,1.6575461192535157,4.453532917861856,0.9808738909369593,0.6345751596560659
4128,1728713598,1728717198,3600,0.1331173884431781,3.180775657584678,0.1,0.1
4129,1728717198,1728720798,3600,0.3089313856628393,3.0397035756670783,0.1,0.1
4130,1728720798,1728722855,2057,2.0208508296862977,4.584680901811498,0.36523381727809967,0.8934479110017608
4131,1728724398,1728724982,584,0.9771618909759754,3.3345757572893477,0.43500416265915887,0.8539911751738276
4132,1728727998,1728731598,3600,0.18906861028226418,3.171043742564108,0.1,0.1
4133,1728731598,1728733433,1835,1.6651117066918275,4.678434633566328,0.19688117836205632,0.7089541837522298
4134,1728735198,1728737885,2687,2.404367175030626,4.638613008587774,0.7829638038526524,0.1117156589265857
4135,1728738798,1728742398,3600,0.34383386258736875,3.171030302247521,0.1,0.1
4136,1728742398,1728745998,3600,0.4507991319404653,3.0416281169211943,0.1,0.1
4137,1728745998,1728749598,3600,0.4908763791831986,3.0451442016592223,0.1,0.1
4138,1728749598,1728749760,162,0.7390069477220312,3.4506700009363245,0.9877474877308102,0.6881320188621679
4139,1728753198,1728756798,3600,0.2624098920917328,3.180217310262633,0.1,0.1
4140,1728756798,1728760398,3600,0.29988818313984644,3.1377289582266004,0.1,0.1
4141,1728760398,1728763998,3600,0.38757858133578327,3.108570496693627,0.1,0.1
4142,1728763998,1728767598,3600,0.37558527932318586,3.0449389856299183,0.1,0.1
4143,1728767598,1728771073,3475,2.210073058684035,4.525686508218737,0.2599456900485996,0.3794478005108808
4144,1728771198,1728774798,3600,0.3200900529684233,3.0212098806145136,0.1,0.1
4145,1728774798,1728778398,3600,0.2410844188202825,3.1416960712353483,0.1,0.1
4146,1728778398,1728781369,2971,2.185583806408188,4.3704767540410785,0.5025827117711139,0.6685273422319571
4147,1728781998,1728785598,3600,0.15594929364433618,3.1724777902339723,0.1,0.1
4148,1728785598,1728789198,3600,0.17769070921899233,3.12333292548265,0.1,0.1
4149,1728789198,1728789791,593,0.5795773581267769,3.3239315541752075,0.8556563728466052,0.2421987772849638
4150,1728792798,1728794815,2017,1.9975322527396764,4.661023320117111,0.8849493977519797,0.6615272789736139
4151,1728796398,1728797306,908,1.1054668955503053,4.154448212935853,0.9786695304845141,0.7845004189826236
4152,1728799998,1728802388,2390,2.223738395229154,4.547795066003538,0.8071079121906849,0.8642955016841795
4153,1728803598,1728805535,1937,2.026905688452617,4.375608748697941,0.6090175649229719,0.763447059882542
4154,1728807198,1728810798,3600,0.22326700101318142,3.1013990884398717,0.1,0.1
4155,1728810798,1728813580,2782,2.3124929422308114,4.498086486581653,0.6056425575806287,0.1900666118367052
4156,1728814398,1728815129,731,1.0433941607410324,4.160055162870272,0.44839327773869353,0.24876129594775095
4157,1728817998,1728820379,2381,2.2512556554725047,4.6362153000411706,0.5016275876799802,0.7752765112035896
4158,1728821598,1728821874,276,0.55221026711021,3.4482032424614477,0.806999685885082,0.6659235009312183
4159,1728825198,1728825512,314,0.5359109263767365,3.6286609870373803,0.42039862162793606,0.5067404575832368
4160,1728828798,1728832269,3471,1.6506423436971225,4.334682325301626,0.7420071314203961,0.8785608193936898
4161,1728832398,1728835998,3600,0.1759670041098755,3.0291353955646114,0.1,0.1
4162,1728835998,1728839598,3600,0.46368343555118763,3.013594645363161,0.1,0.1
4163,1728839598,1728843198,3600,0.35819165809362286,3.170915191052077,0.1,0.1
4164,1728843198,1728845023,1825,1.6158100099339716,4.672487751419699,0.6125309368227649,0.1547415753727155
4165,1728846798,1728850398,3600,0.16175338317419297,3.114402635744264,0.1,0.1
4166,1728850398,1728853998,3600,0.229998478728586,3.1361963402702884,0.1,0.1
4167,1728853998,1728857598,3600,0.1735177679096999,3.1211727947430044,0.1,0.1
4168,1728857598,1728861198,3600,0.48501415767853884,3.082704303994148,0.1,0.1
4169,1728861198,1728863825,2627,2.169917155718392,4.66865458973537,0.37498920288305604,0.16733813247552154
4170,1728864798,1728867537,2739,1.970828695829271,4.672326704959817,0.9910663211263452,0.5310730629172172
4171,1728868398,1728871998,3600,0.39615050430362064,3.192228088170968,0.1,0.1
4172,1728871998,1728872967,969,1.3939922409820542,3.933863956418416,0.1438257969169161,0.17451090415780934
4173,1728875598,1728877885,2287,2.219060573115114,4.463703641176248,0.34724977522102374,0.4957039885888115
4174,1728879198,1728882292,3094,1.9605590231721326,4.634456802614851,0.9424682585994797,0.8896462286192656
4175,1728882798,1728884109,1311,1.1743214161999793,4.044678553679116,0.800935520225322,0.925393459263522
4176,1728886398,1728889998,3600,0.4935932549169809,3.075936996969791,0.1,0.1
4177,1728889998,1728893598,3600,0.2747994321178136,3.160938028233621,0.1,0.1
4178,1728893598,1728897198,3600,0.3880869650648552,3.026028375247169,0.1,0.1
4179,1728897198,1728900090,2892,1.9809277889188954,4.652089648415572,0.5985932634636626,0.9401739503865412
4180,1728900798,1728904398,3600,0.2886151363160684,3.069248670684577,0.1,0.1
4181,1728904398,1728907150,2752,1.8820627565483226,4.530368079315578,0.6031590380385892,0.627750724916696
4182,1728907998,1728911598,3600,0.22726401681441633,3.1161175905666094,0.1,0.1
4183,1728911598,1728911814,216,0.9733459602174481,3.51381578312766,0.4114196985593287,0.37115906254908904
4184,1728915198,1728918798,3600,0.3710745125834598,3.0404149648882917,0.1,0.1
4185,1728918798,1728922398,3600,0.2866193780825117,3.199904287318482,0.1,0.1
4186,1728922398,1728925998,3600,0.1833719145456891,3.0622025712146677,0.1,0.1
4187,1728925998,1728929598,3600,0.1106570215016431,3.1865117511123393,0.1,0.1
4188,1728929598,1728932836,3238,1.626992813737941,4.61205426872779,0.26902711338494356,0.23443827769143188
4189,1728933198,1728933949,751,1.137980203807003,3.8979336578645376,0.47811733919277055,0.10485882941059116
4190,1728936798,1728939163,2365,1.5126676001572372,4.330498208631779,0.823811201616473,0.7738923787578237
4191,1728940398,1728941134,736,1.3888216705596386,3.843088218713576,0.9718718166693641,0.9729024684090808
4192,1728943998,1728945722,1724,1.2880266685101054,3.960516408003771,0.8619660701882844,0.6723760619390158
4193,1728947598,1728951198,3600,0.1392037347514793,3.04338844465022,0.1,0.1
4194,1728951198,1728953991,2793,1.8444994715729908,4.538701534324159,0.20611140607165132,0.3712139085345755
4195,1728954798,1728955693,895,1.059860653061559,3.92244860002265,0.3784835211442983,0.9593536517140883
4196,1728958398,1728959435,1037,1.0648662109522933,3.8744625197402427,0.9674791796883245,0.1981637812337546
4197,1728961998,1728965598,3600,0.3340262637546114,3.070105720217656,0.1,0.1
4198,1728965598,1728969198,3600,0.32006949441887433,3.045066383034173,0.1,0.1
4199,1728969198,1728970323,1125,1.4827711497521654,4.135426904580582,0.7390657343594241,0.2708581652007733
4200,1728972798,1728975714,2916,1.9435489369293617,4.334936641793881,0.4148522669415873,0.1350633740056079
4201,1728976398,1728979998,3600,0.2829797783663054,3.0487631388916294,0.1,0.1
4202,1728979998,1728982926,2928,1.757234377394785,4.461517759536207,0.32804923996156043,0.2364461200732232
4203,1728983598,1728987198,3600,0.4292889118050387,3.097470991848161,0.1,0.1
4204,1728987198,1728990798,3600,0.45843667528624665,3.1252013695424883,0.1,0.1
4205,1728990798,1728991581,783,1.0181684695009123,3.8923388773272096,0.8185112165757483,0.4684337235328888
4206,1728994398,1728997998,3600,0.1373698804900864,3.1285302812234987,0.1,0.1
4207,1728997998,1729001598,3600,0.31608295684650894,3.152954884807504,0.1,0.1
4208,1729001598,1729002027,429,0.953071931244593,3.513827125725503,0.8434165801513628,0.8340148198928308
4209,1729005198,1729006325,1127,1.0447033940076285,4.152304888592481,0.593135272359983,0.6917257096859125
4210,1729008798,1729012398,3600,0.44970603902091266,3.0647586749536018,0.1,0.1
4211,1729012398,1729013507,1109,1.4392403522501767,4.014880732122768,0.13803164477110658,0.448969230094164
4212,1729015998,1729019598,3600,0.3914205486815895,3.1004852893825587,0.1,0.1
4213,1729019598,1729023128,3530,1.567251449417829,4.439227505114692,0.6683508613315059,0.6990978034844247
4214,1729023198,1729024136,938,1.3698491852542936,3.80435820683516,0.26153794800569397,0.32752879502391286
4215,1729026798,1729030398,3600,0.3176961777927708,3.1954606277535924,0.1,0.1
4216,1729030398,1729030873,475,0.6668735548206515,3.394586285136915,0.1145688101530078,0.6036442079623665
4217,1729033998,1729037511,3513,2.387761117889671,4.646781845426435,0.5470290303642452,0.5867900070458494
4218,1729037598,1729037774,176,0.8658304134414161,3.4949010041567656,0.5356049252893704,0.30688618758740827
4219,1729041198,1729041369,171,0.563950186544615,3.512905476998738,0.45014324585274657,0.20252564868983125
4220,1729044798,1729047036,2238,1.6847701295422408,4.563788664143683,0.16849571326877494,0.5016768077437341
4221,1729048398,1729048686,288,0.6986373428452755,3.3460863157323018,0.15465391001943524,0.25084431437279653
4222,1729051998,1729052459,461,0.8937079322077794,3.625400020530619,0.9737499330772558,0.7379792982544104
4223,1729055598,1729059198,3600,0.45343073023805125,3.088551605962904,0.1,0.1
4224,1729059198,1729059842,644,1.001558605643796,3.862490572791621,0.863908864707045,0.9835315296010022
4225,1729062798,1729066398,3600,0.4845926735125249,3.0222753490316454,0.1,0.1
4226,1729066398,1729069998,3600,0.3686254316444878,3.08212716667847,0.1,0.1
4227,1729069998,1729073598,3600,0.27152040876027483,3.1175092865959795,0.1,0.1
4228,1729073598,1729077198,3600,0.3998962899329399,3.1019249276357437,0.1,0.1
4229,1729077198,1729077764,566,0.8042128350833869,3.534688150831384,0.4980704173289884,0.5272739019566071
4230,1729080798,1729084398,3600,0.3545250272031396,3.0226603789930535,0.1,0.1
4231,1729084398,1729087998,3600,0.2101618002181018,3.0607916908737294,0.1,0.1
4232,1729087998,1729091598,3600,0.35874521494862643,3.0597290896521545,0.1,0.1
4233,1729091598,1729095198,3600,0.24977475996403006,3.051723492523361,0.1,0.1
4234,1729095198,1729098798,3600,0.20708543620521663,3.151737766200216,0.1,0.1
4235,1729098798,1729102398,3600,0.3618002407823965,3.063217417593429,0.1,0.1
4236,1729102398,1729102800,402,0.5041415351553278,3.696412174194446,0.5938831539101607,0.6505397565483867
4237,1729105998,1729109598,3600,0.40920131734716003,3.082022251931322,0.1,0.1
4238,1729109598,1729112812,3214,2.4957593502569657,4.349870782728938,0.3067391634905221,0.636934766621723
4239,1729113198,1729116798,3600,0.3849513758446633,3.1850162751274627,0.1,0.1
4240,1729116798,1729120398,3600,0.4121120553329597,3.1381605487191857,0.1,0.1
4241,1729120398,1729123998,3600,0.31735113983855495,3.0875725512617227,0.1,0.1
4242,1729123998,1729127598,3600,0.17339957102982095,3.016134667283451,0.1,0.1
4243,1729127598,1729131198,3600,0.1386020775083921,3.027198264036624,0.1,0.1
4244,1729131198,1729134706,3508,2.1337417041909683,4.548374148067462,0.1604964870323377,0.7257103735579593
4245,1729134798,1729138398,3600,0.3522251984680602,3.1965066411604424,0.1,0.1
4246,1729138398,1729141998,3600,0.2634818302725433,3.173117929621781,0.1,0.1
4247,1729141998,1729144140,2142,2.3653729675098347,4.386297405945958,0.17540344145546266,0.7423337810031106
4248,1729145598,1729147549,1951,2.3411019818158345,4.659398746506693,0.699945498214616,0.6097117610615187
4249,1729149198,1729152417,3219,2.055071663688124,4.472759282826715,0.7404989193848436,0.13295641130434427
4250,1729152798,1729156398,3600,0.4941181400061372,3.014558111352657,0.1,0.1
4251,1729156398,1729159807,3409,1.8468618866811046,4.591246586488228,0.23466063858256442,0.49709084964335126
4252,1729159998,1729162786,2788,2.0027185522325697,4.3709039341142795,0.14115805916279384,0.772647239877342
4253,1729163598,1729167198,3600,0.36604275801696873,3.1430095599780588,0.1,0.1
4254,1729167198,1729170798,3600,0.19060664479736864,3.0085947245245697,0.1,0.1
4255,1729170798,1729174398,3600,0.3136833220829339,3.049991624996208,0.1,0.1
4256,1729174398,1729177998,3600,0.1136596058184598,3.1970469044165,0.1,0.1
4257,1729177998,1729180750,2752,1.6174945885733059,4.502313724864718,0.8313376625293135,0.9199284611819567
4258,1729181598,1729182991,1393,1.0060510607294735,4.079578625887974,0.702470510375816,0.2814345063266075
4259,1729185198,1729188798,3600,0.17859442868670491,3.01843097425822,0.1,0.1
4260,1729188798,1729192398,3600,0.20346268180128183,3.0539283501573062,0.1,0.1
4261,1729192398,1729195638,3240,1.9951041027368954,4.406143664755817,0.6226665111812889,0.494954743985315
4262,1729195998,1729199598,3600,0.44510159027466945,3.0844763828391097,0.1,0.1
4263,1729199598,1729201197,1599,1.0126098677583883,4.1868621308644896,0.18439672637942534,0.7005927766159815
4264,1729203198,1729206798,3600,0.47406029951929296,3.0590771003196022,0.1,0.1
4265,1729206798,1729210398,3600,0.11840776395428572,3.0772530523823236,0.1,0.1
4266,1729210398,1729213998,3600,0.172726687979261,3.044575407464913,0.1,0.1
4267,1729213998,1729217598,3600,0.4806193303350429,3.0403725681960077,0.1,0.1
4268,1729217598,1729217947,349,0.8102428144158518,3.42527716865439,0.758267104023212,0.28358921397384623
4269,1729221198,1729224798,3600,0.2914566793854299,3.088207340446418,0.1,0.1
4270,1729224798,1729228398,3600,0.16757935177595154,3.0316573875797284,0.1,0.1
4271,1729228398,1729231998,3600,0.48786069467358184,3.060454558790338,0.1,0.1
4272,1729231998,1729232829,831,1.3654395248847324,3.9713097517881106,0.7005353153748959,0.5347453298246385
4273,1729235598,1729239198,3600,0.374716314457365,3.0179601819494,0.1,0.1
4274,1729239198,1729241001,1803,1.8973907581594398,4.673284613997621,0.44495912616388666,0.9791854124748562
4275,1729242798,1729246398,3600,0.47621598232415685,3.0074959006130557,0.1,0.1
4276,1729246398,1729249998,3600,0.3513195975957212,3.09630353786253,0.1,0.1
4277,1729249998,1729250169,171,0.5958853920674618,3.4245887614599493,0.30721247953104314,0.3104797747551089
4278,1729253598,1729257198,3600,0.1207512950635255,3.1877918164274957,0.1,0.1
4279,1729257198,1729260798,3600,0.2888187373268648,3.1770237844484606,0.1,0.1
4280,1729260798,1729264398,3600,0.17126293059319125,3.062671964228669,0.1,0.1
4281,1729264398,1729267342,2944,2.106337980514112,4.4092383180334584,0.14650719562358586,0.45145001967052845
4282,1729267998,1729271598,3600,0.19791525829758583,3.0014855324049816,0.1,0.1
4283,1729271598,1729275198,3600,0.3008592013260683,3.0178659972237702,0.1,0.1
4284,1729275198,1729278798,3600,0.37492807540753115,3.0044289706573286,0.1,0.1
4285,1729278798,1729281421,2623,2.0624641860701667,4.6718586945435066,0.6635255600183229,0.6849695565665229
4286,1729282398,1729285472,3074,1.7085867167968547,4.664367881191332,0.4301131635000006,0.2601904422203053
4287,1729285998,1729287244,1246,1.369086209125593,4.177173595377266,0.8322908700057986,0.8653021642932693
4288,1729289598,1729293198,3600,0.31928233364707226,3.027345093132375,0.1,0.1
4289,1729293198,1729295251,2053,1.7706945849776705,4.543181254480237,0.4172762145359348,0.7819624745705727
4290,1729296798,1729300398,3600,0.46285901077057423,3.1130336504680396,0.1,0.1
4291,1729300398,1729300863,465,0.7681054006665929,3.6521376073343905,0.6810080296323735,0.32192606905968
4292,1729303998,1729307598,3600,0.20419929597793215,3.104491260572544,0.1,0.1
4293,1729307598,1729311198,3600,0.19772488183290218,3.11533416518498,0.1,0.1
4294,1729311198,1729314165,2967,2.385208070322178,4.482931512679289,0.16009646017942689,0.5922185735351787
4295,1729314798,1729318398,3600,0.438035614771204,3.126746264858475,0.1,0.1
4296,1729318398,1729321998,3600,0.35398510027042474,3.1327593857962035,0.1,0.1
4297,1729321998,1729325598,3600,0.12327188340653145,3.053868687326862,0.1,0.1
4298,1729325598,1729328446,2848,1.6939812464471398,4.436680313873151,0.6857246482883206,0.34218012778907336
4299,1729329198,1729331061,1863,2.240735128241897,4.400341328159016,0.27120737260825933,0.7750344181581516
4300,1729332798,1729333149,351,0.6321110393003848,3.5819552033536173,0.8756899855246169,0.8528235181897735
4301,1729336398,1729339998,3600,0.3125640965258628,3.0329661781331545,0.1,0.1
4302,1729339998,1729343257,3259,1.9813593162394616,4.433806071517804,0.10684149345657157,0.19756732652937753
4303,1729343598,1729344509,911,1.3595954326698447,3.9185009400522564,0.6551119214081044,0.7920428680806633
4304,1729347198,1729350798,3600,0.44204377287889907,3.0906336441248197,0.1,0.1
4305,1729350798,1729351402,604,1.040181895899723,4.111789811377425,0.22011791793619911,0.4032553814786042
4306,1729354398,1729354965,567,0.69151038819524,3.315231508686911,0.2467936751243297,0.6652561897136708
4307,1729357998,1729360111,2113,2.4202861984536046,4.457154740062196,0.9603358023120528,0.3680280739445315
4308,1729361598,1729363225,1627,1.093020498474864,3.906321442954607,0.39389431055971713,0.9391394086232093
4309,1729365198,1729366446,1248,1.3366912243427655,3.850336186415116,0.3373224282624492,0.7552396448928195
4310,1729368798,1729369412,614,1.1138577274810766,3.934633548240941,0.8203915271614682,0.1469620873365761
4311,1729372398,1729375998,3600,0.14341629935557437,3.1981776981111816,0.1,0.1
4312,1729375998,1729379598,3600,0.42599732729799866,3.1223263283347573,0.1,0.1
4313,1729379598,1729383198,3600,0.30454752216376135,3.0811548766688657,0.1,0.1
4314,1729383198,1729386798,3600,0.4030633071273826,3.1532450058622907,0.1,0.1
4315,1729386798,1729390188,3390,2.431963479183917,4.393527018659194,0.791546121385972,0.3477456301009467
4316,1729390398,1729393820,3422,1.6412167896143384,4.509341335159969,0.13806466005008466,0.6760904069892347
4317,1729393998,1729395063,1065,1.0737747579887877,4.0927518408170585,0.7996183568959518,0.3207121835236559
4318,1729397598,1729399774,2176,1.5131425327447325,4.516701737895341,0.11623085285906809,0.21027106559781916
4319,1729401198,1729403646,2448,2.2156596793483136,4.34972063335064,0.11197187262314943,0.9362469516827852
4320,1729404798,1729408243,3445,1.6705573892852332,4.683314479366532,0.8292915528564759,0.6075559904677438
4321,1729408398,1729411998,3600,0.4945723966965203,3.1048955507838722,0.1,0.1
4322,1729411998,1729415598,3600,0.2735880752598193,3.1478656323172367,0.1,0.1
4323,1729415598,1729419198,3600,0.30195947278934354,3.065220040913205,0.1,0.1
4324,1729419198,1729421186,1988,2.2744328306134554,4.559284271950918,0.9300971530936266,0.21919831019978397
4325,1729422798,1729423833,1035,1.4855488086491704,3.9565686651847867,0.8931095331989336,0.4379628325343159
4326,1729426398,1729429998,3600,0.19053627419811683,3.120214033226044,0.1,0.1
4327,1729429998,1729430529,531,0.9064009503334814,3.5630847473658154,0.6575328642676158,0.8990496674633117
4328,1729433598,1729436539,2941,2.134696926568904,4.347683325966962,0.24065398363065213,0.9213677393559156
4329,1729437198,1729438724,1526,1.336568680120434,4.1574942384569615,0.7879111192826368,0.37981565072420553
4330,1729440798,1729444398,3600,0.2695369170623234,3.1111454193345462,0.1,0.1
4331,1729444398,1729447743,3345,2.096929060885028,4.574111044679635,0.6268723266284134,0.5481662974901955
4332,1729447998,1729449929,1931,1.7922820811319076,4.661430590838561,0.2073231081206458,0.6953222787983949
4333,1729451598,1729452394,796,1.3932332503905123,4.173074885674038,0.7611032376344347,0.25688410211326496
4334,1729455198,1729458798,3600,0.4947396702052417,3.049619535594225,0.1,0.1
4335,1729458798,1729462398,3600,0.2921548976349295,3.1003701711787652,0.1,0.1
4336,1729462398,1729464206,1808,1.725998921240612,4.476683205095559,0.8343034411986484,0.2936582072514766
4337,1729465998,1729469598,3600,0.4546343272418316,3.065807149323475,0.1,0.1
4338,1729469598,1729472146,2548,1.554158290388215,4.6124810475556135,0.1615458655606294,0.5157301685690588
4339,1729473198,1729476798,3600,0.10773635073607597,3.013656217124382,0.1,0.1
4340,1729476798,1729480398,3600,0.22763798406462415,3.117419946949117,0.1,0.1
4341,1729480398,1729483998,3600,0.26573522367692537,3.079845985838817,0.1,0.1
4342,1729483998,1729487598,3600,0.3180865518708092,3.067217789701281,0.1,0.1
4343,1729487598,1729489132,1534,1.0143873471738867,4.0374681241558195,0.6039084261590422,0.6366404298835788
4344,1729491198,1729494798,3600,0.15668578208238035,3.0489972664867175,0.1,0.1
4345,1729494798,1729497620,2822,2.330913025926563,4.546967673542528,0.7117804032000155,0.5758631933103625
4346,1729498398,1729501998,3600,0.4620697349602281,3.1760254913472066,0.1,0.1
4347,1729501998,1729505225,3227,1.6285171983148958,4.502545564628586,0.28581706313134814,0.7197854551331689
4348,1729505598,1729509198,3600,0.22764491509512685,3.1919949462729904,0.1,0.1
4349,1729509198,1729510123,925,1.3057229932100445,4.1589608847059525,0.639356332207165,0.9284468728872888
4350,1729512798,1729513211,413,0.7487334149196749,3.65150913589829,0.42197062629122095,0.7701523502625612
4351,1729516398,1729519998,3600,0.3132717914408538,3.1583868380442333,0.1,0.1
4352,1729519998,1729521420,1422,1.3378406207123537,3.8876001169157366,0.1640813621853316,0.4305551156473143
4353,1729523598,1729525514,1916,1.5106384345537618,4.450391386355484,0.46178820777420904,0.38326517483636313
4354,1729527198,1729530798,3600,0.4481101368465159,3.0059478512279556,0.1,0.1
4355,1729530798,1729533346,2548,1.859346874761132,4.46117810052517,0.7506837238183359,0.8931961424380624
4356,1729534398,1729536622,2224,2.1939653051361505,4.6814800229048545,0.7815839409259533,0.15152451950398627
4357,1729537998,1729541598,3600,0.28390980621406664,3.086891336814882,0.1,0.1
4358,1729541598,1729542723,1125,1.4861525292137674,3.9397091152862176,0.4993053608761002,0.5822832421672566
4359,1729545198,1729547960,2762,2.438793430822516,4.498655944370103,0.5875202419984042,0.3437530718062739
4360,1729548798,1729551397,2599,1.8572006600068915,4.66913477963159,0.4750599962900264,0.14958149720759809
4361,1729552398,1729555005,2607,2.476206883217931,4.548554237595776,0.7519225657681761,0.17150198456333587
4362,1729555998,1729556597,599,0.5088642068694794,3.6712135123438685,0.6495411215249548,0.42739399531618616
4363,1729559598,1729563198,3600,0.4065942141932034,3.0322190989210753,0.1,0.1
4364,1729563198,1729566798,3600,0.18338387638963957,3.116608518653819,0.1,0.1
4365,1729566798,1729569393,2595,2.4609223125618374,4.550567012026823,0.48043711310266624,0.9962009204645476
4366,1729570398,1729573998,3600,0.10228585684554906,3.154527612998243,0.1,0.1
4367,1729573998,1729576292,2294,2.334738990218179,4.424111110580041,0.29735931515792174,0.5497441836091156
4368,1729577598,1729581198,3600,0.46075369123635856,3.0747823103947938,0.1,0.1
4369,1729581198,1729584798,3600,0.12553228295615979,3.002282577454368,0.1,0.1
4370,1729584798,1729588398,3600,0.4321230431709895,3.1514830557441935,0.1,0.1
4371,1729588398,1729589581,1183,1.4809650986214462,4.09249240384029,0.3950864945898579,0.717901865741749
4372,1729591998,1729595598,3600,0.11396494185293995,3.126464413909889,0.1,0.1
4373,1729595598,1729599027,3429,1.6641814285858165,4.4741321092035955,0.23209031030899316,0.18308863609537962
4374,1729599198,1729600076,878,1.4335063869870988,3.9345897736334283,0.15949835190950903,0.36395737066319644
4375,1729602798,1729606398,3600,0.1943290679360354,3.011179832945194,0.1,0.1
4376,1729606398,1729609998,3600,0.39326855304022323,3.014784685259843,0.1,0.1
4377,1729609998,1729613598,3600,0.45556775147384265,3.1812819656913245,0.1,0.1
4378,1729613598,1729614807,1209,1.374685713534668,3.9664316019554864,0.8311730280111335,0.774950808699232
4379,1729617198,1729619913,2715,1.9428442511803932,4.386129736025574,0.32533221598656803,0.6507042585070518
4380,1729620798,1729624398,3600,0.48429671532036866,3.1200880919961604,0.1,0.1
4381,1729624398,1729627998,3600,0.2877223900938655,3.1643863148966203,0.1,0.1
4382,1729627998,1729631598,3600,0.45801739832909283,3.1038910289504997,0.1,0.1
4383,1729631598,1729632778,1180,1.2780034915446787,3.8830519575562326,0.17214680992004816,0.8022200211142799
4384,1729635198,1729636816,1618,1.0891354243995008,3.894957270482162,0.3668701293681399,0.460116365093581
4385,1729638798,1729642398,3600,0.3658833008961666,3.061387298677375,0.1,0.1
4386,1729642398,1729643413,1015,1.245918362760852,4.04666416809777,0.686653014222733,0.8605466325163076
4387,1729645998,1729647449,1451,1.0205710945300235,3.983898074898161,0.7551858517960574,0.9183722987548014
4388,1729649598,1729653198,3600,0.4367149731565977,3.1145121083119918,0.1,0.1
4389,1729653198,1729656798,3600,0.3776762390041206,3.0910169167714834,0.1,0.1
4390,1729656798,1729656922,124,0.9744880578266919,3.3462185482152447,0.9946825143064513,0.2695913894231494
4391,1729660398,1729663998,3600,0.41830353881129156,3.178844459877844,0.1,0.1
4392,1729663998,1729665765,1767,1.136866842565988,4.164597028315398,0.4631436580082029,0.505201693612191
4393,1729667598,1729671198,3600,0.40760567957393434,3.137007798473943,0.1,0.1
4394,1729671198,1729674798,3600,0.4729569991602255,3.1313511017904783,0.1,0.1
4395,1729674798,1729678398,3600,0.44952000860129815,3.065206050477118,0.1,0.1
4396,1729678398,1729679299,901,1.2906463044003433,4.0883119515719155,0.36118894907774857,0.7718672206470627
4397,1729681998,1729683381,1383,1.1799645194219175,4.089013796452531,0.726483782383148,0.5080763350676365
4398,1729685598,1729689198,3600,0.151980515176819,3.08744850480398,0.1,0.1
4399,1729689198,1729691733,2535,1.7596747985569676,4.533088444376833,0.13284816705829297,0.32597323896180025
4400,1729692798,1729693484,686,1.0615265221368309,4.058616809699575,0.5302991532847319,0.652540314283373
4401,1729696398,1729699998,3600,0.16542041315599065,3.032867564878638,0.1,0.1
4402,1729699998,1729701493,1495,1.4413383985962183,3.867531177147446,0.832550035891776,0.4627129601123564
4403,1729703598,1729707198,3600,0.4452910345941131,3.0850289103527064,0.1,0.1
4404,1729707198,1729710798,3600,0.4358954052649915,3.196137654882105,0.1,0.1
4405,1729710798,1729714398,3600,0.3983178567939166,3.1700127315560223,0.1,0.1
4406,1729714398,1729716665,2267,1.7451406230405069,4.62647280883163,0.7977277279167992,0.2204717514109527
4407,1729717998,1729721598,3600,0.24971314589739535,3.0490387138183492,0.1,0.1
4408,1729721598,1729725198,3600,0.3071453310909713,3.192226013348457,0.1,0.1
4409,1729725198,1729728798,3600,0.41311416088996356,3.0543285615653475,0.1,0.1
4410,1729728798,1729732398,3600,0.2100674703786891,3.0788518798660878,0.1,0.1
4411,1729732398,1729733263,865,1.3301120536171618,4.028848468752592,0.9315984806512952,0.892392064692745
4412,1729735998,1729738012,2014,1.692376425206111,4.4124367198977845,0.5215849348150304,0.1472754784837337
4413,1729739598,1729743198,3600,0.1645465020068439,3.020672680598399,0.1,0.1
4414,1729743198,1729746585,3387,2.328519559824101,4.3162785578557274,0.8813235928331429,0.45891612190837516
4415,1729746798,1729749020,2222,1.7303448887344508,4.652907514076901,0.12775489915588092,0.6913574395008184
4416,1729750398,1729751448,1050,1.1662808664607374,3.855962734838769,0.14420582684259992,0.7213643935317534
4417,1729753998,1729755494,1496,1.3788856010121768,3.8088675683165465,0.4199591282668408,0.40412313926499976
4418,1729757598,1729758269,671,1.3224485226514828,3.8400790774437854,0.992645830790971,0.9214596198323003
4419,1729761198,1729764798,3600,0.21790256115618947,3.0349998259634505,0.1,0.1
4420,1729764798,1729768398,3600,0.3193630585590441,3.0773053199214897,0.1,0.1
4421,1729768398,1729771998,3600,0.3123580771852065,3.0751296277980824,0.1,0.1
4422,1729771998,1729772187,189,0.5868641942861159,3.620488848123842,0.6854881893437801,0.26719180772464535
4423,1729775598,1729779198,3600,0.4039972370124043,3.1175197996030577,0.1,0.1
4424,1729779198,1729782798,3600,0.1718834355223257,3.151980239629137,0.1,0.1
4425,1729782798,1729786398,3600,0.16103139020868606,3.0938021316890785,0.1,0.1
4426,1729786398,1729789998,3600,0.45017916559593785,3.0288448991481283,0.1,0.1
4427,1729789998,1729791902,1904,1.6516041932294698,4.561990337286975,0.6947330749649744,0.574985323160924
4428,1729793598,1729796250,2652,1.7469202185449377,4.365989902761029,0.6119218833372091,0.6854112778137686
4429,1729797198,1729800798,3600,0.4622873950020211,3.0669758345685727,0.1,0.1
4430,1729800798,1729803478,2680,2.1830279322382586,4.419643589703287,0.18519826905467895,0.269946089805728
4431,1729804398,1729806196,1798,1.3114941731429968,3.9395917537252068,0.15017521206446346,0.8640753545663836
4432,1729807998,1729811598,3600,0.401809422661911,3.130808549058838,0.1,0.1
4433,1729811598,1729815198,3600,0.14192622000832797,3.0090587319641364,0.1,0.1
4434,1729815198,1729816077,879,1.4414946193062046,3.8425269057397946,0.8545580495409507,0.5079217582101991
4435,1729818798,1729822398,3600,0.30416453367221263,3.087501186046096,0.1,0.1
4436,1729822398,1729825259,2861,1.928642882324557,4.596473398136747,0.19488301916168815,0.7161590911953064
4437,1729825998,1729826750,752,1.4812830029310622,3.8384069918404506,0.7050123062135513,0.7079734220605316
4438,1729829598,1729833198,3600,0.40337117186615024,3.1686503633615444,0.1,0.1
4439,1729833198,1729836645,3447,1.7446411717473072,4.424142375298586,0.16879411044907844,0.8381365200465878
4440,1729836798,1729838524,1726,1.4913379881109847,4.018285573433094,0.3994415925512239,0.3178002956783462
4441,1729840398,1729842068,1670,1.0169090866321697,4.087674784866178,0.8177221017751762,0.15674603804545656
4442,1729843998,1729847598,3600,0.37242603948911124,3.029224734821647,0.1,0.1
4443,1729847598,1729849578,1980,2.2894626967266856,4.3488654577064105,0.4593319412633956,0.23174147504772222
4444,1729851198,1729854798,3600,0.10786364571677379,3.1022586903979734,0.1,0.1
4445,1729854798,1729858398,3600,0.15762330419498738,3.131248221392274,0.1,0.1
4446,1729858398,1729859252,854,1.0752855154070189,3.8532449069050037,0.13878791120274367,0.5534602063033487
4447,1729861998,1729865598,3600,0.10839898959819272,3.05751687998438,0.1,0.1
4448,1729865598,1729868526,2928,2.055134425039956,4.349105939474923,0.9920083260254156,0.28924254993906917
4449,1729869198,1729870324,1126,1.0101059281800533,4.153590924039277,0.17051221295899754,0.21798161251538906
4450,1729872798,1729876398,3600,0.12632063885916867,3.109150650009969,0.1,0.1
4451,1729876398,1729878592,2194,1.6748011891171954,4.520725287810448,0.8673815892463762,0.4730992443028508
4452,1729879998,1729881458,1460,1.127852287517956,3.9143916251023496,0.2878971663818771,0.5778628021049089
4453,1729883598,1729885417,1819,1.5406901728345597,4.625542535343774,0.6934074754159689,0.18388733015149966
4454,1729887198,1729890665,3467,1.8237390259343629,4.537342980389416,0.35005888771547045,0.5906081980595377
4455,1729890798,1729892712,1914,1.7206388237155164,4.432644454931014,0.4711923354039671,0.7758706906839851
4456,1729894398,1729897998,3600,0.11676666249012918,3.100836186075728,0.1,0.1
4457,1729897998,1729901598,3600,0.43921273506054825,3.119287458338023,0.1,0.1
4458,1729901598,1729905198,3600,0.13272310696486664,3.011241691102221,0.1,0.1
4459,1729905198,1729906256,1058,1.1291760631975483,4.015569922698893,0.9010496217921659,0.6610022514512865
4460,1729908798,1729912398,3600,0.24135460004163908,3.015058420645465,0.1,0.1
4461,1729912398,1729915998,3600,0.2699805761799768,3.1995749326938925,0.1,0.1
4462,1729915998,1729916473,475,0.8246862919673701,3.6023020807113806,0.7544873168116366,0.9326135057956232
4463,1729919598,1729923198,3600,0.226853318382633,3.0342609829799327,0.1,0.1
4464,1729923198,1729926798,3600,0.3418933229993682,3.1907649899436494,0.1,0.1
4465,1729926798,1729930398,3600,0.16580453532170072,3.066734172755267,0.1,0.1
4466,1729930398,1729931162,764,1.1725654176246145,3.9143974270422426,0.7990601602297386,0.9641179047323089
4467,1729933998,1729936336,2338,2.1417404743300494,4.654447491131423,0.7252447450961014,0.3858234180718204
4468,1729937598,1729938717,1119,1.138785667126874,4.061602333137099,0.4725634136793835,0.6064958818829664
4469,1729941198,1729944798,3600,0.2941222947515596,3.1278381451578388,0.1,0.1
4470,1729944798,1729947239,2441,2.4988672478320657,4.490040505614237,0.7447912745081939,0.5707638869453164
4471,1729948398,1729949629,1231,1.0482357195726075,3.95933735649262,0.11345560276258707,0.9968527746841725
4472,1729951998,1729955072,3074,1.6541806870239877,4.666747689320428,0.9397049663191493,0.7494884078622778
4473,1729955598,1729958334,2736,2.038527182373715,4.578166026235194,0.6193501185821443,0.43200222766686747
4474,1729959198,1729962686,3488,2.002799011091884,4.423457196648613,0.3122397464507158,0.8082806724400173
4475,1729962798,1729964988,2190,1.6106526959814529,4.585466079031019,0.7000190853432467,0.7914020692250006
4476,1729966398,1729969998,3600,0.10367905304159769,3.1881025492282307,0.1,0.1
4477,1729969998,1729973598,3600,0.1888869017806236,3.1212630388030687,0.1,0.1
4478,1729973598,1729977198,3600,0.40804446328855737,3.057181420250841,0.1,0.1
4479,1729977198,1729980798,3600,0.2740486691907953,3.190986709388785,0.1,0.1
4480,1729980798,1729984398,3600,0.23555631872075905,3.072920539440685,0.1,0.1
4481,1729984398,1729985293,895,1.1216900134346222,3.9501828273153796,0.8927300488868775,0.8798331468917752
4482,1729987998,1729990998,3000,2.325191256144536,4.551637442967177,0.5193789822268892,0.4330963404479867
4483,1729991598,1729995198,3600,0.3526310249776522,3.0865080274829806,0.1,0.1
4484,1729995198,1729998539,3341,1.846343253772231,4.356140031881122,0.6053998178887772,0.7002541463873891
4485,1729998798,1730002398,3600,0.3684631314589897,3.0080094291559143,0.1,0.1
4486,1730002398,1730005330,2932,1.5845043029180215,4.48582774634883,0.8138137565736883,0.8555002931807996
4487,1730005998,1730009598,3600,0.16366374964870972,3.004467466351992,0.1,0.1
4488,1730009598,1730010075,477,0.9616483371651532,3.47491914974126,0.9790453524916138,0.16544232301107115
4489,1730013198,1730016286,3088,1.6011979253810127,4.384095170546449,0.9714361214744642,0.5539888765765696
4490,1730016798,1730019216,2418,1.5893258735555178,4.315802148655509,0.328339998232543,0.39509179445001563
4491,1730020398,1730022924,2526,2.4020673383862348,4.316205329198665,0.1983677989393587,0.46742589924431865
4492,1730023998,1730027598,3600,0.13292013416717774,3.1330166147856335,0.1,0.1
4493,1730027598,1730030581,2983,2.1319277683457583,4.4209296140719845,0.7695580318321119,0.5568583168354589
4494,1730031198,1730031430,232,0.780540092402513,3.3439732794022436,0.593713409315928,0.528722563965076
4495,1730034798,1730038398,3600,0.16053949736101558,3.039299129149869,0.1,0.1
4496,1730038398,1730038692,294,0.7845232645061346,3.4013078455789834,0.5680948047498419,0.5506771647267663
4497,1730041998,1730042182,184,0.5553458909195703,3.640648953702978,0.8373318813814815,0.6029458183721452
4498,1730045598,1730049198,3600,0.1289094259074294,3.0714528123723808,0.1,0.1
4499,1730049198,1730050026,828,1.0035970857922318,3.9806386057622962,0.28095985832085635,0.8463844472373123
4500,1730052798,1730054540,1742,1.1085121991053712,3.8572103438320626,0.3433359686687816,0.7665513001905057
4501,1730056398,1730056694,296,0.8395876473445764,3.4851172345701835,0.792251997557434,0.589218179815828
4502,1730059998,1730060742,744,1.0648716632018178,3.936002753288643,0.5044291886991074,0.4654559878187221
4503,1730063598,1730066168,2570,2.1015810663011427,4.325217993465057,0.6552955057881751,0.6220124991347533
4504,1730067198,1730070798,3600,0.25294288757354494,3.1770765025800602,0.1,0.1
4505,1730070798,1730074398,3600,0.41232198718293667,3.1305692613199056,0.1,0.1
4506,1730074398,1730075599,1201,1.0109460235652472,4.001460449587789,0.264337661098447,0.3824462502464816
4507,1730077998,1730081598,3600,0.46661884824238875,3.0867286904222833,0.1,0.1
4508,1730081598,1730084776,3178,1.7098474567868756,4.383219443762009,0.2730285270398102,0.4108132793231606
4509,1730085198,1730086241,1043,1.3953079680442695,3.8965207131812827,0.3976660766496173,0.1283191086374453
4510,1730088798,1730091548,2750,1.712681397907578,4.3757668924206525,0.6372181128498033,0.5614150510018676
4511,1730092398,1730095837,3439,2.118990579644941,4.350370938796253,0.18528080184396944,0.46356564507023224
4512,1730095998,1730098642,2644,1.998175192019552,4.583268288670514,0.7456961154243377,0.8331157195726027
4513,1730099598,1730103198,3600,0.24330885657324017,3.1248418412971213,0.1,0.1
4514,1730103198,1730106798,3600,0.1457427639638593,3.0883859396487345,0.1,0.1
4515,1730106798,1730108458,1660,1.4928576946474268,4.032350096243321,0.7335465202226199,0.3030591635773192
4516,1730110398,1730112417,2019,2.27953000756466,4.601555932586937,0.8605259393232069,0.9993516606878183
4517,1730113998,1730117598,3600,0.20109075430237722,3.0763014196802527,0.1,0.1
4518,1730117598,1730119892,2294,2.2137777557899736,4.31319415003283,0.5749351686043819,0.9671736449507317
4519,1730121198,1730123523,2325,1.6908159616247265,4.619961006765361,0.9827716721287444,0.365530199956391
4520,1730124798,1730126062,1264,1.4547131031933245,4.197304408804951,0.6639501027361827,0.6219150598488911
4521,1730128398,1730131585,3187,2.321367566601095,4.3444680492169345,0.9111297049341793,0.6037389595291629
4522,1730131998,1730135598,3600,0.4587495533641809,3.1396971660053623,0.1,0.1
4523,1730135598,1730136239,641,1.030027862618493,3.9379153246687806,0.3931762959498376,0.7103296360967281
4524,1730139198,1730140804,1606,1.1288351499148843,4.132017893435824,0.45799241217844644,0.8895657469710343
4525,1730142798,1730145879,3081,1.5778855728683148,4.34439883803129,0.7340668675193895,0.9291259961636881
4526,1730146398,1730147605,1207,1.4495167999415228,4.041197567016855,0.47970948165494576,0.8187138045880096
4527,1730149998,1730153598,3600,0.14832562673455119,3.189177344556921,0.1,0.1
4528,1730153598,1730157198,3600,0.448455606475501,3.07381015159091,0.1,0.1
4529,1730157198,1730160798,3600,0.3724132607160906,3.055583715400293,0.1,0.1
4530,1730160798,1730163238,2440,2.4368748390100485,4.413620530709305,0.30547101585841274,0.30127804378908873
4531,1730164398,1730167998,3600,0.25233155369010163,3.08011567133914,0.1,0.1
4532,1730167998,1730171598,3600,0.15992232510694968,3.1219022542388295,0.1,0.1
4533,1730171598,1730175198,3600,0.1772540080457513,3.0903993229548927,0.1,0.1
4534,1730175198,1730178798,3600,0.24326973328233492,3.011915206303419,0.1,0.1
4535,1730178798,1730182398,3600,0.21703784606723242,3.13430065505728,0.1,0.1
4536,1730182398,1730185551,3153,1.5327133523731113,4.370738922632907,0.3864129216515634,0.4967976793008029
4537,1730185998,1730189598,3600,0.16923841163557546,3.1102945043677006,0.1,0.1
4538,1730189598,1730190750,1152,1.4241493594947876,4.076695480359146,0.9297633124856897,0.19738360515392636
4539,1730193198,1730196798,3600,0.36313859307543106,3.1342676363474653,0.1,0.1
4540,1730196798,1730200398,3600,0.4359978701673224,3.1294380273374363,0.1,0.1
4541,1730200398,1730200985,587,0.7568217626277426,3.5614444036824677,0.18627103979020307,0.5556920203238256
4542,1730203998,1730205916,1918,2.241341296297211,4.571384798060643,0.8087472866707236,0.12909063332023268
4543,1730207598,1730209732,2134,2.2799481777387913,4.696328613371847,0.45011725336046304,0.3552934445792285
4544,1730211198,1730213705,2507,2.1922207698073195,4.676824191182787,0.4522754467444926,0.8171172408456387
4545,1730214798,1730218398,3600,0.32916108290522694,3.103377297022459,0.1,0.1
4546,1730218398,1730220828,2430,1.5639695630484463,4.534072922315029,0.278058859588302,0.7250220751751814
4547,1730221998,1730222462,464,0.6619590505255177,3.4426809817762845,0.4627610692831535,0.47461908990692403
4548,1730225598,1730226507,909,1.1280760433094696,3.9635460196700194,0.5555877536599289,0.2556737549893232
4549,1730229198,1730232798,3600,0.38415788938113504,3.145857858680636,0.1,0.1
4550,1730232798,1730234929,2131,1.6150766902957425,4.4385220383496025,0.8895946796943972,0.8024708876805704
4551,1730236398,1730238315,1917,1.8498311597968269,4.50247451523576,0.4068662036929628,0.4160745451268645
4552,1730239998,1730243598,3600,0.3536176839132936,3.1587848060228385,0.1,0.1
4553,1730243598,1730244514,916,1.2847526985996447,3.9148637172955354,0.6921412591889551,0.22194690216834406
4554,1730247198,1730250798,3600,0.23795006414608388,3.083965537351738,0.1,0.1
4555,1730250798,1730253743,2945,2.458937905543257,4.532844780667989,0.21535112641836107,0.4204847610857261
4556,1730254398,1730256953,2555,1.578578265032867,4.41848186525652,0.5997575739856789,0.7832531392217061
4557,1730257998,1730260385,2387,1.5273987570271976,4.379847582379255,0.43286510814831625,0.30538611738514154
4558,1730261598,1730264195,2597,1.522113069581366,4.304399968398463,0.360059486291179,0.24837188146306174
4559,1730265198,1730268798,3600,0.23667919957058944,3.0111602969326867,0.1,0.1
4560,1730268798,1730269028,230,0.8047828635155334,3.4821793701600185,0.7563400888691612,0.9070370076966617
4561,1730272398,1730274237,1839,1.5125299258754423,4.569366055369038,0.9122486131284886,0.9387878143726224
4562,1730275998,1730279332,3334,2.239942310525738,4.640896746518541,0.7753044823497496,0.40900511978196363
4563,1730279598,1730281582,1984,1.7837129241031509,4.548071138554435,0.8841084534570608,0.8511216709647776
4564,1730283198,1730286621,3423,1.552172391197637,4.496023583821775,0.7394961247474464,0.3880755540502667
4565,1730286798,1730289958,3160,2.297501050343749,4.379429087100341,0.3609298518116195,0.33145840380895203
4566,1730290398,1730291226,828,1.0179110217158995,3.938574847829268,0.4925766955067591,0.3185919030162406
4567,1730293998,1730297598,3600,0.26199506748223955,3.028719325413025,0.1,0.1
4568,1730297598,1730298944,1346,1.0085853987282003,3.936825897988514,0.7220313597486577,0.4042656156662354
4569,1730301198,1730304798,3600,0.35870434189424005,3.112678812906583,0.1,0.1
4570,1730304798,1730305802,1004,1.0526492681138622,3.9162623206356426,0.15330094535549377,0.4459292147841172
4571,1730308398,1730310761,2363,1.955787112326045,4.394522251996606,0.2216636649341529,0.6468241063259609
4572,1730311998,1730315598,3600,0.4395462065640474,3.002834943621506,0.1,0.1
4573,1730315598,1730319198,3600,0.3368063834960795,3.0654188862974747,0.1,0.1
4574,1730319198,1730320619,1421,1.26609162787475,3.9940209450530717,0.3782079543181055,0.11158926399950125
4575,1730322798,1730325793,2995,1.874185386600848,4.319762360930619,0.4405130751214986,0.8338262503829564
4576,1730326398,1730327913,1515,1.0772307502022236,4.164621925952059,0.9030978598142008,0.15772967922270478
4577,1730329998,1730333598,3600,0.19291768113657817,3.1968627688226867,0.1,0.1
4578,1730333598,1730335400,1802,1.9024065417978666,4.305180951038151,0.2295507364771035,0.3155709924285578
4579,1730337198,1730340798,3600,0.43410990567743857,3.0576882908756744,0.1,0.1
4580,1730340798,1730342153,1355,1.4030670085542947,3.9919190550102113,0.8730918331776997,0.859883946699448
4581,1730344398,1730347998,3600,0.19287203127518857,3.0658723500309506,0.1,0.1
4582,1730347998,1730350005,2007,2.083041236910119,4.312727576980475,0.48275703876418796,0.8258609695725831
4583,1730351598,1730352062,464,0.8244373525507729,3.336858555989908,0.6885952451091647,0.7581435183669935
4584,1730355198,1730355863,665,1.1081246895448302,3.833260080986536,0.7218790015072644,0.26702353135693346
4585,1730358798,1730359949,1151,1.0117473633703815,4.133438691827329,0.2853463606307086,0.2941836447741995
4586,1730362398,1730365998,3600,0.3090607682605498,3.0557877442504426,0.1,0.1
4587,1730365998,1730366361,363,0.8765058290949395,3.5827916689283583,0.8139867734368994,0.7326971915581995
4588,1730369598,1730373198,3600,0.29290863567333797,3.139830099260316,0.1,0.1
4589,1730373198,1730374025,827,1.2357578028353147,3.9942095287364134,0.9369627654999905,0.5546868432206831
4590,1730376798,1730380398,3600,0.2651315026625619,3.004801268724087,0.1,0.1
4591,1730380398,1730383998,3600,0.2764994568682505,3.1700696533397603,0.1,0.1
4592,1730383998,1730387255,3257,1.8198205685605873,4.324435946075457,0.30970083480535027,0.8272266948298045
4593,1730387598,1730391198,3600,0.46715855989807087,3.156244057642863,0.1,0.1
4594,1730391198,1730394798,3600,0.38151709750856166,3.12602607106472,0.1,0.1
4595,1730394798,1730396644,1846,2.422945662056523,4.389214246889815,0.2919891344340056,0.1214914704968373
4596,1730398398,1730401998,3600,0.13641293622825607,3.036553548135417,0.1,0.1
4597,1730401998,1730402586,588,0.8047225069254502,3.473733940916601,0.7997437724987371,0.762040300747328
4598,1730405598,1730409198,3600,0.13259743613691582,3.013192507646033,0.1,0.1
4599,1730409198,1730412798,3600,0.37256411684246515,3.135155158702786,0.1,0.1
4600,1730412798,1730414577,1779,1.0870426207658377,3.9873949181565687,0.23823434998345705,0.7551610317833024
4601,1730416398,1730419888,3490,2.0037840928757875,4.532064539773469,0.2884754282058356,0.8689712769161492
4602,1730419998,1730423598,3600,0.20878764204293235,3.0135375767509793,0.1,0.1
4603,1730423598,1730426277,2679,1.7873656070099793,4.487797428501422,0.6737633103313967,0.5393205940172079
4604,1730427198,1730430798,3600,0.46611594429792624,3.044667129007783,0.1,0.1
4605,1730430798,1730434398,3600,0.22706245702806385,3.1376685076349187,0.1,0.1
4606,1730434398,1730437998,3600,0.31125318768925936,3.1662496469750225,0.1,0.1
4607,1730437998,1730441598,3600,0.10337954904005793,3.0330915023186047,0.1,0.1
4608,1730441598,1730444363,2765,1.7244299091986248,4.431260186667916,0.872318460763279,0.9722418505568342
4609,1730445198,1730448798,3600,0.35273191627253564,3.101658881852656,0.1,0.1
4610,1730448798,1730451124,2326,1.6662358377118758,4.634564269701768,0.8689535764523642,0.7245539628267522
4611,1730452398,1730454493,2095,1.5609782327666228,4.506979748002383,0.8850996362284952,0.6544619486192406
4612,1730455998,1730459598,3600,0.48629783294702866,3.087062033616975,0.1,0.1
4613,1730459598,1730461547,1949,1.6005423949054465,4.606677816878274,0.7731148406737475,0.7110777611248079
4614,1730463198,1730466798,3600,0.4159253704162039,3.1258907985570685,0.1,0.1
4615,1730466798,1730468710,1912,2.0456995209738476,4.38796299113095,0.2820973461805889,0.9069679869297173
4616,1730470398,1730472874,2476,1.5564457737440232,4.390898791861233,0.3479330265439955,0.6558659696954068
4617,1730473998,1730477598,3600,0.11396193638977303,3.129609377256405,0.1,0.1
4618,1730477598,1730481198,3600,0.3027110970275829,3.1969686124646275,0.1,0.1
4619,1730481198,1730484798,3600,0.3058168375612343,3.12434228796981,0.1,0.1
4620,1730484798,1730485077,279,0.9876664815859382,3.5811907559501406,0.5229455245819502,0.637210439333751
4621,1730488398,1730491998,3600,0.18571985353763784,3.1479318325952086,0.1,0.1
4622,1730491998,1730492476,478,0.7321262259094792,3.4012160196370025,0.9878087621561178,0.27098594685175104
4623,1730495598,1730498917,3319,2.147703199464014,4.383121171318579,0.13782660756406556,0.1684673090962262
4624,1730499198,1730502798,3600,0.2890016245403556,3.1031610925884383,0.1,0.1
4625,1730502798,1730504640,1842,1.759595659973344,4.401867491672512,0.7381084325139644,0.730637758501714
4626,1730506398,1730508266,1868,1.9628968290022812,4.351686517343056,0.543622354727605,0.5270219627448348
4627,1730509998,1730511177,1179,1.3966096724191441,4.1001438611848116,0.30315757052595216,0.11725595233532204
4628,1730513598,1730516124,2526,2.322645090949175,4.341408947534818,0.8447290113967657,0.5338162991352124
4629,1730517198,1730518772,1574,1.4291449698459477,4.041704357323009,0.6956821048605093,0.38901577671728726
4630,1730520798,1730523100,2302,1.9558188234699725,4.641010271072654,0.7010229351224796,0.9091489532301715
4631,1730524398,1730525409,1011,1.0747653315815924,4.09790503615003,0.8576237101833623,0.2878764455433617
4632,1730527998,1730531598,3600,0.33147036942218655,3.0763331319899945,0.1,0.1
4633,1730531598,1730532919,1321,1.3054300165599955,4.1891935580326045,0.4842659548060757,0.3197946650647472
4634,1730535198,1730536549,1351,1.1621563121263965,3.8158157263633057,0.9832556354655569,0.7528645990547649
4635,1730538798,1730542256,3458,1.6627595503553678,4.546294282315654,0.5421259043886907,0.4239445852937259
4636,1730542398,1730543059,661,1.168608491727264,3.8941042877749394,0.6320011261136409,0.7136074530334786
4637,1730545998,1730549598,3600,0.3687933038685146,3.149816815258117,0.1,0.1
4638,1730549598,1730550959,1361,1.0344335355393879,3.8779259556343604,0.45736753346011216,0.7181968223856134
4639,1730553198,1730556798,3600,0.48239042729290826,3.0771444870072098,0.1,0.1
4640,1730556798,1730560398,3600,0.3172667201262958,3.1711647192436816,0.1,0.1
4641,1730560398,1730563998,3600,0.4616417862299814,3.1581846948901324,0.1,0.1
4642,1730563998,1730567598,3600,0.1521447757754497,3.09524533188769,0.1,0.1
4643,1730567598,1730571198,3600,0.3896765517678996,3.1191126050788283,0.1,0.1
4644,1730571198,1730574798,3600,0.19461020456367045,3.174281798456011,0.1,0.1
4645,1730574798,1730578398,3600,0.3489442297219273,3.1306404505132837,0.1,0.1
4646,1730578398,1730581989,3591,1.811762607144865,4.444755245033548,0.32794307819937496,0.5604008730785177
4647,1730581998,1730585598,3600,0.4507044374348822,3.193730022759602,0.1,0.1
4648,1730585598,1730589198,3600,0.3406536036791521,3.1814183078353895,0.1,0.1
4649,1730589198,1730592798,3600,0.1701158446889412,3.0173140391210835,0.1,0.1
4650,1730592798,1730596398,3600,0.33168429712833103,3.058027228124923,0.1,0.1
4651,1730596398,1730596912,514,0.5115274687213425,3.341918375850496,0.8172313408030173,0.3878717801971714
4652,1730599998,1730603598,3600,0.37355889392043495,3.1977066040331623,0.1,0.1
4653,1730603598,1730606185,2587,1.836062502241075,4.684319599440698,0.5514419574106391,0.570714916675891
4654,1730607198,1730610798,3600,0.35359801133976165,3.115572712821836,0.1,0.1
4655,1730610798,1730614398,3600,0.48064415697547636,3.0990695725117954,0.1,0.1
4656,1730614398,1730617998,3600,0.21550548550139698,3.196125878218527,0.1,0.1
4657,1730617998,1730621458,3460,2.112886195402076,4.6184525374796825,0.6392579019978865,0.7530948872142718
4658,1730621598,1730623963,2365,1.7019906792676367,4.416592796392187,0.6975642231813475,0.2488778171080827
4659,1730625198,1730626398,1200,1.2132444963442177,3.8774367537476415,0.8558997705558643,0.5400034597321436
4660,1730628798,1730632398,3600,0.2075779374700989,3.0952781430734557,0.1,0.1
4661,1730632398,1730635998,3600,0.28950627994727807,3.046742927345257,0.1,0.1
4662,1730635998,1730636255,257,0.7443552272898906,3.5663706066887877,0.5645453108743964,0.20825217152148645
4663,1730639598,1730643198,3600,0.11882108105636942,3.1035434727282443,0.1,0.1
4664,1730643198,1730646798,3600,0.18903357800544685,3.088632178011911,0.1,0.1
4665,1730646798,1730647622,824,1.1202071651267325,3.86565458770033,0.6142781063897241,0.10647973233449692
4666,1730650398,1730652225,1827,2.2907857918833723,4.375307461802421,0.22112220494379387,0.37771592830102996
4667,1730653998,1730657598,3600,0.28396836498067757,3.0162230801601524,0.1,0.1
4668,1730657598,1730659502,1904,2.4563157916611216,4.699537620640645,0.6022060011774527,0.8195574342213434
4669,1730661198,1730664798,3600,0.14764158504841118,3.0110515431578526,0.1,0.1
4670,1730664798,1730668398,3600,0.3896158289356201,3.1197797611107188,0.1,0.1
4671,1730668398,1730671998,3600,0.4502832180047215,3.173428775925859,0.1,0.1
4672,1730671998,1730675598,3600,0.35178872953458673,3.0346839057273116,0.1,0.1
4673,1730675598,1730679198,3600,0.23742277870107908,3.1280329983440915,0.1,0.1
4674,1730679198,1730682798,3600,0.3919572919045241,3.08139186372503,0.1,0.1
4675,1730682798,1730686398,3600,0.22693027744232214,3.0942620403403582,0.1,0.1
4676,1730686398,1730689998,3600,0.15856963835811047,3.188087607888594,0.1,0.1
4677,1730689998,1730693598,3600,0.3897155347698623,3.040491867458233,0.1,0.1
4678,1730693598,1730697198,3600,0.3903629858091323,3.1743524724570373,0.1,0.1
4679,1730697198,1730700798,3600,0.2508185153559135,3.088349759141559,0.1,0.1
4680,1730700798,1730701641,843,1.4985943929633174,4.102563515409018,0.913343370809291,0.3927770684883314
4681,1730704398,1730707998,3600,0.23808038042677568,3.038159690278877,0.1,0.1
4682,1730707998,1730711561,3563,2.331990409401641,4.605866927927837,0.5392131867725288,0.2299958935148624
4683,1730711598,1730715198,3600,0.13831172444550055,3.0365339392129482,0.1,0.1
4684,1730715198,1730717943,2745,1.7989619312824683,4.60888363202128,0.8291688810327704,0.2183166251056205
4685,1730718798,1730722002,3204,2.250473185924503,4.482131740291554,0.8280527009637567,0.6739136865394104
4686,1730722398,1730722557,159,0.8232272849562536,3.594003357105393,0.16109805148874587,0.4999420948196328
4687,1730725998,1730729598,3600,0.4608511410417232,3.012049602797979,0.1,0.1
4688,1730729598,1730733198,3600,0.3077126278715333,3.0173585902494233,0.1,0.1
4689,1730733198,1730735152,1954,1.5494067892204078,4.4830252784886815,0.1322388324047768,0.41079079086567294
4690,1730736798,1730737214,416,0.8916027405837954,3.4491344064508214,0.9236908141015846,0.8316359177306495
4691,1730740398,1730741086,688,1.4073176878695393,3.927707132696573,0.8079823802483074,0.6076516456625661
4692,1730743998,1730744571,573,0.5219960190948268,3.377453889319019,0.8658094893170826,0.8211135979288435
4693,1730747598,1730751198,3600,0.47190189589317555,3.1719473411458843,0.1,0.1
4694,1730751198,1730751354,156,0.8283592518808762,3.5344458946529547,0.3919165692687113,0.6934480932830758
4695,1730754798,1730755282,484,0.8505781986120681,3.5529226856518057,0.8001753831121079,0.3030689005140719
4696,1730758398,1730761998,3600,0.23874900261498327,3.1996816953126355,0.1,0.1
4697,1730761998,1730763983,1985,2.026502732310189,4.6904844228563904,0.45878107943921465,0.8650515096557349
4698,1730765598,1730766865,1267,1.1549823223893874,3.9180400627782324,0.48369182691867996,0.13145628063804446
4699,1730769198,1730772798,3600,0.43936795595112,3.104273007005538,0.1,0.1
4700,1730772798,1730776398,3600,0.30783898247846775,3.18543832158356,0.1,0.1
4701,1730776398,1730779022,2624,2.3629753674492835,4.609298596221642,0.4282539447988375,0.3968394538172014
4702,1730779998,1730781878,1880,1.8493111350393203,4.403844373077947,0.386753524663462,0.36401891648514983
4703,1730783598,1730787198,3600,0.12418309727084426,3.000868736450028,0.1,0.1
4704,1730787198,1730789891,2693,1.8626960981872707,4.521077002221905,0.2990087667342738,0.582347190590348
4705,1730790798,1730791816,1018,1.0174124699141485,3.9047899240794797,0.590749293002955,0.9767839170089495
4706,1730794398,1730797998,3600,0.1701454443787535,3.038768699630496,0.1,0.1
4707,1730797998,1730801598,3600,0.3439637972411794,3.0399809982601034,0.1,0.1
4708,1730801598,1730805198,3600,0.40666524446605157,3.1773073597752854,0.1,0.1
4709,1730805198,1730808222,3024,2.4852515268939337,4.320314778551857,0.15071299282782885,0.45554935617320524
4710,1730808798,1730810961,2163,1.8430171341270225,4.335933351805083,0.6314470964764733,0.7475350607922052
4711,1730812398,1730815998,3600,0.34961456283152936,3.0490649442835984,0.1,0.1
4712,1730815998,1730816594,596,0.5313631497870459,3.407781916825304,0.2427055957191025,0.48699596573147175
4713,1730819598,1730823198,3600,0.14464194258050778,3.1009882773019015,0.1,0.1
4714,1730823198,1730826798,3600,0.4107696440047758,3.0930257975851028,0.1,0.1
4715,1730826798,1730830398,3600,0.4333915386530304,3.0659050286429945,0.1,0.1
4716,1730830398,1730833234,2836,1.6383249898720245,4.5694747687964234,0.4141162231908092,0.6426146875900469
4717,1730833998,1730836019,2021,2.1429567568492236,4.506276513651253,0.5765648906637204,0.5764169325698242
4718,1730837598,1730841198,3600,0.31034516225382164,3.1825638245035948,0.1,0.1
4719,1730841198,1730844150,2952,1.9112880335557305,4.318426942417841,0.8343708022085399,0.17088517545488047
4720,1730844798,1730848398,3600,0.40562842347646333,3.1144558383264442,0.1,0.1
4721,1730848398,1730851998,3600,0.15645941440119726,3.178922152275016,0.1,0.1
4722,1730851998,1730855598,3600,0.20524381580077675,3.034588509359341,0.1,0.1
4723,1730855598,1730859198,3600,0.2779359698780427,3.157963272819984,0.1,0.1
4724,1730859198,1730862461,3263,1.6934058724694365,4.5502087970046565,0.5530597916999017,0.9404864915739894
4725,1730862798,1730866398,3600,0.15719163621504953,3.100854817961333,0.1,0.1
4726,1730866398,1730867186,788,1.0050506249659146,3.866855272419665,0.10421420666169769,0.7530952847672485
4727,1730869998,1730871400,1402,1.2285206764583125,4.049144758806907,0.661467499711894,0.2725985797360535
4728,1730873598,1730877198,3600,0.2914067383506476,3.1535483110950002,0.1,0.1
4729,1730877198,1730880209,3011,1.8804699624889187,4.527364231876662,0.11110042498751915,0.8148421021250486
4730,1730880798,1730881579,781,1.3720024216463933,4.056210976804666,0.8333315807471652,0.1493930210012175
4731,1730884398,1730885455,1057,1.1101424122110406,4.07405793692048,0.6711821114704982,0.5126941331893529
4732,1730887998,1730891598,3600,0.26062842472249736,3.078799811748615,0.1,0.1
4733,1730891598,1730895198,3600,0.15682579388514248,3.1364178129841607,0.1,0.1
4734,1730895198,1730898798,3600,0.3064060310822837,3.1528346821841473,0.1,0.1
4735,1730898798,1730902398,3600,0.4582390923837001,3.108422977063421,0.1,0.1
4736,1730902398,1730904287,1889,2.3322178348902787,4.308085659615854,0.2686752517251356,0.837100549208525
4737,1730905998,1730908625,2627,2.1607741079404215,4.560997417613708,0.235726815677051,0.24426177059510187
4738,1730909598,1730913198,3600,0.48183455715467405,3.1218976890124863,0.1,0.1
4739,1730913198,1730916541,3343,1.8254294661652044,4.333173545370058,0.37967818812433474,0.796110698756636
4740,1730916798,1730920129,3331,2.3313170500235683,4.417115752189836,0.4533738958052551,0.5219566529611162
4741,1730920398,1730923679,3281,1.794232689989097,4.619731445400775,0.8740496912781546,0.45434559343627623
4742,1730923998,1730927598,3600,0.3269353895942856,3.084176403743651,0.1,0.1
4743,1730927598,1730931198,3600,0.20556748208190792,3.0290773989672606,0.1,0.1
4744,1730931198,1730934798,3600,0.303246063289743,3.0106266695496244,0.1,0.1
4745,1730934798,1730937805,3007,2.100428670485749,4.418653793665115,0.8293156784323178,0.35426401845599265
4746,1730938398,1730938898,500,0.6438002994656633,3.414759472874511,0.7967968793623816,0.5212615793578603
4747,1730941998,1730943076,1078,1.249109335089527,4.0808680896935785,0.7212862139985742,0.3445232801686327
4748,1730945598,1730946366,768,1.0009074757218113,3.9440824135417296,0.44071302964493586,0.5433522257866265
4749,1730949198,1730952798,3600,0.20842254761827184,3.150246075023735,0.1,0.1
4750,1730952798,1730954615,1817,2.10425432942311,4.696319946994357,0.8909937117716327,0.3783113922204736
4751,1730956398,1730957175,777,1.0386589885270463,3.881843249971527,0.8807755188859269,0.3219738872360601
4752,1730959998,1730963598,3600,0.15313309061312907,3.105458648002658,0.1,0.1
4753,1730963598,1730967198,3600,0.15375488227379705,3.159147216836221,0.1,0.1
4754,1730967198,1730969106,1908,1.9281561905056763,4.467699113047217,0.8735189685717772,0.8157055685698058
4755,1730970798,1730974398,3600,0.3149949012573584,3.116120593249877,0.1,0.1
4756,1730974398,1730977998,3600,0.331262534213336,3.0346408771605855,0.1,0.1
4757,1730977998,1730979620,1622,1.2508609693988528,4.03044835012074,0.3159338469300241,0.673998988579969
4758,1730981598,1730985198,3600,0.4557420432324011,3.1542861456305253,0.1,0.1
4759,1730985198,1730987459,2261,1.70720410384057,4.689088547731429,0.5187749530671435,0.8590531646445476
4760,1730988798,1730992398,3600,0.38359463456270715,3.0420530386123796,0.1,0.1
4761,1730992398,1730995137,2739,2.2392209094198967,4.639975772750958,0.382407361341762,0.5514075729457257
4762,1730995998,1730997174,1176,1.277815567548664,4.173451718990805,0.1958401670466261,0.8477559409855935
4763,1730999598,1731003061,3463,1.5908369487877017,4.4944811190145515,0.4141140582895432,0.13704858558354746
4764,1731003198,1731006199,3001,1.6865195114127127,4.492902382887825,0.8546595978374925,0.15668680485488382
4765,1731006798,1731007880,1082,1.3742448043453832,3.831159360852381,0.33145552381518906,0.7570489172788166
4766,1731010398,1731013998,3600,0.3068400375510457,3.1669269362687773,0.1,0.1
4767,1731013998,1731017598,3600,0.3144773325521347,3.002281425473089,0.1,0.1
4768,1731017598,1731021198,3600,0.29457011705865,3.1787357140875523,0.1,0.1
4769,1731021198,1731024311,3113,1.9258017712618327,4.318284743653605,0.4297364928914812,0.33845056781907834
4770,1731024798,1731027029,2231,1.934644381606676,4.314718494373272,0.16136188525417558,0.7052211039378723
4771,1731028398,1731031998,3600,0.441713657827571,3.1576870901314047,0.1,0.1
4772,1731031998,1731035598,3600,0.28960753072273593,3.044581307450544,0.1,0.1
4773,1731035598,1731039198,3600,0.3996044094638397,3.142843719193024,0.1,0.1
4774,1731039198,1731042160,2962,2.4235677894253405,4.363568886202784,0.36043155289067197,0.639066659592406
4775,1731042798,1731046398,3600,0.3508198656739292,3.0652404411108956,0.1,0.1
4776,1731046398,1731049998,3600,0.3952295277093948,3.1762943863098965,0.1,0.1
4777,1731049998,1731053598,3600,0.16727954112829402,3.1169476044697246,0.1,0.1
4778,1731053598,1731056772,3174,1.9516774439900217,4.572994965540975,0.4359561168353282,0.8966753584325556
4779,1731057198,1731059858,2660,2.156301219225277,4.3661438076196974,0.6443105539128903,0.30959556895335516
4780,1731060798,1731064398,3600,0.21362722595586156,3.153796702851436,0.1,0.1
4781,1731064398,1731067401,3003,1.8163628381353816,4.65540165099688,0.970660686834783,0.14951162764378148
4782,1731067998,1731071598,3600,0.2648187243601248,3.0794287017876765,0.1,0.1
4783,1731071598,1731075198,3600,0.38062618714105934,3.1236804479330407,0.1,0.1
4784,1731075198,1731078798,3600,0.24574002908390802,3.0719167278002555,0.1,0.1
4785,1731078798,1731082353,3555,2.0251935989037833,4.671179183438025,0.7869954224845336,0.33917930216734715
4786,1731082398,1731085998,3600,0.13938311612780252,3.1978865799420912,0.1,0.1
4787,1731085998,1731089598,3600,0.23395695333095756,3.006442522141965,0.1,0.1
4788,1731089598,1731093198,3600,0.48021592632491317,3.103118944917671,0.1,0.1
4789,1731093198,1731094146,948,1.46949429631155,3.9589828124783812,0.8607042155252563,0.6733695537684243
4790,1731096798,1731099545,2747,1.5857389779052824,4.551648844660067,0.8546337809534337,0.6966888488549984
4791,1731100398,1731103998,3600,0.19475750012823767,3.1388249642676276,0.1,0.1
4792,1731103998,1731107598,3600,0.39979718815665155,3.127024440322033,0.1,0.1
4793,1731107598,1731110938,3340,1.8201392567121517,4.534254861231878,0.8719244300061735,0.18919637887879587
4794,1731111198,1731114790,3592,1.6706774069541925,4.314153426931039,0.23227478732172158,0.9897601317392173
4795,1731114798,1731118398,3600,0.12625302786212755,3.044655444179472,0.1,0.1
4796,1731118398,1731119934,1536,1.3147878911139501,4.0671490068339535,0.37525367419779654,0.7784136647965775
4797,1731121998,1731125598,3600,0.389331354050232,3.0578843622684717,0.1,0.1
4798,1731125598,1731126142,544,0.930818723280576,3.3952307928960623,0.4278930907169386,0.9424243729668984
4799,1731129198,1731132798,3600,0.268272509700322,3.085071429166085,0.1,0.1
4800,1731132798,1731136398,3600,0.16453713148125038,3.1892737728490674,0.1,0.1
4801,1731136398,1731139998,3600,0.3830880476595694,3.0702577139825427,0.1,0.1
4802,1731139998,1731143598,3600,0.19048080077629984,3.0103042417030266,0.1,0.1
4803,1731143598,1731147198,3600,0.12337115237292738,3.1883388600901115,0.1,0.1
4804,1731147198,1731150798,3600,0.2919303229329307,3.137518247424809,0.1,0.1
4805,1731150798,1731154398,3600,0.27008285586797887,3.0881471349999563,0.1,0.1
4806,1731154398,1731157998,3600,0.16410713635517843,3.1079583842325196,0.1,0.1
4807,1731157998,1731161598,3600,0.13063994245393482,3.0318600027702387,0.1,0.1
4808,1731161598,1731165198,3600,0.10211478775220391,3.084004341710984,0.1,0.1
4809,1731165198,1731168798,3600,0.37549762232430095,3.1381522192740894,0.1,0.1
4810,1731168798,1731171257,2459,1.5607420272847068,4.66123690623423,0.5488330334042114,0.5868480024814083
4811,1731172398,1731173916,1518,1.0099112730522586,3.9636158561748283,0.620896263657808,0.936909822043982
4812,1731175998,1731179598,3600,0.30867239359994925,3.0167155953551683,0.1,0.1
4813,1731179598,1731183036,3438,2.4078907554380007,4.66572579402649,0.8140522601490369,0.7220657023061
4814,1731183198,1731186223,3025,1.9703650478833206,4.678733154045642,0.6106071309462994,0.8842754166156898
4815,1731186798,1731190398,3600,0.33608510180962603,3.1514641585006173,0.1,0.1
4816,1731190398,1731193998,3600,0.40188351474934947,3.0982146346554162,0.1,0.1
4817,1731193998,1731194844,846,1.3805150218219113,3.9437972448559195,0.5221246857867722,0.9340961515110213
4818,1731197598,1731201198,3600,0.15899797021991638,3.032368950633167,0.1,0.1
4819,1731201198,1731204798,3600,0.3923736352393763,3.039850525008402,0.1,0.1
4820,1731204798,1731208398,3600,0.28891921606849646,3.023120871210489,0.1,0.1
4821,1731208398,1731211998,3600,0.2620606086685606,3.1733979219471093,0.1,0.1
4822,1731211998,1731215598,3600,0.2259580872631217,3.0531703314611343,0.1,0.1
4823,1731215598,1731219198,3600,0.2153828190214623,3.121233550536597,0.1,0.1
4824,1731219198,1731222724,3526,2.282085970153543,4.468659081718275,0.7877035609584102,0.5415307285094864
4825,1731222798,1731226398,3600,0.2240802600220201,3.189641760848071,0.1,0.1
4826,1731226398,1731229056,2658,1.8401410150200919,4.310410517039642,0.9230961631765714,0.5302985138354152
4827,1731229998,1731231351,1353,1.4184148844824205,4.077858518491778,0.41260592491175474,0.5736110938946379
4828,1731233598,1731234535,937,1.3709500883791694,3.939857331899666,0.37220794485707664,0.9757842426076736
4829,1731237198,1731240798,3600,0.17171332984591495,3.1047254997498284,0.1,0.1
4830,1731240798,1731244398,3600,0.20947161919368784,3.1282467575334008,0.1,0.1
4831,1731244398,1731245040,642,1.4075129405891715,4.075556516294308,0.5658520796766323,0.1861473533998433
4832,1731247998,1731251598,3600,0.3368966721023121,3.094699961142899,0.1,0.1
4833,1731251598,1731252438,840,1.2696733804228204,4.043009801645976,0.9817901943746415,0.4196755877421471
4834,1731255198,1731258702,3504,1.52191077528447,4.326091897044616,0.35936566345078635,0.8672935782503874
4835,1731258798,1731258865,67,0.6847925862201807,3.4652175673770014,0.604979356033924,0.6484584039671657
4836,1731262398,1731263732,1334,1.2323490959037107,3.8243169761324043,0.28187874377562294,0.39634728554677057
4837,1731265998,1731266964,966,1.1119213812648903,3.9612688962861933,0.5249688250604373,0.2541537149684164
4838,1731269598,1731273198,3600,0.10337632649109962,3.01604699441821,0.1,0.1
4839,1731273198,1731276798,3600,0.34429067209757386,3.027894233296413,0.1,0.1
4840,1731276798,1731279912,3114,1.899576362901924,4.419362301797303,0.4333520084453587,0.9827841517126082
4841,1731280398,1731283998,3600,0.20703956746894875,3.1965563995487956,0.1,0.1
4842,1731283998,1731284813,815,1.4165600683813455,4.161402056440906,0.4326360790831316,0.5951715345805373
4843,1731287598,1731291198,3600,0.32972470870297077,3.1065537179689415,0.1,0.1
4844,1731291198,1731293486,2288,2.209324312001722,4.484318702711598,0.45575378456162297,0.1897050518161542
4845,1731294798,1731298103,3305,2.4413205241013687,4.381913300206639,0.7685607755719168,0.5977229707403486
4846,1731298398,1731300972,2574,1.5903118723519378,4.3388495937381615,0.4976594151563456,0.7399835736605127
4847,1731301998,1731304657,2659,2.3559943227874247,4.369386792882403,0.7000143053228702,0.5661657169635452
4848,1731305598,1731309198,3600,0.20909007896747497,3.1948526098577523,0.1,0.1
4849,1731309198,1731312798,3600,0.1578806017948257,3.1655917494003503,0.1,0.1
4850,1731312798,1731316398,3600,0.2995719348427193,3.0549904124795098,0.1,0.1
4851,1731316398,1731316672,274,0.6409701461333385,3.3138358171048408,0.19964495898983914,0.7882465625221806
4852,1731319998,1731321796,1798,1.0403644313098321,4.1814115221873775,0.5464898705670688,0.3728491216270011
4853,1731323598,1731324643,1045,1.210097352578586,3.8388675960165437,0.67571163366012,0.7093117975813114
4854,1731327198,1731330798,3600,0.1360967738276313,3.190487996046124,0.1,0.1
4855,1731330798,1731332299,1501,1.1279506245250182,3.9651084821091023,0.1468480400554958,0.9123061321782004
4856,1731334398,1731337998,3600,0.4396033912630094,3.0206722915252726,0.1,0.1
4857,1731337998,1731338403,405,0.6745162979205136,3.369029281608337,0.8456062833445901,0.12012934959936054
4858,1731341598,1731345198,3600,0.18395881109577955,3.1587689049673724,0.1,0.1
4859,1731345198,1731346040,842,1.3136362628619151,3.829196911794414,0.6828020902933424,0.1745018619822023
4860,1731348798,1731351026,2228,1.5023064124619596,4.614160005285663,0.6915154989785808,0.5812447401941699
4861,1731352398,1731355998,3600,0.18786606493178765,3.1466443828032884,0.1,0.1
4862,1731355998,1731356811,813,1.019294143107214,3.8546418448490463,0.4734089095253312,0.6602973757125447
4863,1731359598,1731359942,344,0.805868232662649,3.6011033144983435,0.5752805881552936,0.1710951861931983
4864,1731363198,1731364493,1295,1.4413997366661433,3.8639913943585507,0.4064815252104692,0.3553250715397003
4865,1731366798,1731370328,3530,2.352387821755474,4.321715150313821,0.6671163390356663,0.8708635168081429
4866,1731370398,1731373998,3600,0.19830214282200107,3.0002281160670945,0.1,0.1
4867,1731373998,1731377598,3600,0.17433233847009,3.0100320373590073,0.1,0.1
4868,1731377598,1731381198,3600,0.4953913292560286,3.1610704006595083,0.1,0.1
4869,1731381198,1731384798,3600,0.33351564217338614,3.0370206252569814,0.1,0.1
4870,1731384798,1731388398,3600,0.47221893810081295,3.130006657233302,0.1,0.1
4871,1731388398,1731391755,3357,2.266876784260817,4.3773760785269475,0.6840393191166311,0.1987781145781598
4872,1731391998,1731395598,3600,0.2837033379185917,3.0391632747922865,0.1,0.1
4873,1731395598,1731395875,277,0.6392684740221373,3.6129574982070816,0.6586690990427155,0.5929870210844947
4874,1731399198,1731401061,1863,2.310870551067913,4.475475704524735,0.6557968214294356,0.7922945539951975
4875,1731402798,1731405370,2572,2.216223295738259,4.64472987625842,0.4905424954949681,0.7543086427017742
4876,1731406398,1731408129,1731,1.264956367286459,3.861624338480495,0.6372335831662738,0.7323927860934187
4877,1731409998,1731411291,1293,1.0751508635228109,4.059000201166416,0.740015027533872,0.9256285628399502
4878,1731413598,1731417198,3600,0.4165133372725026,3.172440895238471,0.1,0.1
4879,1731417198,1731420798,3600,0.48793145884975064,3.1698503828899027,0.1,0.1
4880,1731420798,1731423483,2685,2.4651366685708402,4.482625074351087,0.5056649523769278,0.3744992824516348
4881,1731424398,1731427998,3600,0.2357860686204014,3.01863445386356,0.1,0.1
4882,1731427998,1731431598,3600,0.43897925838930174,3.0464389634695133,0.1,0.1
4883,1731431598,1731432109,511,0.934526005054225,3.571173804300937,0.8434763260947521,0.12067572425453581
4884,1731435198,1731438798,3600,0.2143744278038502,3.0530602977329315,0.1,0.1
4885,1731438798,1731442398,3600,0.10703004312275102,3.00532009100096,0.1,0.1
4886,1731442398,1731445998,3600,0.21162381357015128,3.075749178988874,0.1,0.1
4887,1731445998,1731449598,3600,0.17833574798483032,3.0132186435881914,0.1,0.1
4888,1731449598,1731452004,2406,2.399093333394245,4.6402826071320105,0.7743034674950028,0.8875168897866167
4889,1731453198,1731456798,3600,0.273512238503396,3.1496516918737245,0.1,0.1
4890,1731456798,1731457123,325,0.5983977138400441,3.445052688152047,0.15590331028272195,0.7132690437471346
4891,1731460398,1731462552,2154,1.9099618394038513,4.320484900192282,0.9734562697647692,0.6052449375334809
4892,1731463998,1731467598,3600,0.4666747917284081,3.0786798154958457,0.1,0.1
4893,1731467598,1731470708,3110,1.5350171884338475,4.661025384496049,0.12292148380968071,0.710044572723933
4894,1731471198,1731473547,2349,1.689103024423442,4.647253936430617,0.6850349504741979,0.7278228973147458
4895,1731474798,1731478398,3600,0.13309560631412476,3.1838709569257904,0.1,0.1
4896,1731478398,1731478484,86,0.5804204264301099,3.414574617777834,0.8181109863828403,0.4432673403179389
4897,1731481998,1731485598,3600,0.43705436382210283,3.0240067843368537,0.1,0.1
4898,1731485598,1731487534,1936,1.5820719714746512,4.322421874694107,0.5397305401668527,0.5148987370588645
4899,1731489198,1731489900,702,1.0476855374079526,4.176605623786549,0.7763738517813231,0.9795111995191795
4900,1731492798,1731495932,3134,1.909005574931688,4.643014087299497,0.4793702981342197,0.806812817923915
4901,1731496398,1731497202,804,1.48582231798561,4.092909267027621,0.751878907807891,0.344941553754053
4902,1731499998,1731500289,291,0.972038143987674,3.3241999658226478,0.11095054677195121,0.6787792986825738
4903,1731503598,1731505981,2383,2.204797841348889,4.46571664776947,0.8020696371675634,0.9991065357512083
4904,1731507198,1731508472,1274,1.449816876326707,4.059442891155187,0.8455802924346105,0.41671150466665763
4905,1731510798,1731513223,2425,2.084225129681584,4.583689396695573,0.8107096217122813,0.7894987549691258
4906,1731514398,1731517998,3600,0.45661176228420053,3.1093148565487017,0.1,0.1
4907,1731517998,1731520411,2413,1.8678370714700845,4.487213952631175,0.960457579043139,0.6092467792022488
4908,1731521598,1731521882,284,0.9261777359091725,3.699800939563419,0.6457068551506173,0.1718027154311507
4909,1731525198,1731528798,3600,0.4042106296521202,3.1730946912349745,0.1,0.1
4910,1731528798,1731532398,3600,0.10934811343000722,3.1169265252669294,0.1,0.1
4911,1731532398,1731535998,3600,0.22330486634377014,3.1705365168517683,0.1,0.1
4912,1731535998,1731539598,3600,0.17922370019500297,3.0934886700192417,0.1,0.1
4913,1731539598,1731543198,3600,0.4628289848957122,3.0820668881639524,0.1,0.1
4914,1731543198,1731546138,2940,2.3096036262471715,4.635603637802115,0.49340308440714575,0.765940829501385
4915,1731546798,1731550398,3600,0.37990758113637424,3.011716899557955,0.1,0.1
4916,1731550398,1731553998,3600,0.43941459642725356,3.159097823113299,0.1,0.1
4917,1731553998,1731554259,261,0.7994602517238748,3.397524205016121,0.7088141589297094,0.7831666692368079
4918,1731557598,1731558290,692,1.022030221577779,3.97535968882834,0.4745173711892463,0.48685353558189803
4919,1731561198,1731562452,1254,1.2751519847771184,3.973638940642939,0.6243221787779432,0.5880740690653093
4920,1731564798,1731568398,3600,0.35650493969890173,3.06089489301109,0.1,0.1
4921,1731568398,1731568932,534,0.6299358059410392,3.503681534881219,0.4940734794519257,0.4071675819999697
4922,1731571998,1731574043,2045,1.9413113415670327,4.670366075715508,0.7911627736161885,0.3010361755367731
4923,1731575598,1731576464,866,1.0047249838885968,4.15741537368065,0.47162481313612403,0.23653126633137822
4924,1731579198,1731580492,1294,1.4380621957293018,3.9484226763944514,0.3311191553526266,0.8516899989630914
4925,1731582798,1731586398,3600,0.31454385221424885,3.103605700965216,0.1,0.1
4926,1731586398,1731589668,3270,2.340270770306098,4.4513798274564085,0.891458859422133,0.27502697689502875
4927,1731589998,1731590077,79,0.5021962654299279,3.5114658634592706,0.3954355591613322,0.7535976507394787
4928,1731593598,1731594184,586,0.5481029248403358,3.6071517898558514,0.3222493881095588,0.34902610287952784
4929,1731597198,1731599099,1901,2.070479687073547,4.682850176244251,0.6487541580590135,0.3403587634245394
4930,1731600798,1731604398,3600,0.3853948775704932,3.158270170084018,0.1,0.1
4931,1731604398,1731605833,1435,1.111041962499393,4.195799189809018,0.7004532730337764,0.8542218362170891
4932,1731607998,1731611598,3600,0.1789862489737566,3.001990348459034,0.1,0.1
4933,1731611598,1731615198,3600,0.28721908976456434,3.146530343326788,0.1,0.1
4934,1731615198,1731618798,3600,0.22412646176218703,3.154832329802003,0.1,0.1
4935,1731618798,1731621755,2957,1.7695869530515709,4.669319928147058,0.332286347944407,0.7371929774526991
4936,1731622398,1731625617,3219,2.49486655498108,4.530704941820242,0.5215187691927234,0.6670022028753252
4937,1731625998,1731629598,3600,0.24357118710876266,3.12902075778658,0.1,0.1
4938,1731629598,1731631153,1555,1.09705090305834,3.9046886569366226,0.12484480406738496,0.9906174724609824
4939,1731633198,1731636192,2994,2.1888214836354702,4.324000021914302,0.2329345837465368,0.9825826867729821
4940,1731636798,1731640398,3600,0.2670963787806724,3.127060403651334,0.1,0.1
4941,1731640398,1731643998,3600,0.3292574370131369,3.189670772881123,0.1,0.1
4942,1731643998,1731647598,3600,0.26255011020763397,3.1946990459028313,0.1,0.1
4943,1731647598,1731650552,2954,2.4997322114941456,4.617024481451062,0.27680008114303845,0.6337192844173624
4944,1731651198,1731654798,3600,0.2854518086678033,3.041894444794122,0.1,0.1
4945,1731654798,1731658398,3600,0.29940346833664155,3.161602908318079,0.1,0.1
4946,1731658398,1731661998,3600,0.4031086869051812,3.1294690233379905,0.1,0.1
4947,1731661998,1731665598,3600,0.41059776765935585,3.192163477770518,0.1,0.1
4948,1731665598,1731669198,3600,0.3356019069143861,3.043395293359967,0.1,0.1
4949,1731669198,1731671495,2297,1.6720453974000893,4.555078108515047,0.8605475033345698,0.8297094070687493
4950,1731672798,1731673162,364,0.8754466170690853,3.4968664162096768,0.2156050644317386,0.6164535007830916
4951,1731676398,1731679998,3600,0.370657921408306,3.009202213075975,0.1,0.1
4952,1731679998,1731683598,3600,0.3013059017096576,3.109973755551256,0.1,0.1
4953,1731683598,1731687198,3600,0.28681120798069504,3.033464719312314,0.1,0.1
4954,1731687198,1731690798,3600,0.43152480180500596,3.0742252541522235,0.1,0.1
4955,1731690798,1731694398,3600,0.3361308359089642,3.0989404294798137,0.1,0.1
4956,1731694398,1731695198,800,1.3736646232006349,4.14754268117202,0.424311316760723,0.48064768048039685
4957,1731697998,1731701181,3183,1.529845784650183,4.515662991171055,0.5051268897987442,0.9072727284640563
4958,1731701598,1731705198,3600,0.40016365242435425,3.0478339115864745,0.1,0.1
4959,1731705198,1731707901,2703,2.3318643577354683,4.582331512974949,0.9312855977906166,0.7019030262935575
4960,1731708798,1731709046,248,0.5590711341823862,3.5238797557918082,0.41585235920438257,0.3628057598889305
4961,1731712398,1731715998,3600,0.3243902622920075,3.0959136784868675,0.1,0.1
4962,1731715998,1731719598,3600,0.36201713739239083,3.0226589549570653,0.1,0.1
4963,1731719598,1731723198,3600,0.22677689086197167,3.0730724686630158,0.1,0.1
4964,1731723198,1731726464,3266,2.0950036529242264,4.501816640625612,0.44943075247680997,0.7084469951931051
4965,1731726798,1731728546,1748,1.0167582154153836,4.049778859117317,0.4386739649882304,0.44880968277006617
4966,1731730398,1731733998,3600,0.22245013852915474,3.110950729831218,0.1,0.1
4967,1731733998,1731737586,3588,2.3595908878506435,4.339539151509371,0.8114728135213345,0.737225782063923
4968,1731737598,1731741198,3600,0.2297596451783985,3.1091626757213535,0.1,0.1
4969,1731741198,1731744798,3600,0.4624882714674047,3.1267477237545105,0.1,0.1
4970,1731744798,1731745173,375,0.8105049337257805,3.6840955082933675,0.7550557736481227,0.7904059763855538
4971,1731748398,1731751072,2674,1.874319297247805,4.3988050141117805,0.35481015870333266,0.9257357949561804
4972,1731751998,1731755598,3600,0.10893145097309263,3.159092222065971,0.1,0.1
4973,1731755598,1731759198,3600,0.21692138823042734,3.099965197592929,0.1,0.1
4974,1731759198,1731760168,970,1.4608248469061398,4.08381853554224,0.9806654655156177,0.7942203595360042
4975,1731762798,1731762871,73,0.9701805915892159,3.33429209655798,0.2597644156955056,0.7187447777253099
4976,1731766398,1731768144,1746,1.1537802877638699,4.149749409008498,0.850482295154787,0.8830339037965615
4977,1731769998,1731773598,3600,0.143061770158457,3.0522296458053244,0.1,0.1
4978,1731773598,1731775166,1568,1.1516817818981304,4.074184251010293,0.40870581121881966,0.23009788130717174
4979,1731777198,1731778016,818,1.2074640926780753,4.062134109772131,0.7755928393632422,0.9423573431102188
4980,1731780798,1731782075,1277,1.3580963992639008,3.915921247296012,0.10046275184310421,0.19612520353653118
4981,1731784398,1731786056,1658,1.3511659943738834,3.8375457996320894,0.6951104058372775,0.8260150719709276
4982,1731787998,1731788977,979,1.1822879772247845,3.8228829245284413,0.9646459170554272,0.2748294845741407
4983,1731791598,1731795198,3600,0.15484094071031215,3.116009639271468,0.1,0.1
4984,1731795198,1731796339,1141,1.111488880595917,3.9343055923225383,0.38826486562439555,0.8351408050779912
4985,1731798798,1731799671,873,1.422796274600587,4.073331408475952,0.71474769260152,0.2766414737964913
4986,1731802398,1731803065,667,1.3772659669833904,3.90834650774457,0.187051298438063,0.4999950604386396
4987,1731805998,1731809277,3279,2.4823737667580708,4.426182761031134,0.4758858470428168,0.8601281492869236
4988,1731809598,1731811918,2320,1.936883186404276,4.545144440855563,0.27748690908140644,0.5049594902459087
4989,1731813198,1731813751,553,0.8829090034914464,3.467650679833169,0.7900625798057271,0.8931527371730266
4990,1731816798,1731816971,173,0.8106336062098887,3.3493243574188916,0.7634421666316088,0.12475526823525851
4991,1731820398,1731821376,978,1.061154469730152,4.1790183227944055,0.2993198340703536,0.11448427726497525
4992,1731823998,1731827598,3600,0.1152704381862705,3.128113477676254,0.1,0.1
4993,1731827598,1731830516,2918,1.8509650253071583,4.5469152523469365,0.5357988589435818,0.4850351029797726
4994,1731831198,1731833927,2729,1.8279484925945404,4.539608777974456,0.5799557070209149,0.8088672495340165
4995,1731834798,1731837045,2247,1.6820853547439767,4.611051684033866,0.8300405258121449,0.8640487288885941
4996,1731838398,1731841998,3600,0.3382799510318739,3.1182732076017445,0.1,0.1
4997,1731841998,1731845489,3491,2.2715219765760883,4.304105198231869,0.24499678529340327,0.4431330098145366
4998,1731845598,1731846252,654,1.3140144983901072,3.972637691905401,0.23655617790466724,0.545816000564814
4999,1731849198,1731852798,3600,0.2915644554683554,3.1007841896369492,0.1,0.1
5000,1731852798,1731855486,2688,2.3958097884854004,4.57358183353386,0.7318723295123338,0.6328846999866233
5001,1731856398,1731858645,2247,2.2030612387792985,4.392100466381052,0.580451211314695,0.880187133639806
5002,1731859998,1731862393,2395,2.4969553005312424,4.558647716365559,0.6717171985167145,0.3188031060372316
5003,1731863598,1731867198,3600,0.20651524722180967,3.081920214327813,0.1,0.1
5004,1731867198,1731870798,3600,0.12470511783771415,3.0978702749040496,0.1,0.1
5005,1731870798,1731872998,2200,1.8636006654632316,4.353834662807975,0.936758088537061,0.3650623660548131
5006,1731874398,1731877998,3600,0.47550088040341787,3.152901382321323,0.1,0.1
5007,1731877998,1731881598,3600,0.37526635600798985,3.195053698510027,0.1,0.1
5008,1731881598,1731885198,3600,0.13106514682561354,3.1072860962482927,0.1,0.1
5009,1731885198,1731888798,3600,0.4298086451356965,3.051730633999141,0.1,0.1
5010,1731888798,1731891946,3148,2.083222425072525,4.398462204833531,0.8002276832953925,0.1601987373311847
5011,1731892398,1731895187,2789,2.3868942993623294,4.630076132232142,0.5184806384966318,0.7293259094431387
5012,1731895998,1731898791,2793,1.8228316443186614,4.525206351025116,0.7032866148170108,0.9282989252384185
5013,1731899598,1731901092,1494,1.1528865053844233,4.082995128438167,0.7517335670443783,0.7820567075387612
5014,1731903198,1731906798,3600,0.37506734950944176,3.00125346593678,0.1,0.1
5015,1731906798,1731910398,3600,0.41163017846775407,3.126961988918667,0.1,0.1
5016,1731910398,1731913998,3600,0.19163257459182495,3.129086337934984,0.1,0.1
5017,1731913998,1731917598,3600,0.25368922564961094,3.136118781058507,0.1,0.1
5018,1731917598,1731921198,3600,0.20831007162168796,3.015819542438876,0.1,0.1
5019,1731921198,1731924269,3071,2.171325072077983,4.61485457241803,0.3635843395262921,0.33114011926833264
5020,1731924798,1731928398,3600,0.49562457355834943,3.1914815370818763,0.1,0.1
5021,1731928398,1731931998,3600,0.48861253605042976,3.129998574592678,0.1,0.1
5022,1731931998,1731934420,2422,2.497499964966817,4.609358520922978,0.7693258301972683,0.7302178634997875
5023,1731935598,1731936877,1279,1.0340278662925992,4.126210305670925,0.8681163771994225,0.4401437769847245
5024,1731939198,1731942798,3600,0.16081164004952983,3.0529889792959373,0.1,0.1
5025,1731942798,1731945248,2450,2.359563903369764,4.594878050393024,0.53539988792,0.8968345245286357
5026,1731946398,1731949998,3600,0.40968047233564164,3.1516167205207126,0.1,0.1
5027,1731949998,1731953598,3600,0.28717716352259737,3.1745719414036513,0.1,0.1
5028,1731953598,1731957198,3600,0.26912338939480496,3.093317575435598,0.1,0.1
5029,1731957198,1731957824,626,1.440603803666654,4.144508133982028,0.5742991602418439,0.212843336003602
5030,1731960798,1731961420,622,1.06894269355051,3.8534372703758897,0.558415028522819,0.6585637486328568
5031,1731964398,1731967231,2833,1.8007034531019182,4.335914078377486,0.8288267213638719,0.3541048683255088
5032,1731967998,1731969061,1063,1.2525184482063314,3.9722420422298472,0.31284486746159734,0.17827502529191597
5033,1731971598,1731975198,3600,0.18256116528045105,3.0616193371500127,0.1,0.1
5034,1731975198,1731978729,3531,1.840712359744264,4.361309040942591,0.6839259045406575,0.5820692156395506
5035,1731978798,1731980849,2051,2.314375843192271,4.673087691756191,0.5695438663368425,0.24156155812247287
5036,1731982398,1731984724,2326,1.53439180262674,4.567648174157153,0.1474483139869907,0.5778342013378502
5037,1731985998,1731987828,1830,2.30480914320427,4.300533762947296,0.24123620769768686,0.37364583024763165
5038,1731989598,1731989759,161,0.6769313210178505,3.350665347751666,0.6972122998913908,0.8419178913921481
5039,1731993198,1731996798,3600,0.15128135178241112,3.071736009252603,0.1,0.1
5040,1731996798,1731999053,2255,1.6904475114411097,4.603279044517227,0.5905819398508837,0.8198957997082038
5041,1732000398,1732000926,528,0.757199130077696,3.3385550805841158,0.651727264711719,0.8620148947646346
5042,1732003998,1732004596,598,0.5561935256852615,3.6005654329403347,0.9607013982399103,0.4971952200230483
5043,1732007598,1732008736,1138,1.3029032722228062,4.188725829350068,0.47218455474990717,0.6027391646460407
5044,1732011198,1732014798,3600,0.1740481965954015,3.061906880761241,0.1,0.1
5045,1732014798,1732017488,2690,1.5746460553893389,4.460767376027592,0.7687747279046907,0.44667392538991446
5046,1732018398,1732019351,953,1.4572272251658815,4.150290637166888,0.4618153586690389,0.9257658998430882
5047,1732021998,1732025598,3600,0.3786175079912054,3.1448852758728942,0.1,0.1
5048,1732025598,1732028222,2624,2.413863174147998,4.413651457092328,0.8254518395237553,0.5503702298817463
5049,1732029198,1732032335,3137,2.090472134658314,4.434524202522961,0.8014176002033656,0.2662029594460577
5050,1732032798,1732034208,1410,1.310392375920149,3.8644153850217244,0.9499520419600731,0.5195509049762966
5051,1732036398,1732039998,3600,0.3962653318171515,3.1048735409396704,0.1,0.1
5052,1732039998,1732043598,3600,0.35389369647962765,3.085246027603715,0.1,0.1
5053,1732043598,1732045241,1643,1.2462814500131127,3.9668569191118492,0.4459137665745315,0.6225998876913782
5054,1732047198,1732047996,798,1.4177853698173584,4.064442090216106,0.8885230497850242,0.46394042855221207
5055,1732050798,1732054398,3600,0.10335586670400475,3.1621494711793847,0.1,0.1
5056,1732054398,1732057998,3600,0.282200986003751,3.0146286334648127,0.1,0.1
5057,1732057998,1732061598,3600,0.23700144270370274,3.138482944149675,0.1,0.1
5058,1732061598,1732065198,3600,0.196571778662275,3.0711318599774917,0.1,0.1
5059,1732065198,1732067566,2368,1.9655387373047524,4.636022604078575,0.1408935023702844,0.9313004303661947
5060,1732068798,1732072398,3600,0.3188760601246733,3.0835384216676416,0.1,0.1
5061,1732072398,1732073679,1281,1.2103396737234315,4.088608684437351,0.7112205173678257,0.11811986727054498
5062,1732075998,1732079598,3600,0.21483065819180244,3.182205280425161,0.1,0.1
5063,1732079598,1732083198,3600,0.17861918955879783,3.1539809692917475,0.1,0.1
5064,1732083198,1732086258,3060,1.7189617088103157,4.560125560306418,0.2901070047676612,0.11016543778643456
5065,1732086798,1732090398,3600,0.14434735173857152,3.1337272045324482,0.1,0.1
5066,1732090398,1732091110,712,1.4762296637940582,3.8400199781904183,0.6759295672169566,0.6068374227210382
5067,1732093998,1732097598,3600,0.38702778514023073,3.199201224231846,0.1,0.1
5068,1732097598,1732101092,3494,2.373304855180744,4.327229626038315,0.46103427597161795,0.25518529356439534
5069,1732101198,1732102470,1272,1.076363726182927,4.149878514779848,0.9624155053514826,0.30299074508018825
5070,1732104798,1732107650,2852,1.9197154533219876,4.336316863193615,0.8332748544367551,0.7510371006302089
5071,1732108398,1732111998,3600,0.2584206813517842,3.016732608082221,0.1,0.1
5072,1732111998,1732115598,3600,0.43013140068918765,3.0364884232422815,0.1,0.1
5073,1732115598,1732116305,707,1.426072434626065,4.037939736946126,0.19916072177057936,0.5808230276086901
5074,1732119198,1732122798,3600,0.15695598236651087,3.068456085859305,0.1,0.1
5075,1732122798,1732125342,2544,2.235973503980731,4.487633086727386,0.13411129446135037,0.6701681096025763
5076,1732126398,1732129998,3600,0.1209055233713357,3.035049640854564,0.1,0.1
5077,1732129998,1732133272,3274,1.553327748019771,4.421261770893778,0.9313870189334855,0.3004003610520431
5078,1732133598,1732136121,2523,1.5822793865084153,4.631751950059299,0.21625518237827263,0.6798077477107148
5079,1732137198,1732140798,3600,0.3403751393879107,3.1529962289033313,0.1,0.1
5080,1732140798,1732143926,3128,1.6382342434377923,4.390261101457844,0.40743946460611524,0.845388560069447
5081,1732144398,1732147998,3600,0.17335166757375942,3.061841946209406,0.1,0.1
5082,1732147998,1732151598,3600,0.2854161725551173,3.087038050023305,0.1,0.1
5083,1732151598,1732153202,1604,1.2012045162054181,3.805793697468128,0.8447405105916984,0.4672671984596988
5084,1732155198,1732156554,1356,1.1212990492736126,3.9798943385668006,0.36650350362391193,0.19347736898272105
5085,1732158798,1732160228,1430,1.180342139574558,3.807405064818278,0.6874029807963988,0.48937218760121093
5086,1732162398,1732165998,3600,0.41102163590289065,3.116057989235361,0.1,0.1
5087,1732165998,1732167945,1947,2.0302238712495657,4.5863771328898615,0.5270549187908812,0.49584088733597165
5088,1732169598,1732171824,2226,1.9923573198361293,4.65602353300746,0.7358894165572059,0.12944207705009633
5089,1732173198,1732176253,3055,1.8433679690687788,4.48957846088388,0.28131390419389934,0.6386596509124848
5090,1732176798,1732180398,3600,0.21587514055089235,3.0441217178011564,0.1,0.1
5091,1732180398,1732183998,3600,0.2980175510668502,3.1506341708083334,0.1,0.1
5092,1732183998,1732187598,3600,0.13573559339990618,3.122969131201369,0.1,0.1
5093,1732187598,1732187815,217,0.6506538534476431,3.406248928242073,0.40216045849038085,0.7123410539083753
5094,1732191198,1732191565,367,0.7842468734513726,3.356789858673398,0.7236730537986007,0.8794494499118133
5095,1732194798,1732197758,2960,2.103905472381607,4.695698456391303,0.9985339861171196,0.3624658983676238
5096,1732198398,1732201565,3167,1.7102087212942632,4.333375306510082,0.6670277889921654,0.389942864108033
5097,1732201998,1732204492,2494,2.0288770757393104,4.340803848478459,0.18391620348973006,0.6305414833089328
5098,1732205598,1732209198,3600,0.4354547860364403,3.165307662221407,0.1,0.1
5099,1732209198,1732212798,3600,0.32199397599172436,3.170887909093945,0.1,0.1
5100,1732212798,1732215697,2899,1.5048639420331782,4.570143949550219,0.13845115064612268,0.989459677604616
5101,1732216398,1732219133,2735,2.1685333625424423,4.387225970438655,0.6536631661087026,0.15283115965933336
5102,1732219998,1732220247,249,0.9921320838783445,3.3673086668170447,0.4925959493956593,0.5211850707485786
5103,1732223598,1732226530,2932,1.784902070985558,4.668336796063339,0.726397225779725,0.6910520518837586
5104,1732227198,1732230798,3600,0.45000333430362083,3.002070348125068,0.1,0.1
5105,1732230798,1732234398,3600,0.46838080180038866,3.1995783975282723,0.1,0.1
5106,1732234398,1732236470,2072,2.126546391087186,4.56888495577971,0.6862882121568551,0.9439081323444928
5107,1732237998,1732241598,3600,0.1746760339659374,3.052546161242333,0.1,0.1
5108,1732241598,1732243731,2133,1.7063905904344208,4.698705689813817,0.5263336621130283,0.21851173893666737
5109,1732245198,1732248798,3600,0.47969265421088625,3.0980632700847472,0.1,0.1
5110,1732248798,1732249913,1115,1.4326625844515144,3.884799524818268,0.46541525496200986,0.2578249620647175
5111,1732252398,1732254369,1971,2.0694924621721715,4.4348981000475,0.27759979848924077,0.8455605516121638
5112,1732255998,1732259598,3600,0.3944059397325296,3.1161167516787334,0.1,0.1
5113,1732259598,1732259770,172,0.9796598816285143,3.533475897897881,0.6720917343635714,0.2554717649073765
5114,1732263198,1732266798,3600,0.43851436616043316,3.1680164323613536,0.1,0.1
5115,1732266798,1732267935,1137,1.315558578733838,4.017207500852624,0.12628594795786116,0.7811628926966129
5116,1732270398,1732272243,1845,1.8040016450662923,4.376565867288606,0.6312057340493428,0.3329401477445718
5117,1732273998,1732277598,3600,0.11958371786582722,3.1146313423430634,0.1,0.1
5118,1732277598,1732280608,3010,2.018197363861367,4.6806502675746,0.34383261415746386,0.27238669075889044
5119,1732281198,1732283171,1973,2.1482428529667814,4.511230619362533,0.49572311331023833,0.5309904423036952
5120,1732284798,1732288398,3600,0.23683165598433834,3.163223280686712,0.1,0.1
5121,1732288398,1732291998,3600,0.13049776066012286,3.0699543519047063,0.1,0.1
5122,1732291998,1732295598,3600,0.10173539719116312,3.094601371623144,0.1,0.1
5123,1732295598,1732299198,3600,0.23021184097318664,3.0386902497335178,0.1,0.1
5124,1732299198,1732302798,3600,0.33926800155181003,3.1732743054935293,0.1,0.1
5125,1732302798,1732303184,386,0.8383361955523849,3.3184534450876173,0.21133813247563243,0.3387616565417747
5126,1732306398,1732309998,3600,0.25592752583312206,3.0435431369146775,0.1,0.1
5127,1732309998,1732313598,3600,0.39595393760267095,3.1507636877904694,0.1,0.1
5128,1732313598,1732316708,3110,1.9993946054223493,4.334803464473604,0.9948117781280582,0.24398482227911153
5129,1732317198,1732320798,3600,0.2999378170594007,3.0469674257335835,0.1,0.1
5130,1732320798,1732322699,1901,2.2009690144438494,4.527180439254511,0.27945668204732155,0.975804204703161
5131,1732324398,1732325025,627,1.0734422958722736,3.867683473592999,0.3079412466817125,0.11476847655808353
5132,1732327998,1732331598,3600,0.48693035416177866,3.123310083876687,0.1,0.1
5133,1732331598,1732334056,2458,1.766767429773624,4.678938580811616,0.4049652433898284,0.3510891484077654
5134,1732335198,1732338798,3600,0.3287931058363657,3.1163915313748687,0.1,0.1
5135,1732338798,1732342398,3600,0.28822389846667185,3.1812387370320403,0.1,0.1
5136,1732342398,1732345998,3600,0.4431051719891712,3.086065294684483,0.1,0.1
5137,1732345998,1732349598,3600,0.47662053211528677,3.183654347344321,0.1,0.1
5138,1732349598,1732353198,3600,0.21482008941739564,3.1535659697416074,0.1,0.1
5139,1732353198,1732356798,3600,0.36382667740963726,3.1675084541257017,0.1,0.1
5140,1732356798,1732360398,3600,0.23530072506115604,3.172002244685624,0.1,0.1
5141,1732360398,1732360589,191,0.7621273753832474,3.3599224437264645,0.5321787476237457,0.5931174129442337
5142,1732363998,1732364698,700,1.325388372774725,3.953432388762836,0.14946010091323136,0.3710650039428751
5143,1732367598,1732371198,3600,0.2972262820574151,3.0052956406225513,0.1,0.1
5144,1732371198,1732374798,3600,0.4969255590834317,3.1099181449987494,0.1,0.1
5145,1732374798,1732377526,2728,2.3878054999001446,4.385276167426743,0.9164030585913305,0.624216154508699
5146,1732378398,1732381998,3600,0.4701073443524779,3.1897055352060892,0.1,0.1
5147,1732381998,1732385598,3600,0.28273514450119297,3.100039562130619,0.1,0.1
5148,1732385598,1732389198,3600,0.4709754538523201,3.160833246913946,0.1,0.1
5149,1732389198,1732392798,3600,0.45683102868794545,3.1536167435597995,0.1,0.1
5150,1732392798,1732396398,3600,0.1617419067799471,3.0294420512145104,0.1,0.1
5151,1732396398,1732399998,3600,0.4656543250390818,3.123253261407839,0.1,0.1
5152,1732399998,1732400847,849,1.3697929560974886,4.140585464972124,0.20556082619645827,0.5344078720177413
5153,1732403598,1732407110,3512,1.9749195006008444,4.453419187877264,0.7774673719727876,0.9530164996373037
5154,1732407198,1732410798,3600,0.12187741054138486,3.0528564770961273,0.1,0.1
5155,1732410798,1732413106,2308,2.466742067594299,4.40793667361266,0.709445172525956,0.9391295369336912
5156,1732414398,1732417998,3600,0.4310184095661902,3.134927480568971,0.1,0.1
5157,1732417998,1732421598,3600,0.11049041976299288,3.1333938613179613,0.1,0.1
5158,1732421598,1732425198,3600,0.33287926559776226,3.0903969000371787,0.1,0.1
5159,1732425198,1732428798,3600,0.30971012551629973,3.1312510959440294,0.1,0.1
5160,1732428798,1732432317,3519,1.6747141127318441,4.443552066752551,0.6838899887586143,0.7806810673138628
5161,1732432398,1732433399,1001,1.4127107302951494,3.9748465937826882,0.23562916172688564,0.7106949045786559
5162,1732435998,1732439598,3600,0.38080912666912237,3.037487910906744,0.1,0.1
5163,1732439598,1732443198,3600,0.11803336857085123,3.1269009127688934,0.1,0.1
5164,1732443198,1732443673,475,0.7196486346108865,3.6862109396621037,0.33850756151766326,0.17832406910097048
5165,1732446798,1732450398,3600,0.17514152411749545,3.0206458221036745,0.1,0.1
5166,1732450398,1732453998,3600,0.16913345530475676,3.0428088677094762,0.1,0.1
5167,1732453998,1732456924,2926,2.3119260725164477,4.585697307156079,0.8341187405342103,0.2935157060710515
5168,1732457598,1732459020,1422,1.1796332534008558,3.960074680054195,0.36963902063221865,0.920356777761351
5169,1732461198,1732464798,3600,0.35722820638470854,3.1799268560742684,0.1,0.1
5170,1732464798,1732465258,460,0.9828775653341641,3.4548285382983894,0.4922774701933814,0.16228358620935662
5171,1732468398,1732471998,3600,0.4025559126017898,3.096367961625559,0.1,0.1
5172,1732471998,1732475598,3600,0.1001127616648946,3.1093895658725774,0.1,0.1
5173,1732475598,1732476387,789,1.1904365562957753,3.8853005980095197,0.17929506348563165,0.5437205999283472
5174,1732479198,1732479778,580,0.929859699109516,3.625203744455777,0.6631044572455732,0.4704463404551077
5175,1732482798,1732486398,3600,0.1734362444320933,3.078200616870532,0.1,0.1
5176,1732486398,1732487123,725,1.0917737167358026,4.052939900259683,0.7841010843296652,0.49817461984938516
5177,1732489998,1732492898,2900,1.82846462342026,4.4356159601461655,0.2720951358181305,0.6256483813836149
5178,1732493598,1732493689,91,0.5984867616981495,3.3517133136513566,0.799135464075918,0.5422471947077083
5179,1732497198,1732500798,3600,0.3301956689478036,3.0883683691512314,0.1,0.1
5180,1732500798,1732504398,3600,0.4183866249057907,3.0825091846396737,0.1,0.1
5181,1732504398,1732504968,570,0.8421127501390382,3.3253118225469374,0.9234792837677133,0.5429379430405864
5182,1732507998,1732511598,3600,0.3699075228658735,3.1828717745488064,0.1,0.1
5183,1732511598,1732515198,3600,0.43596867710130927,3.07547156451669,0.1,0.1
5184,1732515198,1732518798,3600,0.23947402618783015,3.0535565668451934,0.1,0.1
5185,1732518798,1732521591,2793,1.8447046037585468,4.415251384654224,0.2785250224606345,0.13809099210577497
5186,1732522398,1732523635,1237,1.2878395568423602,4.125920392737451,0.3587835304213768,0.24944363068204942
5187,1732525998,1732529598,3600,0.48789456545313215,3.0699776180035725,0.1,0.1
5188,1732529598,1732532589,2991,1.8652670911556766,4.654894670846526,0.7129388340550913,0.5159576271228653
5189,1732533198,1732535559,2361,1.8970488338776745,4.5372910387262095,0.8457161921994107,0.9128475686312225
5190,1732536798,1732540398,3600,0.45915248074900683,3.030496640761864,0.1,0.1
5191,1732540398,1732541596,1198,1.195268186635706,3.8737733748625156,0.7225477489289244,0.2629174620287598
5192,1732543998,1732544513,515,0.9544568485921308,3.6402898798804273,0.1797876667436788,0.9047477827093507
5193,1732547598,1732548775,1177,1.0053698844682364,3.8183023419391935,0.8321012676946389,0.4002046976345368
5194,1732551198,1732554322,3124,2.1775238003349378,4.331887469820083,0.11401799400236412,0.7703531453201307
5195,1732554798,1732555250,452,0.8942405468721892,3.3253219119713973,0.4188131512272205,0.7002567088103107
5196,1732558398,1732559354,956,1.3248826499472455,4.166337873453579,0.9967975713737911,0.35457507307251424
5197,1732561998,1732565598,3600,0.4332418235380672,3.0926935084162435,0.1,0.1
5198,1732565598,1732568779,3181,1.9792082328679004,4.421156347615131,0.91426791887802,0.1679587934583579
5199,1732569198,1732572798,3600,0.45573443989552964,3.172872566408835,0.1,0.1
5200,1732572798,1732575701,2903,2.3108514653139967,4.365157549567238,0.9437140068415242,0.36928688112824726
5201,1732576398,1732579234,2836,1.5322062854849423,4.588728642310535,0.9100978693934679,0.41405668651700345
5202,1732579998,1732583598,3600,0.13923031666374286,3.137866729254043,0.1,0.1
5203,1732583598,1732585397,1799,1.3887618139366236,3.82481448920483,0.6154532548065952,0.2960495798645629
5204,1732587198,1732588486,1288,1.1699612902465577,3.8686284819440293,0.858686416356385,0.7719351989702458
5205,1732590798,1732594398,3600,0.46100922374655573,3.031090996462811,0.1,0.1
5206,1732594398,1732597998,3600,0.28833717588137053,3.074256897577607,0.1,0.1
5207,1732597998,1732601598,3600,0.18155403638619189,3.07269991096039,0.1,0.1
5208,1732601598,1732602807,1209,1.1374622973788147,3.9720523918941484,0.8397545063891405,0.8357612948693973
5209,1732605198,1732608798,3600,0.1190238216591447,3.1862448854239305,0.1,0.1
5210,1732608798,1732610175,1377,1.0658490483350442,4.070328508263888,0.6398200257062522,0.410813341086256
5211,1732612398,1732615998,3600,0.2912436779719364,3.05303110769958,0.1,0.1
5212,1732615998,1732619402,3404,1.688359730237869,4.658535486566367,0.21071878571480446,0.465549069748705
5213,1732619598,1732623198,3600,0.4940046469685131,3.0049862664650617,0.1,0.1
5214,1732623198,1732626798,3600,0.3606547763710197,3.123475092892206,0.1,0.1
5215,1732626798,1732628292,1494,1.0993899872776782,4.045383504133698,0.6953565621067332,0.5601355940325032
5216,1732630398,1732632519,2121,2.1206453620331502,4.465783455149341,0.2725221142807463,0.40416988109107477
5217,1732633998,1732636152,2154,2.110907136621446,4.44896448696429,0.836551542305102,0.421501809852869
5218,1732637598,1732641198,3600,0.37481315865084086,3.149264926547941,0.1,0.1
5219,1732641198,1732644798,3600,0.2025140571143485,3.0881280503796393,0.1,0.1
5220,1732644798,1732647284,2486,1.666838427302471,4.581790202461252,0.5918638258410374,0.39469882312190874
5221,1732648398,1732651998,3600,0.2946182046168618,3.14050802869114,0.1,0.1
5222,1732651998,1732652762,764,1.1156401322130431,4.123290460471364,0.41662175319159844,0.7346132574146681
5223,1732655598,1732657325,1727,1.3321317317723702,3.843292046876467,0.8192235280992957,0.5417752286873615
5224,1732659198,1732659579,381,0.8774532638737698,3.5139394460061824,0.9510129698430314,0.3507173902226405
5225,1732662798,1732666134,3336,1.6892637391648568,4.430033404655939,0.37132128256576735,0.48339521379641814
5226,1732666398,1732669998,3600,0.32950403923578453,3.116775019236287,0.1,0.1
5227,1732669998,1732671661,1663,1.3247729195742632,3.984681105027385,0.32154868082058957,0.8362147345671544
5228,1732673598,1732674620,1022,1.1552859171914092,3.9229316132481356,0.1831171631793067,0.20203397655912303
5229,1732677198,1732680798,3600,0.373328658778481,3.0871348004455132,0.1,0.1
5230,1732680798,1732684224,3426,2.4796939969569554,4.305586696387322,0.8092039432590744,0.9833486417741153
5231,1732684398,1732687371,2973,2.4386965941066308,4.675147806560282,0.3812248447037715,0.5780101431765541
5232,1732687998,1732691598,3600,0.43376753795090484,3.158208305642612,0.1,0.1
5233,1732691598,1732693705,2107,2.403769335182212,4.576434126211159,0.37929836536296313,0.7025088859617552
5234,1732695198,1732698798,3600,0.27601340341026354,3.01842965429971,0.1,0.1
5235,1732698798,1732702398,3600,0.4180348417154557,3.041548779944499,0.1,0.1
5236,1732702398,1732703288,890,1.2917585172101982,3.8120600848114625,0.6856287382509676,0.3243863490743928
5237,1732705998,1732709241,3243,1.9913350852098164,4.328973505816963,0.9488477872273684,0.894383068092837
5238,1732709598,1732713198,3600,0.15818539836856793,3.019461048675021,0.1,0.1
5239,1732713198,1732714249,1051,1.0474468295067059,4.131067643116554,0.6844187847953402,0.7773351991128252
5240,1732716798,1732718178,1380,1.0219910870139075,4.0229155225613304,0.6462030115566415,0.8935860476424136
5241,1732720398,1732723998,3600,0.28482585528344895,3.053190857766875,0.1,0.1
5242,1732723998,1732727598,3600,0.21110473734403146,3.0082527153307725,0.1,0.1
5243,1732727598,1732731198,3600,0.21095896847236795,3.1206143910268316,0.1,0.1
5244,1732731198,1732732538,1340,1.4104089828628261,3.8257545831507622,0.42699884981235436,0.8192983132572993
5245,1732734798,1732737681,2883,2.4145047695043687,4.572056798854429,0.6026376695143987,0.11606251796136981
5246,1732738398,1732741998,3600,0.1303279998398006,3.0099366679950705,0.1,0.1
5247,1732741998,1732743638,1640,1.2068107863977233,4.036073589844137,0.7193679022306952,0.39864701029325833
5248,1732745598,1732748240,2642,1.9987194975512559,4.425410899736022,0.13232100795437837,0.9246140526035097
5249,1732749198,1732750778,1580,1.4022883394138264,4.069495337630703,0.8804787750521847,0.5326884912282158
5250,1732752798,1732754350,1552,1.2863481131422914,4.160179056745881,0.5626624467498689,0.22684922587769463
5251,1732756398,1732759998,3600,0.3584979206507214,3.0116321678610825,0.1,0.1
5252,1732759998,1732763598,3600,0.25409787591484423,3.190498117269842,0.1,0.1
5253,1732763598,1732764499,901,1.224076735775197,3.970774808880046,0.6702690082618822,0.48819525022903354
5254,1732767198,1732767770,572,0.7927629062354453,3.5245813796206695,0.9669326317733749,0.21959546856546255
5255,1732770798,1732773249,2451,2.023655805280909,4.503219832141197,0.2728038363727856,0.5335909591047323
5256,1732774398,1732777998,3600,0.46104774642153246,3.1314325730343224,0.1,0.1
5257,1732777998,1732779491,1493,1.3581721591883633,3.800466445662171,0.9626807585650665,0.6548587131158247
5258,1732781598,1732785036,3438,1.7754707742977678,4.534838818485633,0.2859608399225404,0.8088996368345438
5259,1732785198,1732788022,2824,1.5208374747897604,4.698487897055947,0.6793544807840726,0.14492238123166157
5260,1732788798,1732789779,981,1.4684362162811957,4.175857977156651,0.6403192985795794,0.16077017002108807
5261,1732792398,1732795998,3600,0.2622191345497425,3.1362853544212457,0.1,0.1
5262,1732795998,1732796194,196,0.703735913850751,3.6828441623153063,0.7514658307960748,0.6521118039040684
5263,1732799598,1732801853,2255,2.379700178660808,4.372831132655387,0.5987055709697477,0.9032305736337001
5264,1732803198,1732806798,3600,0.11637415623401909,3.0274224729622885,0.1,0.1
5265,1732806798,1732810398,3600,0.41676970883172004,3.143973148916303,0.1,0.1
5266,1732810398,1732810567,169,0.5499080923505013,3.4295985654039645,0.6527940907090506,0.9758606942667668
5267,1732813998,1732816851,2853,1.8217824725227694,4.634480069084796,0.7019136345759028,0.5949145108578439
5268,1732817598,1732820533,2935,1.7237683012743656,4.367800619454006,0.7881975437913151,0.718980951111271
5269,1732821198,1732822007,809,1.196139616858855,4.038439856539092,0.8191960452831883,0.49191802981056754
5270,1732824798,1732825890,1092,1.2375075163969314,4.072289262489884,0.8413461743548468,0.220212038717979
5271,1732828398,1732831207,2809,1.5138247372755824,4.5157681699677825,0.37101778394551754,0.4599566712805434
5272,1732831998,1732834398,2400,1.7000323089852372,4.500520071177636,0.4821971174813875,0.1620945707773622
5273,1732835598,1732839198,3600,0.13011771623629476,3.1556360002862345,0.1,0.1
5274,1732839198,1732840454,1256,1.1451901079352833,4.111925642313795,0.25196343899052775,0.7330739486783049
5275,1732842798,1732846398,3600,0.42871353236207965,3.048428108277595,0.1,0.1
5276,1732846398,1732849998,3600,0.19786970570762774,3.052300840522282,0.1,0.1
5277,1732849998,1732853598,3600,0.21535998400139997,3.15695766297561,0.1,0.1
5278,1732853598,1732857161,3563,1.5882036292503714,4.400498434948679,0.7068553060983576,0.5027783146612862
5279,1732857198,1732860798,3600,0.4506735895897336,3.194109512602846,0.1,0.1
5280,1732860798,1732864398,3600,0.38152103146714034,3.031481650287985,0.1,0.1
5281,1732864398,1732867998,3600,0.12749236318098808,3.172859826228446,0.1,0.1
5282,1732867998,1732871598,3600,0.3063277501614184,3.0988924425848103,0.1,0.1
5283,1732871598,1732875198,3600,0.47843392801838647,3.10686548172159,0.1,0.1
5284,1732875198,1732878798,3600,0.14995858295220585,3.1447813578815973,0.1,0.1
5285,1732878798,1732881157,2359,1.8671567780430427,4.4123407732543205,0.6680806932890968,0.24542407196071686
5286,1732882398,1732884941,2543,2.267283918778325,4.5017511682649545,0.9224553582184959,0.5590931314068219
5287,1732885998,1732889598,3600,0.17029326201434172,3.0340069866677704,0.1,0.1
5288,1732889598,1732893198,3600,0.3483132049664941,3.1952735768576233,0.1,0.1
5289,1732893198,1732893711,513,0.5513034553625917,3.5934475592152375,0.778757551596986,0.2723501031480585
5290,1732896798,1732899017,2219,2.0257284152738118,4.654372310602358,0.5480286339895384,0.738196811375672
5291,1732900398,1732901610,1212,1.2244402167834578,3.873639141992,0.8844677923462622,0.5795649834965267
5292,1732903998,1732907598,3600,0.26371052196153855,3.0229896290663887,0.1,0.1
5293,1732907598,1732911198,3600,0.48658736467417096,3.046265115537695,0.1,0.1
5294,1732911198,1732914798,3600,0.4492946683217305,3.0521950362906667,0.1,0.1
5295,1732914798,1732918398,3600,0.3746622884778331,3.0540129959329345,0.1,0.1
5296,1732918398,1732919960,1562,1.4299672269857855,4.14892379221281,0.478607317292576,0.8543169879328177
5297,1732921998,1732924820,2822,1.8075700636650955,4.496160231547433,0.8020982132265284,0.1393027219984922
5298,1732925598,1732929198,3600,0.4796764957884896,3.0001369342973634,0.1,0.1
5299,1732929198,1732932798,3600,0.12295495615672447,3.150135627731288,0.1,0.1
5300,1732932798,1732935501,2703,1.7169617842142924,4.527051370696834,0.524328874987672,0.73881559881942
5301,1732936398,1732939998,3600,0.16942096822325917,3.1073255116602456,0.1,0.1
5302,1732939998,1732943598,3600,0.242371211935805,3.1050324720609312,0.1,0.1
5303,1732943598,1732947186,3588,2.107274312137234,4.588066275799327,0.27552786921877803,0.8997973764733707
5304,1732947198,1732950798,3600,0.3235193106012265,3.0898188362813226,0.1,0.1
5305,1732950798,1732954398,3600,0.44054032824136713,3.005897985134567,0.1,0.1
5306,1732954398,1732955565,1167,1.145796328976715,3.9944113943702284,0.4999208284231069,0.7540798750133928
5307,1732957998,1732961346,3348,2.0936920854166328,4.657636156826504,0.21097538698990193,0.4857064766533319
5308,1732961598,1732963203,1605,1.434328884340633,4.180028235924651,0.8088986097662458,0.7303840370043213
5309,1732965198,1732967286,2088,2.3288566806222097,4.581576756808819,0.5458133868071968,0.982776689143024
5310,1732968798,1732971023,2225,1.7923554692941974,4.5152429591109176,0.2404280546285493,0.48729826949040866
5311,1732972398,1732973563,1165,1.0596034879379006,3.8096298447222847,0.9638341912970568,0.32167160122215366
5312,1732975998,1732979598,3600,0.4284133578980882,3.098995215264286,0.1,0.1
5313,1732979598,1732981102,1504,1.016003923574025,4.111878415211121,0.1945177282821414,0.47030962115458674
5314,1732983198,1732984449,1251,1.266660573405025,3.870974097420109,0.3506742496265476,0.6401737624863202
5315,1732986798,1732990185,3387,2.267051523492205,4.454025933964946,0.2309852500818911,0.5728706443837516
5316,1732990398,1732993982,3584,2.0140771499999137,4.529623376812153,0.6308845209766936,0.1722548033668168
5317,1732993998,1732995104,1106,1.025086690730712,4.068382191651446,0.9056750867610859,0.6149108161457244
5318,1732997598,1732997778,180,0.8455115033200424,3.5488252889209653,0.6507777533779807,0.1578747965371627
5319,1733001198,1733004798,3600,0.3360734837764211,3.1648318676740375,0.1,0.1
5320,1733004798,1733008398,3600,0.33489278759773644,3.108569939725838,0.1,0.1
5321,1733008398,1733010225,1827,1.6532549952711653,4.343090081523551,0.2411749216381406,0.6902865012936688
5322,1733011998,1733012139,141,0.9486170471565214,3.544892127169538,0.19623059284023076,0.7276805083621264
5323,1733015598,1733018793,3195,2.1089620793868837,4.6402219955100215,0.7527707084359738,0.9379908536870852
5324,1733019198,1733022798,3600,0.1919457582112692,3.1523692348371277,0.1,0.1
5325,1733022798,1733026398,3600,0.38288687870505855,3.054481948225587,0.1,0.1
5326,1733026398,1733029998,3600,0.24314344260503518,3.0038844768449278,0.1,0.1
5327,1733029998,1733033584,3586,2.110849638348992,4.314737643695071,0.25384624418633034,0.49059447179478977
5328,1733033598,1733037198,3600,0.33284154491476214,3.0747122931339965,0.1,0.1
5329,1733037198,1733038707,1509,1.0422447317658345,3.9904167587390473,0.8450240053318655,0.7433385182192658
5330,1733040798,1733044398,3600,0.12586548868446068,3.1487571457424157,0.1,0.1
5331,1733044398,1733046614,2216,2.2636376967980856,4.677983482762947,0.7473793893140737,0.9905422027155624
5332,1733047998,1733048994,996,1.4374108869657065,3.882334801210622,0.4834997047699079,0.6250762914062257
5333,1733051598,1733053602,2004,1.5390488827249085,4.510962343511383,0.5555289621628873,0.4012165971671644
5334,1733055198,1733058798,3600,0.12696861725298741,3.0186445209326966,0.1,0.1
5335,1733058798,1733062398,3600,0.2979275346631012,3.0203324026745393,0.1,0.1
5336,1733062398,1733065998,3600,0.4806242177352653,3.047166173456077,0.1,0.1
5337,1733065998,1733066379,381,0.9502422368603403,3.4172987010126534,0.9902533916056097,0.9536472051853918
5338,1733069598,1733070698,1100,1.0544684785783593,3.8979890356176994,0.6658770372051375,0.858933539813335
5339,1733073198,1733076798,3600,0.24926124061491275,3.0890000499943215,0.1,0.1
5340,1733076798,1733080010,3212,1.7737373308406263,4.647157804943556,0.7124919315900047,0.4451512198966785
5341,1733080398,1733083998,3600,0.44687707566154433,3.19115678137056,0.1,0.1
5342,1733083998,1733087598,3600,0.16786377840847655,3.1113378180638835,0.1,0.1
5343,1733087598,1733090206,2608,1.5185438261713806,4.543807176893617,0.749427466316163,0.9595559697725045
5344,1733091198,1733094798,3600,0.10458865709100046,3.197388814306619,0.1,0.1
5345,1733094798,1733096384,1586,1.1658003141941657,3.8870488692690963,0.3315531016620132,0.3848124106501277
5346,1733098398,1733101790,3392,1.6925624692993748,4.303432526883286,0.5219882456244561,0.4523471231124969
5347,1733101998,1733105598,3600,0.3895699164805758,3.1860178548081945,0.1,0.1
5348,1733105598,1733108699,3101,1.678289992412982,4.323986370949785,0.5391760184715845,0.7423231364604632
5349,1733109198,1733110205,1007,1.067902583439778,4.0928099288916036,0.5829858967067111,0.7554712635327154
5350,1733112798,1733116398,3600,0.3352179873181561,3.073874422616018,0.1,0.1
5351,1733116398,1733119998,3600,0.4251228147822843,3.001546167374371,0.1,0.1
5352,1733119998,1733123044,3046,2.209166862002533,4.513409970569578,0.27710682201624987,0.35454584341755646
5353,1733123598,1733127198,3600,0.40692964045090385,3.0085673195092717,0.1,0.1
5354,1733127198,1733130798,3600,0.3918551795031249,3.074678954086693,0.1,0.1
5355,1733130798,1733134398,3600,0.3395498513082973,3.029536263571305,0.1,0.1
5356,1733134398,1733137998,3600,0.35193174337861066,3.1585141418022604,0.1,0.1
5357,1733137998,1733141598,3600,0.47438136363151107,3.1191313098268165,0.1,0.1
5358,1733141598,1733144322,2724,1.7504946168783677,4.524438644347422,0.6627910434439164,0.9215845905375849
5359,1733145198,1733148798,3600,0.4786924275567116,3.134127476778683,0.1,0.1
5360,1733148798,1733151412,2614,1.5205562265875525,4.447241438416215,0.9572906649841167,0.9294989129684583
5361,1733152398,1733155998,3600,0.2277687489568955,3.018305541271357,0.1,0.1
5362,1733155998,1733159598,3600,0.28966557009014166,3.1855001774051614,0.1,0.1
5363,1733159598,1733163198,3600,0.3813505026298297,3.078016768255589,0.1,0.1
5364,1733163198,1733166798,3600,0.23312951074823485,3.068127642450033,0.1,0.1
5365,1733166798,1733169954,3156,2.010030111072683,4.591050112144692,0.2120253753220686,0.7023589916882352
5366,1733170398,1733173045,2647,2.020909522411711,4.619600369862682,0.6344723895523574,0.856690750933123
5367,1733173998,1733177598,3600,0.22168574243660166,3.1951294185072996,0.1,0.1
5368,1733177598,1733178582,984,1.333610776520721,4.143222451999826,0.20453121912869704,0.8034738625801735
5369,1733181198,1733184245,3047,1.9523177514874972,4.483253039630795,0.5215480954451447,0.5275451679853884
5370,1733184798,1733188398,3600,0.3442763470033475,3.02113333120802,0.1,0.1
5371,1733188398,1733188720,322,0.7144887449214641,3.384876620111729,0.8018597219673542,0.5778344113343733
5372,1733191998,1733195598,3600,0.25250598099091254,3.030304318404604,0.1,0.1
5373,1733195598,1733197841,2243,1.6902539217190522,4.665192482202117,0.12622839081882256,0.3693612876618747
5374,1733199198,1733202798,3600,0.2929844676259318,3.0853311648881454,0.1,0.1
5375,1733202798,1733205841,3043,1.8861154132405553,4.636242226078532,0.8301804111961875,0.6889831022061499
5376,1733206398,1733207248,850,1.1388948397758925,3.9679983903057803,0.7328911556720584,0.7170890003386954
5377,1733209998,1733211102,1104,1.185858315342136,3.805851711848571,0.30345931353023076,0.9293383780640467
5378,1733213598,1733217198,3600,0.4632522061072196,3.1042809437974404,0.1,0.1
5379,1733217198,1733218716,1518,1.0956772483048645,4.168448558233532,0.3384683071511114,0.16049093746075432
5380,1733220798,1733224398,3600,0.12282038510817671,3.1008809780308417,0.1,0.1
5381,1733224398,1733227998,3600,0.3879601919526682,3.1059119580934884,0.1,0.1
5382,1733227998,1733231437,3439,2.413810653195069,4.422544794924438,0.4638733508109374,0.3703652467725995
5383,1733231598,1733232650,1052,1.2790008240580857,3.8748795213633596,0.7426164718497941,0.5430934419989928
5384,1733235198,1733238798,3600,0.24330243910134453,3.156730022634054,0.1,0.1
5385,1733238798,1733242398,3600,0.30955368004917416,3.145605479839509,0.1,0.1
5386,1733242398,1733245998,3600,0.23392393128794642,3.1909822854412857,0.1,0.1
5387,1733245998,1733246559,561,0.7515020058459462,3.4210596530585264,0.9225231934369976,0.3767131774939281
5388,1733249598,1733253198,3600,0.11596004462012358,3.143200923709031,0.1,0.1
5389,1733253198,1733253605,407,0.7684079397802506,3.4963143383582125,0.9499010472969525,0.7596744676234827
5390,1733256798,1733259515,2717,2.350904307854243,4.65361202131293,0.7120603912937647,0.7296712925203961
5391,1733260398,1733263998,3600,0.26518788388621084,3.127271625388261,0.1,0.1
5392,1733263998,1733267598,3600,0.19529410220147647,3.055985973748022,0.1,0.1
5393,1733267598,1733271198,3600,0.21623205420061165,3.0282287129734726,0.1,0.1
5394,1733271198,1733274798,3600,0.3249769249066179,3.032642925153192,0.1,0.1
5395,1733274798,1733275085,287,0.9670106149537019,3.3438268391045782,0.6328411478359255,0.8556415507734209
5396,1733278398,1733280563,2165,2.074813097306737,4.532637610020902,0.16275150442866265,0.42860492765307934
5397,1733281998,1733284801,2803,1.8491736872997468,4.374372290783401,0.2551206333543387,0.35183615513203115
5398,1733285598,1733286755,1157,1.4741283827550091,3.9770871478268672,0.8016706627284981,0.60644808497964
5399,1733289198,1733289582,384,0.5226243754870392,3.6335718041991605,0.957382301789088,0.9617496918543613
5400,1733292798,1733295630,2832,1.9805082021975653,4.5801614506119765,0.4662434037360663,0.2778847753626003
5401,1733296398,1733299998,3600,0.2148857907598894,3.0632926431004135,0.1,0.1
5402,1733299998,1733303304,3306,1.6635096819835178,4.571830410750193,0.13798314773604675,0.8164573052391221
5403,1733303598,1733307198,3600,0.1556314993160219,3.053935368759172,0.1,0.1
5404,1733307198,1733310798,3600,0.48703966913075225,3.083907252904033,0.1,0.1
5405,1733310798,1733314398,3600,0.38102896641052464,3.1627409006161367,0.1,0.1
5406,1733314398,1733317998,3600,0.4262307467102452,3.0838296287670213,0.1,0.1
5407,1733317998,1733321384,3386,1.6185442514182458,4.409881133320476,0.6772825211106359,0.49699999986663845
5408,1733321598,1733322684,1086,1.3431016394352795,4.002147736789602,0.5707467174165203,0.20813733960094855
5409,1733325198,1733328198,3000,1.783974103231147,4.467138194584863,0.9945124632112712,0.661309533241969
5410,1733328798,1733332398,3600,0.29260733571419617,3.0152505294473833,0.1,0.1
5411,1733332398,1733333000,602,1.2566568906231632,4.059442209766337,0.8328883643394214,0.33459114859433225
5412,1733335998,1733339378,3380,2.1559677955647554,4.377148016137073,0.41656102367080405,0.9952001098232104
5413,1733339598,1733343198,3600,0.4589350325703091,3.1037971318844995,0.1,0.1
5414,1733343198,1733345638,2440,2.362061564060882,4.307198918830566,0.2570945275178137,0.8546273787844599
5415,1733346798,1733350398,3600,0.22841713411744966,3.117636103848353,0.1,0.1
5416,1733350398,1733353998,3600,0.27727594365743435,3.1188899304646722,0.1,0.1
5417,1733353998,1733356335,2337,1.5328493405957224,4.392785339411959,0.8751097100114105,0.24501940270277883
5418,1733357598,1733359426,1828,1.5525423559211715,4.669572692659478,0.20408678812318964,0.9803158160434211
5419,1733361198,1733364798,3600,0.2065712814263687,3.1531819106731063,0.1,0.1
5420,1733364798,1733368398,3600,0.10428605966327953,3.147925655984741,0.1,0.1
5421,1733368398,1733371604,3206,1.6802877096547144,4.438680343276143,0.18905597266164503,0.4170122854544839
5422,1733371998,1733375598,3600,0.3826432115540529,3.058373982890627,0.1,0.1
5423,1733375598,1733379198,3600,0.3403726365396267,3.1873222747916112,0.1,0.1
5424,1733379198,1733380294,1096,1.0148416994935054,3.823117868391101,0.4571108337035088,0.11022795022678751
5425,1733382798,1733385751,2953,1.5775964260477144,4.576676302258787,0.49603285847539547,0.3044309142798065
5426,1733386398,1733389998,3600,0.2735753721542449,3.1713746939266363,0.1,0.1
5427,1733389998,1733390529,531,0.750271980151856,3.5442648058194557,0.7244936358422553,0.14805619793255242
5428,1733393598,1733397198,3600,0.28961749148478344,3.1742765494278697,0.1,0.1
5429,1733397198,1733398004,806,1.2265597040577765,4.1263692699054175,0.1962674504555899,0.3500177258331254
5430,1733400798,1733401459,661,1.1760717729867345,3.941734313143228,0.59277118034558,0.8781787003806916
5431,1733404398,1733404896,498,0.9374206154882034,3.452486004194567,0.7235170247753112,0.7370752994855203
5432,1733407998,1733411598,3600,0.204576178778144,3.128705424888704,0.1,0.1
5433,1733411598,1733412340,742,1.4857888614890808,4.071623535890207,0.6015465723428307,0.7964533457180513
5434,1733415198,1733418798,3600,0.34524870988198664,3.0005491105586644,0.1,0.1
5435,1733418798,1733422398,3600,0.27215534912915207,3.1543017521967345,0.1,0.1
5436,1733422398,1733424769,2371,1.6395539239945163,4.555171656532838,0.18457681882462143,0.7504392719139212
5437,1733425998,1733428653,2655,2.060189839027807,4.682557442313135,0.49967531613935023,0.7913053388855142
5438,1733429598,1733433198,3600,0.2981090637996342,3.069601468203909,0.1,0.1
5439,1733433198,1733436798,3600,0.3637549689308449,3.0845956677914677,0.1,0.1
5440,1733436798,1733440398,3600,0.16600214975889496,3.040624930761242,0.1,0.1
5441,1733440398,1733442515,2117,1.6729464091762694,4.505995267871829,0.5772789446021012,0.8385364199498814
5442,1733443998,1733447598,3600,0.43230791829483284,3.0545653536312236,0.1,0.1
5443,1733447598,1733449506,1908,1.6834564947520936,4.521305129103114,0.8983368843368824,0.23519373325705328
5444,1733451198,1733454798,3600,0.2806827476748889,3.07855945111537,0.1,0.1
5445,1733454798,1733456258,1460,1.092609752011567,3.94016427256083,0.4406487398205039,0.7948484995564004
5446,1733458398,1733458522,124,0.8102844261651909,3.4904693270248464,0.15781511882635874,0.39487117073502687
5447,1733461998,1733465598,3600,0.2183143088195205,3.180183362073194,0.1,0.1
5448,1733465598,1733468181,2583,1.811854237352569,4.621703202222493,0.19290852313137727,0.3662810363160933
5449,1733469198,1733472194,2996,1.6634577558594748,4.558170040584085,0.7816920249194949,0.39890589609663263
5450,1733472798,1733476184,3386,2.3871364862596938,4.445841350595325,0.42463215163262036,0.3354640689066151
5451,1733476398,1733479912,3514,2.2902363479202363,4.599807141975272,0.8837663492541028,0.7821252181446899
5452,1733479998,1733483598,3600,0.2442925446901716,3.0985633205064866,0.1,0.1
5453,1733483598,1733487198,3600,0.4184599543068891,3.194505799862812,0.1,0.1
5454,1733487198,1733490614,3416,2.092250042647059,4.681882456182516,0.6932431978214038,0.3775015018660858
5455,1733490798,1733494398,3600,0.49451531766306334,3.0281746558891407,0.1,0.1
5456,1733494398,1733497998,3600,0.25957185607134736,3.0598755637263966,0.1,0.1
5457,1733497998,1733500833,2835,2.3964014776266795,4.390343164431207,0.9362038783489182,0.23100777455524898
5458,1733501598,1733503109,1511,1.406767534710498,3.836193908926537,0.8352118393754538,0.5014515492158452
5459,1733505198,1733505599,401,0.6327772277476758,3.3228947968880522,0.3024611724173486,0.16171331373753228
5460,1733508798,1733512398,3600,0.15582377018521384,3.0445318654231093,0.1,0.1
5461,1733512398,1733513965,1567,1.1076987737543877,4.01453670924535,0.9274271579375133,0.101338526168057
5462,1733515998,1733519598,3600,0.40324857692743166,3.130462131519848,0.1,0.1
5463,1733519598,1733520044,446,0.7129723796293885,3.654871715041174,0.5879939687467196,0.6712742101693011
5464,1733523198,1733526798,3600,0.34967059020647373,3.165348148152049,0.1,0.1
5465,1733526798,1733530398,3600,0.36288098031638605,3.1934024180429446,0.1,0.1
5466,1733530398,1733533998,3600,0.3010791725975056,3.0604144774136266,0.1,0.1
5467,1733533998,1733537598,3600,0.15422648768697367,3.0103834827434075,0.1,0.1
5468,1733537598,1733539363,1765,1.1294295365681601,4.035472023581533,0.6252073437366102,0.9004149600389756
5469,1733541198,1733541822,624,1.2461935737160188,3.9185947334202527,0.6796082398472751,0.7506914478147096
5470,1733544798,1733545588,790,1.4935846166676463,4.159707635588237,0.12245312883321102,0.9596119989120981
5471,1733548398,1733551998,3600,0.3278874849146095,3.1002404061651054,0.1,0.1
5472,1733551998,1733555598,3600,0.39188392014616613,3.0256385936307537,0.1,0.1
5473,1733555598,1733559129,3531,1.6578369382067224,4.6995867502369,0.5512506605786215,0.5799360184836828
5474,1733559198,1733562706,3508,2.2015402374802893,4.468850143379769,0.12626477746716905,0.9827468731945671
5475,1733562798,1733566398,3600,0.15803696096991443,3.142304650941668,0.1,0.1
5476,1733566398,1733569998,3600,0.30409420332069836,3.1170553132159435,0.1,0.1
5477,1733569998,1733570667,669,1.3993940367070952,3.992091165810133,0.931752946990501,0.2095348506915119
5478,1733573598,1733575020,1422,1.2355513731939798,3.8145501479679256,0.6781733255240533,0.7042791207660892
5479,1733577198,1733580798,3600,0.4612198911081684,3.0808687303418343,0.1,0.1
5480,1733580798,1733584398,3600,0.12208640983765334,3.0883785878252525,0.1,0.1
5481,1733584398,1733587760,3362,2.399662936571519,4.4858588419289465,0.14192745567346157,0.12555311670417166
5482,1733587998,1733591598,3600,0.14427945131875633,3.036541474337357,0.1,0.1
5483,1733591598,1733595198,3600,0.2656124113606718,3.1256589541580175,0.1,0.1
5484,1733595198,1733598798,3600,0.13806980088069232,3.175148053341848,0.1,0.1
5485,1733598798,1733602395,3597,2.2751718582767118,4.385389179518116,0.7100903626763552,0.9902399923821861
5486,1733602398,1733603636,1238,1.313217782825057,4.085732860394989,0.9173357607960919,0.7463394261620814
5487,1733605998,1733609347,3349,2.1784223515070913,4.371517133937779,0.930498537744505,0.8547474879571947
5488,1733609598,1733613198,3600,0.31202233070847424,3.06047074031518,0.1,0.1
5489,1733613198,1733616798,3600,0.3963815567700123,3.061489351071056,0.1,0.1
5490,1733616798,1733618812,2014,2.314021145103675,4.5258601235199745,0.4716629304214275,0.501644678625912
5491,1733620398,1733623998,3600,0.4046655651990846,3.1956791149363633,0.1,0.1
5492,1733623998,1733627598,3600,0.3195707301311264,3.0275341325055756,0.1,0.1
5493,1733627598,1733629668,2070,1.6335153124922581,4.606396320013716,0.6387573756735624,0.6820926286161455
5494,1733631198,1733633595,2397,2.1559182688946876,4.514800903345935,0.5646270371037219,0.9772919568485774
5495,1733634798,1733636803,2005,2.1041554571409358,4.609127052006073,0.10126111366615206,0.5641964448242975
5496,1733638398,1733641998,3600,0.21215793309206493,3.0365284990892882,0.1,0.1
5497,1733641998,1733642108,110,0.8688147802342681,3.6950452821839823,0.9712196689066092,0.20701157654617872
5498,1733645598,1733646747,1149,1.3285799694591267,3.9798285258123194,0.9213694242032665,0.12354548975202921
5499,1733649198,1733649956,758,1.041466692634438,3.9551075051299978,0.5320296964400103,0.39617923162226476
5500,1733652798,1733656398,3600,0.4670801885978998,3.005670106178401,0.1,0.1
5501,1733656398,1733659998,3600,0.2241634037595306,3.0115045680671124,0.1,0.1
5502,1733659998,1733663397,3399,2.058208274473004,4.403031155380459,0.2810094000699518,0.833919259315021
5503,1733663598,1733667019,3421,1.7847306837995225,4.391020018828801,0.6121522732041265,0.1798448142909142
5504,1733667198,1733670798,3600,0.4625242213342995,3.1312523173499804,0.1,0.1
5505,1733670798,1733673688,2890,2.2376082147836227,4.354008942858661,0.5887441893978009,0.4276693156939263
5506,1733674398,1733674964,566,0.9250860361608321,3.4453505016062063,0.937238364346886,0.325507593043587
5507,1733677998,1733681179,3181,1.9762877453931722,4.6409629452285195,0.16197092390433945,0.6267844697340756
5508,1733681598,1733683833,2235,1.6642999854796834,4.346535341453904,0.8194409393904232,0.4335700365005585
5509,1733685198,1733685705,507,0.5985171640779712,3.5752287399389053,0.9474545281643932,0.4984435886989178
5510,1733688798,1733692398,3600,0.1742659867354969,3.11457342532542,0.1,0.1
5511,1733692398,1733693747,1349,1.0792207948937764,4.1850064780348335,0.790633210668552,0.8295325520094018
5512,1733695998,1733699598,3600,0.3580526013984118,3.1699949975796904,0.1,0.1
5513,1733699598,1733701933,2335,2.361988933166155,4.640946524765757,0.5250122570824088,0.7222223821351743
5514,1733703198,1733706798,3600,0.18455185975613972,3.101629285443732,0.1,0.1
5515,1733706798,1733710398,3600,0.44605768365593346,3.054512851113661,0.1,0.1
5516,1733710398,1733713998,3600,0.1635053583985079,3.01732038989881,0.1,0.1
5517,1733713998,1733717598,3600,0.24181927510068088,3.1228536747973235,0.1,0.1
5518,1733717598,1733721198,3600,0.16318364343642525,3.0270640276006286,0.1,0.1
5519,1733721198,1733724798,3600,0.38205329195585747,3.0420930942674915,0.1,0.1
5520,1733724798,1733725987,1189,1.2834723626890496,3.8237719028182124,0.24922624802994198,0.7398698747747667
5521,1733728398,1733731786,3388,1.634337190670651,4.425123221440026,0.8650814712877775,0.4311166109298301
5522,1733731998,1733735598,3600,0.4451783906493858,3.1272734749378905,0.1,0.1
5523,1733735598,1733739198,3600,0.4338819697933387,3.105762657872428,0.1,0.1
5524,1733739198,1733742535,3337,2.4063985284712874,4.57487235484282,0.39116473258126205,0.3211947723588183
5525,1733742798,1733746398,3600,0.23743758679984928,3.0372563770994643,0.1,0.1
5526,1733746398,1733749998,3600,0.18416189488840998,3.041592513289537,0.1,0.1
5527,1733749998,1733753527,3529,1.6052978185696083,4.443078633053751,0.6710719797809146,0.8761075407086378
5528,1733753598,1733757114,3516,2.396765315525846,4.585628271921323,0.5055825480298126,0.30178023273598137
5529,1733757198,1733760798,3600,0.26983935576350726,3.0865429511780786,0.1,0.1
5530,1733760798,1733761090,292,0.7046074078976988,3.6632181752953197,0.2904287854787558,0.420408879799848
5531,1733764398,1733767998,3600,0.18102578301583916,3.091421189882067,0.1,0.1
5532,1733767998,1733771598,3600,0.34482973258666744,3.01904219990172,0.1,0.1
5533,1733771598,1733774463,2865,1.8201686985238559,4.6011242532156675,0.6903626610889065,0.4693178519902136
5534,1733775198,1733778798,3600,0.22305944051443466,3.176540713263809,0.1,0.1
5535,1733778798,1733782398,3600,0.21656048133002118,3.0293026718629057,0.1,0.1
5536,1733782398,1733785998,3600,0.3921697889548056,3.089378086279866,0.1,0.1
5537,1733785998,1733788841,2843,2.2283812328766492,4.3312113200111035,0.7791791170789943,0.4555996453137612
5538,1733789598,1733791040,1442,1.2462342097755466,3.8505427200666476,0.8450552421537132,0.11130023026773307
5539,1733793198,1733794779,1581,1.246471328692549,3.806629353848027,0.595252545262862,0.10542714762773192
5540,1733796798,1733799286,2488,2.071804497152963,4.5044630151450455,0.2825784375327393,0.9436759767465005
5541,1733800398,1733803998,3600,0.17073422005826905,3.196078772845939,0.1,0.1
5542,1733803998,1733805962,1964,2.1659271082565494,4.6905430354680595,0.3306359051129969,0.20382956564735621
5543,1733807598,1733810214,2616,2.422841453031028,4.3733439560648595,0.8700111525183323,0.9570952209002017
5544,1733811198,1733814798,3600,0.33961668908992393,3.1172782629081803,0.1,0.1
5545,1733814798,1733818398,3600,0.27884452437916796,3.1078969834458294,0.1,0.1
5546,1733818398,1733819717,1319,1.4329030226045567,3.9432848655653183,0.10679887817020303,0.21857530519591617
5547,1733821998,1733825598,3600,0.47012045050186513,3.142854008260065,0.1,0.1
5548,1733825598,1733829198,3600,0.47065461934049435,3.0635126406495394,0.1,0.1
5549,1733829198,1733832798,3600,0.49904408633511843,3.017627292529406,0.1,0.1
5550,1733832798,1733836398,3600,0.41761218844011483,3.0583577907087998,0.1,0.1
5551,1733836398,1733839355,2957,1.6715757647835607,4.388468661333895,0.36346187574212263,0.8089802621749348
5552,1733839998,1733843598,3600,0.2721358390838926,3.1714662805534255,0.1,0.1
5553,1733843598,1733847198,3600,0.2892109299144635,3.1446616646030234,0.1,0.1
5554,1733847198,1733850798,3600,0.28349240780442697,3.1386243847375614,0.1,0.1
5555,1733850798,1733854398,3600,0.2112922035744564,3.1458712052149322,0.1,0.1
5556,1733854398,1733855308,910,1.1506814129617073,3.921106237488278,0.46076212754368784,0.7324447849681834
5557,1733857998,1733861598,3600,0.1435478385646535,3.0884115146305855,0.1,0.1
5558,1733861598,1733863772,2174,1.6611406840959142,4.48259319337297,0.2462800287607145,0.381267666470975
5559,1733865198,1733865839,641,1.4424971585934516,3.867487214505754,0.8123727821300225,0.616141296340777
5560,1733868798,1733872398,3600,0.41443609952281624,3.032578609349611,0.1,0.1
5561,1733872398,1733875998,3600,0.21011250568877404,3.0279126321052865,0.1,0.1
5562,1733875998,1733879598,3600,0.49054955129470057,3.0559694874869616,0.1,0.1
5563,1733879598,1733880055,457,0.7834270234093639,3.693362083570083,0.5856649144791954,0.7500070711741005
5564,1733883198,1733886798,3600,0.15447251752418875,3.139598049715606,0.1,0.1
5565,1733886798,1733886948,150,0.7795550689968209,3.3479775642377305,0.24419176306513807,0.843596739932518
5566,1733890398,1733893998,3600,0.2428546925492004,3.0825123719074417,0.1,0.1
5567,1733893998,1733897598,3600,0.47459283072326286,3.121605638863553,0.1,0.1
5568,1733897598,1733898176,578,0.8241455705439892,3.3480117045297857,0.1119517054592079,0.47876609560830596
5569,1733901198,1733901890,692,1.094623006434058,3.8475573318268292,0.6659443329157494,0.1610560471240396
5570,1733904798,1733908398,3600,0.2846365526711391,3.1304781700312065,0.1,0.1
5571,1733908398,1733910149,1751,1.0708053944439282,3.9281093633440665,0.43735855627855635,0.6260322931895629
5572,1733911998,1733912295,297,0.7822890046325279,3.6515316172718792,0.9674686991327589,0.42535705615664277
5573,1733915598,1733919198,3600,0.20078325748881737,3.0154991932568636,0.1,0.1
5574,1733919198,1733919340,142,0.8257712959698025,3.5905211135123825,0.40060593631626606,0.7684315783855176
5575,1733922798,1733925631,2833,1.784913296980295,4.607092416097498,0.8180319365569806,0.3403218391325705
5576,1733926398,1733927449,1051,1.3419866887667335,4.011645991108269,0.8627935123441077,0.901955456981032
5577,1733929998,1733933598,3600,0.10727201870534767,3.193428646890375,0.1,0.1
5578,1733933598,1733933820,222,0.6062709082435007,3.6556438633902824,0.25804917944611605,0.8885248346055319
5579,1733937198,1733940798,3600,0.3779167564670828,3.1486710751692755,0.1,0.1
5580,1733940798,1733944398,3600,0.15651835147730325,3.1325479639716143,0.1,0.1
5581,1733944398,1733946439,2041,2.090646351336149,4.501093504685818,0.8660582575458892,0.19862557541612247
5582,1733947998,1733950545,2547,2.013789554553491,4.635999664753082,0.18519208264306536,0.4475576785504112
5583,1733951598,1733955198,3600,0.3911358253035301,3.05247382527709,0.1,0.1
5584,1733955198,1733955945,747,1.1912039681944142,3.8645089581926118,0.2652680696826992,0.8571790797869906
5585,1733958798,1733960738,1940,1.7548454482114808,4.4167051467468434,0.4881350367845475,0.14577891485692296
5586,1733962398,1733963003,605,1.1732714556261434,4.156733426106914,0.48033501152406044,0.9330131624464104
5587,1733965998,1733966785,787,1.2869945265060885,3.9574809250766503,0.5116595843724199,0.453767265427228
5588,1733969598,1733972785,3187,2.0808198289765727,4.67710013873209,0.6177405491965141,0.8468475514430769
5589,1733973198,1733976798,3600,0.3345106374615131,3.1062305881362517,0.1,0.1
5590,1733976798,1733980398,3600,0.45526705583425986,3.1576677387268974,0.1,0.1
5591,1733980398,1733982714,2316,1.9327444686615283,4.358778346815121,0.5665836354071417,0.7165537893152888
5592,1733983998,1733987598,3600,0.36020144757301087,3.016062238317369,0.1,0.1
5593,1733987598,1733989431,1833,1.5372370327224814,4.602816727736696,0.8579216534928413,0.494437159232229
5594,1733991198,1733993032,1834,2.4203125667644962,4.478013924246304,0.3613621808636517,0.25912414239448633
5595,1733994798,1733998398,3600,0.43398524301419306,3.0340622492700184,0.1,0.1
5596,1733998398,1734001998,3600,0.22988069806599168,3.135406462798802,0.1,0.1
5597,1734001998,1734002402,404,0.7610386558342721,3.44270291641807,0.649175335814467,0.4085458931224262
5598,1734005598,1734009198,3600,0.1163031636764111,3.1881488122497657,0.1,0.1
5599,1734009198,1734012798,3600,0.3051630829700521,3.085275584992781,0.1,0.1
5600,1734012798,1734016398,3600,0.13596044378720823,3.0402986211483793,0.1,0.1
5601,1734016398,1734019838,3440,2.3930660142545817,4.674502801007788,0.7439909109700008,0.7588843691493723
5602,1734019998,1734023200,3202,2.1961528363245355,4.681838540131386,0.420660941299975,0.15744862255334405
5603,1734023598,1734024492,894,1.1050415741740938,4.1218081214102735,0.2500537533070039,0.36246384107358554
5604,1734027198,1734027420,222,0.7556314908052666,3.452581493955958,0.6372400220157083,0.3507431442126008
5605,1734030798,1734034398,3600,0.3941720185852041,3.051728749513369,0.1,0.1
5606,1734034398,1734037998,3600,0.4579007359237086,3.109068473521029,0.1,0.1
5607,1734037998,1734041598,3600,0.422635885163937,3.0076475752670255,0.1,0.1
5608,1734041598,1734045198,3600,0.3084875110591716,3.1644240593799617,0.1,0.1
5609,1734045198,1734048798,3600,0.23284119070930664,3.080294944232842,0.1,0.1
5610,1734048798,1734052398,3600,0.4920243355640709,3.0422204975046965,0.1,0.1
5611,1734052398,1734053961,1563,1.1778352330598336,4.149712286410292,0.39134114671989995,0.4506382065356045
5612,1734055998,1734057145,1147,1.1413879316216748,3.9757763559801202,0.6705268594316657,0.41424551193980774
5613,1734059598,1734063198,3600,0.23082750684435804,3.020220836279023,0.1,0.1
5614,1734063198,1734064425,1227,1.3062884398712626,3.993836470261102,0.4899073581979858,0.6616140879479921
5615,1734066798,1734068867,2069,2.3380818284362945,4.633600722826595,0.1755382751229223,0.750531398056932
5616,1734070398,1734073998,3600,0.28693618733562853,3.0787862343778327,0.1,0.1
5617,1734073998,1734074504,506,0.811040861006561,3.4500834716463915,0.9803832450879588,0.13289564946464266
5618,1734077598,1734081198,3600,0.34644396957926293,3.0941315315170295,0.1,0.1
5619,1734081198,1734081584,386,0.8394765049773006,3.315882643767197,0.28196276004540133,0.42448002248347416
5620,1734084798,1734088398,3600,0.20303816894950724,3.0578629006988827,0.1,0.1
5621,1734088398,1734091998,3600,0.1475821922620848,3.1618065398391715,0.1,0.1
5622,1734091998,1734093281,1283,1.142517607463229,3.831319285843441,0.10543724755958728,0.34578466706932637
5623,1734095598,1734098141,2543,1.6185003323285878,4.410327105712543,0.8618761305083683,0.7339386563623147
5624,1734099198,1734100065,867,1.101118532983666,4.047300610494225,0.21208963342086207,0.9682041034789513
5625,1734102798,1734106398,3600,0.32083941426550133,3.035688844333082,0.1,0.1
5626,1734106398,1734109144,2746,2.164156851800646,4.4749954805911285,0.11964799660212914,0.9081786844731319
5627,1734109998,1734113598,3600,0.27320277211590904,3.0351875251182667,0.1,0.1
5628,1734113598,1734115877,2279,1.561915695172091,4.391049044542678,0.8319796623830766,0.8018942868741111
5629,1734117198,1734120798,3600,0.32555821341988495,3.0716557139967513,0.1,0.1
5630,1734120798,1734121278,480,0.7155688357843975,3.5132138584895327,0.8134512116121745,0.7795640473451472
5631,1734124398,1734127998,3600,0.23128613931467756,3.1571152039605965,0.1,0.1
5632,1734127998,1734131598,3600,0.27932401352954606,3.0114371693316775,0.1,0.1
5633,1734131598,1734135198,3600,0.4258976830984663,3.1660224049297643,0.1,0.1
5634,1734135198,1734138798,3600,0.46123631037599566,3.0708366657436876,0.1,0.1
5635,1734138798,1734142398,3600,0.2384442722266802,3.1017338659564615,0.1,0.1
5636,1734142398,1734145998,3600,0.36560044936594494,3.1462241024137207,0.1,0.1
5637,1734145998,1734149598,3600,0.303690698566189,3.002087887940876,0.1,0.1
5638,1734149598,1734151119,1521,1.2574411814453916,3.97424489861463,0.6446987125536325,0.9165898937051384
5639,1734153198,1734154411,1213,1.437370453843449,4.0169949631404265,0.8703904843005421,0.9112255847429626
5640,1734156798,1734160398,3600,0.28106544390074606,3.0184181730014075,0.1,0.1
5641,1734160398,1734163998,3600,0.4447275366901112,3.122299546020322,0.1,0.1
5642,1734163998,1734165631,1633,1.402300631162171,4.0994559121437195,0.670995329083682,0.1467060179824072
5643,1734167598,1734169462,1864,1.6913612596470387,4.647647360985283,0.32145249527774966,0.7395787813393836
5644,1734171198,1734172902,1704,1.1874399408686553,3.877054785641775,0.5116560618372021,0.3449920053838742
5645,1734174798,1734178398,3600,0.48112014294237215,3.01211552157229,0.1,0.1
5646,1734178398,1734180629,2231,2.265134292898412,4.664645584419397,0.5744859124049788,0.7631291943682954
5647,1734181998,1734185598,3600,0.26176158001487804,3.1245220446384363,0.1,0.1
5648,1734185598,1734189198,3600,0.4092798644998369,3.1520923703770327,0.1,0.1
5649,1734189198,1734190470,1272,1.4178670670748819,4.130194652077929,0.29679181347995054,0.838439070337239
5650,1734192798,1734196176,3378,1.9338161957648996,4.425150431498727,0.21354113224628757,0.709853936617941
5651,1734196398,1734197583,1185,1.4373032920615767,4.084655421971701,0.609171598418473,0.47323218606520334
5652,1734199998,1734200222,224,0.8654919007413426,3.576964183753914,0.34472262638717077,0.5543737341885823
5653,1734203598,1734207198,3600,0.23612584706108009,3.0035178498630044,0.1,0.1
5654,1734207198,1734210195,2997,2.3359514217374775,4.528912182798331,0.590589202822081,0.15070715174828192
5655,1734210798,1734214194,3396,1.9897546772412915,4.371502424893844,0.3956801480518801,0.8343418193237353
5656,1734214398,1734217623,3225,2.4487303340960187,4.6291430958034425,0.18826882053057603,0.796301882550362
5657,1734217998,1734221598,3600,0.2964338041733373,3.1160483558896352,0.1,0.1
5658,1734221598,1734225198,3600,0.34763178483059376,3.01384174915852,0.1,0.1
5659,1734225198,1734228798,3600,0.3473393258371389,3.1918187767194723,0.1,0.1
5660,1734228798,1734229075,277,0.6132089785966504,3.602605169210391,0.6123989448369588,0.8927426083709535
5661,1734232398,1734235998,3600,0.3562890156652697,3.101129483938493,0.1,0.1
5662,1734235998,1734239598,3600,0.16879212312908268,3.0835288165053965,0.1,0.1
5663,1734239598,1734243198,3600,0.24321997299190865,3.0321595135653614,0.1,0.1
5664,1734243198,1734244411,1213,1.3663927371839264,3.9155458069871014,0.49458697912616245,0.21060064821055507
5665,1734246798,1734247947,1149,1.0674962404036745,3.9037366610175175,0.6583388827408252,0.777059299565879
5666,1734250398,1734251777,1379,1.3260827583993346,3.983431816770579,0.858414199185663,0.77607377221537
5667,1734253998,1734257598,3600,0.16352274940823947,3.052279769605522,0.1,0.1
5668,1734257598,1734258111,513,0.5119927505235402,3.6184997701324146,0.9034606800574229,0.4292821297771159
5669,1734261198,1734264798,3600,0.2510803620890667,3.0575797100902666,0.1,0.1
5670,1734264798,1734268398,3600,0.3193640338041335,3.1869573557747337,0.1,0.1
5671,1734268398,1734269137,739,1.1592591616276167,4.046353105774246,0.8800039331582218,0.5616355020689142
5672,1734271998,1734274907,2909,2.0820506534709065,4.611211237452453,0.5789811177283388,0.6848221802953308
5673,1734275598,1734279198,3600,0.1704772086514458,3.0278328530771765,0.1,0.1
5674,1734279198,1734281899,2701,1.698086610750802,4.368283875269808,0.6570245827617993,0.1866100368548974
5675,1734282798,1734286398,3600,0.15176413193496116,3.0469311761233895,0.1,0.1
5676,1734286398,1734288160,1762,1.3625851083212546,4.0305379060726985,0.7435844731464183,0.672468828999178
5677,1734289998,1734293232,3234,2.4878960829539456,4.422285361947619,0.2574615401778729,0.8314487696687
5678,1734293598,1734296334,2736,2.1926468219624775,4.583571989785702,0.3962881956842337,0.9036431822094032
5679,1734297198,1734300152,2954,1.5450215186017107,4.664481323004548,0.7088256442410573,0.7457413888827583
5680,1734300798,1734302792,1994,1.704268272501265,4.548536961657163,0.2763930025351923,0.4281777226165
5681,1734304398,1734304633,235,0.8834742317449321,3.442935295850144,0.9679245948746938,0.9171262145855446
5682,1734307998,1734311598,3600,0.38626271651067257,3.0718222133727138,0.1,0.1
5683,1734311598,1734315198,3600,0.25138550641864044,3.133155571346739,0.1,0.1
5684,1734315198,1734317276,2078,2.051012708356824,4.483698526450782,0.7005098522746674,0.6228536009263407
5685,1734318798,1734321363,2565,2.4535806394224857,4.385634286776226,0.35340186489709957,0.8330998915534051
5686,1734322398,1734322647,249,0.7080165770797961,3.4400127860565597,0.20674928934627912,0.23523438999534657
5687,1734325998,1734327944,1946,2.3300422340245897,4.550555093116726,0.3696023369588046,0.364863666478329
5688,1734329598,1734331203,1605,1.2265750192173694,3.874497492145733,0.7436385325220589,0.28775256031682306
5689,1734333198,1734336798,3600,0.39068406307389125,3.1438287954078126,0.1,0.1
5690,1734336798,1734339667,2869,1.770904547723514,4.429742728814063,0.6349676047175108,0.7516697210282186
5691,1734340398,1734343998,3600,0.4977432620853657,3.083591867805731,0.1,0.1
5692,1734343998,1734347598,3600,0.2634876379450436,3.065792986590349,0.1,0.1
5693,1734347598,1734350167,2569,2.316089581220983,4.684167408631417,0.32374375260804356,0.12677781413451686
5694,1734351198,1734353129,1931,1.7272569080058124,4.525057626001227,0.3535949360163487,0.23321859340266127
5695,1734354798,1734356487,1689,1.2808666485886944,3.806976313081428,0.7863591109491647,0.7091547019835911
5696,1734358398,1734359367,969,1.2057680095473151,4.189485224285187,0.5975893294518144,0.9253656877926526
5697,1734361998,1734365598,3600,0.28322171108871963,3.181747113021058,0.1,0.1
5698,1734365598,1734369198,3600,0.43622901515461887,3.0467404791199417,0.1,0.1
5699,1734369198,1734372798,3600,0.20529045591969247,3.019476267244923,0.1,0.1
5700,1734372798,1734376398,3600,0.42043709165652776,3.0458856257771734,0.1,0.1
5701,1734376398,1734376467,69,0.7069852873504183,3.657618667741674,0.15297370717699968,0.4415311507591325
5702,1734379998,1734380389,391,0.9268192938030684,3.395717868573338,0.4356592650824408,0.9596957958038266
5703,1734383598,1734387049,3451,2.07894742167736,4.649403206344758,0.6277346203778478,0.6206638164309578
5704,1734387198,1734388606,1408,1.1252940526359134,4.0009106098389395,0.342687181274021,0.2643363450161059
5705,1734390798,1734394398,3600,0.1664807982197477,3.10069684779463,0.1,0.1
5706,1734394398,1734397998,3600,0.155567844696196,3.1956683114004614,0.1,0.1
5707,1734397998,1734401598,3600,0.28155570522596274,3.1292547202594454,0.1,0.1
5708,1734401598,1734403914,2316,2.4904244961766997,4.634758189203644,0.3384085887210562,0.8000826880582348
5709,1734405198,1734408798,3600,0.4233257021517334,3.159294189897391,0.1,0.1
5710,1734408798,1734411045,2247,1.866545410873108,4.448015664959279,0.7060282558180254,0.4496728124362076
5711,1734412398,1734415998,3600,0.23805146528365606,3.1034630621008117,0.1,0.1
5712,1734415998,1734418859,2861,2.409540538321026,4.687087896510382,0.7895935226480498,0.4567889300883219
5713,1734419598,1734421069,1471,1.4372144837270122,3.8885969778310807,0.5290955006969935,0.6412523623256129
5714,1734423198,1734426798,3600,0.4193583717025601,3.005054019436717,0.1,0.1
5715,1734426798,1734430393,3595,1.7845306159096403,4.36037086299838,0.9186147628656842,0.6540163785004699
5716,1734430398,1734431089,691,1.091586172096933,3.8648337974657863,0.8669693626200536,0.32377779346668967
5717,1734433998,1734437166,3168,2.4095120387305218,4.354217900124876,0.5514013005397467,0.7931155604075194
5718,1734437598,1734437664,66,0.6918025760832012,3.6081234510291953,0.9747286913784189,0.5818845510200269
5719,1734441198,1734443206,2008,2.2214905504035083,4.474967790681764,0.493599259986676,0.4787764753919437
5720,1734444798,1734445667,869,1.3541178366159339,4.079524150833797,0.611127166160816,0.8801421439426107
5721,1734448398,1734451998,3600,0.4967169405095514,3.148469003814479,0.1,0.1
5722,1734451998,1734455598,3600,0.2857430555981227,3.1662704148284146,0.1,0.1
5723,1734455598,1734458305,2707,2.2165635554813568,4.42397111431427,0.5479797442791933,0.9918611335298964
5724,1734459198,1734461185,1987,1.5271879439569498,4.417129722094055,0.18095359949322953,0.7824363870802399
5725,1734462798,1734466240,3442,2.4269173728406597,4.320902759663603,0.20936927384641402,0.2295286570969395
5726,1734466398,1734469998,3600,0.18564779156310227,3.1620335484168973,0.1,0.1
5727,1734469998,1734473598,3600,0.35626397741794924,3.1553671716465863,0.1,0.1
5728,1734473598,1734477198,3600,0.26522966621749244,3.1306257798868886,0.1,0.1
5729,1734477198,1734480343,3145,2.2880274012237303,4.303143523159038,0.5722645410229416,0.2139401758241587
5730,1734480798,1734484398,3600,0.23127656770654503,3.14720189729866,0.1,0.1
5731,1734484398,1734485074,676,1.0306680244884845,3.8259019161411962,0.9551131867485495,0.7476664785228789
5732,1734487998,1734490383,2385,1.7939928825216098,4.395695534372201,0.7471503489130338,0.4338227132585034
5733,1734491598,1734495198,3600,0.42990015154303907,3.0526172361304766,0.1,0.1
5734,1734495198,1734497704,2506,1.830503480576204,4.606790572553216,0.8025037920322442,0.4761715272226912
5735,1734498798,1734502398,3600,0.29853852667822217,3.1375086528027376,0.1,0.1
5736,1734502398,1734505998,3600,0.349292088473133,3.100227686072224,0.1,0.1
5737,1734505998,1734507049,1051,1.2093166074862547,4.09644664619795,0.589361011883742,0.8378438666913418
5738,1734509598,1734510573,975,1.0873934100229965,4.036864417434235,0.6614892859046082,0.7290778061597852
5739,1734513198,1734514556,1358,1.0931120430370442,3.9407896069331967,0.6193960644028969,0.8932292940469744
5740,1734516798,1734517703,905,1.107253628199811,4.038049473912508,0.606783566101588,0.8059195075506647
5741,1734520398,1734522431,2033,1.9756040305679585,4.687448423747307,0.6791316562700118,0.8066922661158908
5742,1734523998,1734527598,3600,0.3737166453273846,3.186956192820578,0.1,0.1
5743,1734527598,1734528062,464,0.7624398460229636,3.357359791676566,0.295352844656577,0.281402929352266
5744,1734531198,1734534798,3600,0.3414607127402894,3.1420477495569354,0.1,0.1
5745,1734534798,1734535989,1191,1.4093441556547313,4.00996497373246,0.8392176556692107,0.816827361758781
5746,1734538398,1734541998,3600,0.10168028730129737,3.1593363671931285,0.1,0.1
5747,1734541998,1734544714,2716,2.1329412260293106,4.566063581123855,0.647725257336847,0.14721496736143222
5748,1734545598,1734548917,3319,1.9337088358831198,4.573020360187246,0.8945852065326217,0.14015274718066562
5749,1734549198,1734550194,996,1.1465040657608945,4.184758800530777,0.10965000788420837,0.9416509328005562
5750,1734552798,1734556398,3600,0.19147350433814503,3.041237864240307,0.1,0.1
5751,1734556398,1734557482,1084,1.285116952110814,4.106191529615254,0.4433049200071608,0.3856020695487127
5752,1734559998,1734560448,450,0.9785560326632473,3.322749234414131,0.7411136659128894,0.3060796403954803
5753,1734563598,1734567198,3600,0.3993162548292408,3.1869164150528957,0.1,0.1
5754,1734567198,1734570798,3600,0.45769052962174106,3.1230602521598163,0.1,0.1
5755,1734570798,1734572734,1936,1.6582411828184116,4.436852417138741,0.31325866932303315,0.403567796733697
5756,1734574398,1734577998,3600,0.22424765304295435,3.177038216708748,0.1,0.1
5757,1734577998,1734581598,3600,0.4037920619202524,3.0307570953064067,0.1,0.1
5758,1734581598,1734585198,3600,0.27505654714401206,3.1590321772450576,0.1,0.1
5759,1734585198,1734585287,89,0.9975322059144663,3.5816124941248506,0.10814081765383592,0.2436523096048544
5760,1734588798,1734589463,665,1.0666602731714818,4.145379040949484,0.4603165478907695,0.8381441583847683
5761,1734592398,1734595740,3342,2.186914830348208,4.314896001401834,0.22416021402078046,0.8611834414680672
5762,1734595998,1734599598,3600,0.4318903845430405,3.1329561830169004,0.1,0.1
5763,1734599598,1734603198,3600,0.29249958808752385,3.1918448683894027,0.1,0.1
5764,1734603198,1734604613,1415,1.2696376116908683,4.127569423601899,0.8204482447007216,0.37023822635419046
5765,1734606798,1734610398,3600,0.3485855205595251,3.0087389257037356,0.1,0.1
5766,1734610398,1734613998,3600,0.4681987797167393,3.01165977217983,0.1,0.1
5767,1734613998,1734617598,3600,0.4462323355290482,3.1526400456629227,0.1,0.1
5768,1734617598,1734621198,3600,0.26636995701265215,3.0875260226954446,0.1,0.1
5769,1734621198,1734623063,1865,2.335341386089417,4.696616473100007,0.6934643171957834,0.23174670460470959
5770,1734624798,1734628398,3600,0.4554435468039487,3.0623451909248813,0.1,0.1
5771,1734628398,1734631998,3600,0.27989893659078474,3.156925258718978,0.1,0.1
5772,1734631998,1734635598,3600,0.4135276406525965,3.1304479824740072,0.1,0.1
5773,1734635598,1734639198,3600,0.3675025269292864,3.101218736116083,0.1,0.1
5774,1734639198,1734642798,3600,0.43048632572822254,3.0618006700456113,0.1,0.1
5775,1734642798,1734646398,3600,0.14005021519545713,3.1150090550824863,0.1,0.1
5776,1734646398,1734646771,373,0.5213197236550584,3.426482338633417,0.26482485693317237,0.20489736779532314
5777,1734649998,1734653598,3600,0.24038285400808898,3.033839124886385,0.1,0.1
5778,1734653598,1734654733,1135,1.1533455082516921,3.8850107446384885,0.4242901289604708,0.6590826944081746
5779,1734657198,1734660798,3600,0.2067927465028,3.1248332469297733,0.1,0.1
5780,1734660798,1734661112,314,0.6383629761751994,3.635653964420923,0.12938854433266464,0.1387791489616095
5781,1734664398,1734667998,3600,0.3610793070185324,3.1799004710108645,0.1,0.1
5782,1734667998,1734671598,3600,0.22123254825873728,3.117051912922305,0.1,0.1
5783,1734671598,1734672639,1041,1.0220963042351792,4.048558052872745,0.6902803154996313,0.3889209994465176
5784,1734675198,1734678798,3600,0.2431526814672242,3.136774715527618,0.1,0.1
5785,1734678798,1734682398,3600,0.2189689051941593,3.1959541834810703,0.1,0.1
5786,1734682398,1734685998,3600,0.4285767719050505,3.078423971103865,0.1,0.1
5787,1734685998,1734686245,247,0.7491380426025491,3.3969830013624125,0.4390365834159303,0.7704393222999906
5788,1734689598,1734693198,3600,0.2754323334183729,3.188213972164052,0.1,0.1
5789,1734693198,1734696798,3600,0.17480936194304614,3.000901246119853,0.1,0.1
5790,1734696798,1734700398,3600,0.34414339226795,3.0406506857003124,0.1,0.1
5791,1734700398,1734703998,3600,0.47859193971633684,3.1041748415163286,0.1,0.1
5792,1734703998,1734704758,760,1.2938152318467222,4.098934404204681,0.32473977263682763,0.3283002386070836
5793,1734707598,1734711198,3600,0.20149080427647448,3.1429373642951988,0.1,0.1
5794,1734711198,1734713756,2558,2.41657452406419,4.6723299695118525,0.3051138796529559,0.6748259353891408
5795,1734714798,1734715930,1132,1.1747667697596456,3.935752208333645,0.6891859389077037,0.9625955478104462
5796,1734718398,1734721998,3600,0.481947179178169,3.0864549557226915,0.1,0.1
5797,1734721998,1734725598,3600,0.3234876782326213,3.0984521597332915,0.1,0.1
5798,1734725598,1734728815,3217,1.5278998603425546,4.557952779321728,0.20786674270459304,0.25750809033503824
5799,1734729198,1734732798,3600,0.276001549113546,3.1927921042849605,0.1,0.1
5800,1734732798,1734736398,3600,0.1308463387063573,3.0720713331751095,0.1,0.1
5801,1734736398,1734739998,3600,0.1353102842825561,3.0201795853130022,0.1,0.1
5802,1734739998,1734742252,2254,2.1916829149928834,4.530649073836916,0.5038175319657181,0.4782354139149644
5803,1734743598,1734747198,3600,0.4255720354512551,3.031868531778689,0.1,0.1
5804,1734747198,1734750798,3600,0.29958248065790916,3.081572008915735,0.1,0.1
5805,1734750798,1734753818,3020,2.3250176570891554,4.626683270619498,0.7713807812863689,0.8196446858740297
5806,1734754398,1734757998,3600,0.38715241185650406,3.0749599557776413,0.1,0.1
5807,1734757998,1734760144,2146,2.220042847246935,4.356952241342895,0.6655244553157458,0.5293677759011072
5808,1734761598,1734764835,3237,2.018282918275218,4.699412997033476,0.7308659827770404,0.902485245654991
5809,1734765198,1734767110,1912,1.6217992948231696,4.411952169393427,0.8689552933651934,0.9495246349464171
5810,1734768798,1734769456,658,1.4409582337969664,3.8943382151201478,0.1762670264964113,0.48912029689563297
5811,1734772398,1734775834,3436,2.1582166140673644,4.5558994918724425,0.5662299040284706,0.9642174257058995
5812,1734775998,1734779598,3600,0.46475541131590103,3.0354331141123954,0.1,0.1
5813,1734779598,1734781084,1486,1.0206714802235473,3.9775787994082465,0.8633905069963179,0.22306131995758777
5814,1734783198,1734786072,2874,2.27634654207682,4.577553191928981,0.8780126298085696,0.9026791022125631
5815,1734786798,1734790398,3600,0.14928035866136613,3.092474029929381,0.1,0.1
5816,1734790398,1734791414,1016,1.3952143109085087,4.187388454987524,0.19387482249146903,0.7912611878609027
5817,1734793998,1734797598,3600,0.4631862393656314,3.090527095961218,0.1,0.1
5818,1734797598,1734798595,997,1.4647550357877461,3.8079514501090896,0.43623985105029484,0.22274520519519353
5819,1734801198,1734804173,2975,2.3642224142155266,4.323735142115523,0.2840721726638057,0.9191657006930429
5820,1734804798,1734806812,2014,1.9046846240535436,4.628318393488557,0.7110541356596205,0.2969035259472959
5821,1734808398,1734811998,3600,0.41072573979049076,3.0530840172782017,0.1,0.1
5822,1734811998,1734812497,499,0.555166662584356,3.5679558224648673,0.6659912581311574,0.6897279439942965
5823,1734815598,1734819198,3600,0.4705098458512931,3.0241166829704533,0.1,0.1
5824,1734819198,1734822798,3600,0.20139524010842483,3.0948905968258393,0.1,0.1
5825,1734822798,1734826346,3548,1.5625108242014039,4.354148945349854,0.25543531424939303,0.18565539862581895
5826,1734826398,1734827226,828,1.0156539456113467,3.9005069128130008,0.7388510750339375,0.15340303972910285
5827,1734829998,1734833598,3600,0.25420462988259085,3.098472784539373,0.1,0.1
5828,1734833598,1734834835,1237,1.343243619855924,4.1775419238983265,0.9394901110290003,0.5578771085641306
5829,1734837198,1734840798,3600,0.4993236882751365,3.1759551081984214,0.1,0.1
5830,1734840798,1734842434,1636,1.3990461650303088,4.090829559452714,0.12642623061441674,0.5515065591812884
5831,1734844398,1734847998,3600,0.32160863422225716,3.160301760627137,0.1,0.1
5832,1734847998,1734849459,1461,1.262718012297849,4.083042060282362,0.5387887504615898,0.4310057503099267
5833,1734851598,1734855128,3530,2.4276654915178586,4.503713193165759,0.6358867373453887,0.8049950417312837
5834,1734855198,1734857669,2471,2.3946530182997225,4.500055314453122,0.1867793191588808,0.6195933947656612
5835,1734858798,1734861693,2895,2.4125931191218566,4.668157253100355,0.9417711556921743,0.9083326411407575
5836,1734862398,1734865998,3600,0.24228864445557236,3.1793599989195407,0.1,0.1
5837,1734865998,1734866261,263,0.5502610920937699,3.334015653261336,0.4250283454091194,0.922401334803994
5838,1734869598,1734873198,3600,0.2325934931567195,3.0590339322824276,0.1,0.1
5839,1734873198,1734875684,2486,1.692857511310657,4.601662326100311,0.48937233385992707,0.4534951729445904
5840,1734876798,1734880398,3600,0.41324394908418305,3.140704817729289,0.1,0.1
5841,1734880398,1734883998,3600,0.45749276211204926,3.139127973271177,0.1,0.1
5842,1734883998,1734887598,3600,0.18066794725369612,3.0464119744255274,0.1,0.1
5843,1734887598,1734888138,540,0.6402956231474898,3.403209910527777,0.8896898894422237,0.6229244406550108
5844,1734891198,1734891634,436,0.9128240045238614,3.654808238168743,0.4196952274449791,0.4608549290145738
5845,1734894798,1734898398,3600,0.2361532769265947,3.112554011480797,0.1,0.1
5846,1734898398,1734901998,3600,0.15622353688050816,3.1531979713885288,0.1,0.1
5847,1734901998,1734905598,3600,0.17401680859321694,3.1641885673741994,0.1,0.1
5848,1734905598,1734907079,1481,1.3110149754242737,3.8315413148055795,0.7190539804193299,0.6939923999385034
5849,1734909198,1734912798,3600,0.41702224872916804,3.0237759659460233,0.1,0.1
5850,1734912798,1734916398,3600,0.1460440956057194,3.0150996949858824,0.1,0.1
5851,1734916398,1734916909,511,0.8369715720104992,3.527884734529574,0.3738340270261872,0.3832056498853269
5852,1734919998,1734923598,3600,0.35376280034559693,3.0288061301497384,0.1,0.1
5853,1734923598,1734925991,2393,2.2733203788145886,4.315856896220835,0.10373288864297558,0.6487414164881629
5854,1734927198,1734930798,3600,0.42114753747181266,3.060129037560336,0.1,0.1
5855,1734930798,1734931523,725,1.2188848023817496,3.880071134156386,0.6619608927612225,0.3449397827091871
5856,1734934398,1734937998,3600,0.3157501143608016,3.1627402787887995,0.1,0.1
5857,1734937998,1734939022,1024,1.2235949416639653,4.14700966991354,0.25664153093274955,0.23412738492806592
5858,1734941598,1734945198,3600,0.13093438333465388,3.1206860857509415,0.1,0.1
5859,1734945198,1734948798,3600,0.24677290965712376,3.054153660696831,0.1,0.1
5860,1734948798,1734952398,3600,0.4753279763241801,3.047759698317317,0.1,0.1
5861,1734952398,1734955998,3600,0.49722203163463563,3.138779952128421,0.1,0.1
5862,1734955998,1734959598,3600,0.3723394770177143,3.0955406763171234,0.1,0.1
5863,1734959598,1734960777,1179,1.0678744635645747,4.006098313024125,0.9820365738428257,0.29238312451914816
5864,1734963198,1734966631,3433,1.5487194433023839,4.302998589842582,0.2240502927288514,0.8608522817057968
5865,1734966798,1734970192,3394,1.886216237493422,4.3196690023947975,0.6301192868409908,0.8822635841103633
5866,1734970398,1734972634,2236,2.1649281655994583,4.374959945867757,0.5001209840850452,0.5630780583498721
5867,1734973998,1734977598,3600,0.16968664692727126,3.1504513433771946,0.1,0.1
5868,1734977598,1734981198,3600,0.39491930054886504,3.0366972754131067,0.1,0.1
5869,1734981198,1734984798,3600,0.4624829018404626,3.0698045105606626,0.1,0.1
5870,1734984798,1734986202,1404,1.0022489339636336,4.052100178140501,0.8329217758675977,0.3673765732533848
5871,1734988398,1734991998,3600,0.21850537290618918,3.1280299707011134,0.1,0.1
5872,1734991998,1734995598,3600,0.23649247802880558,3.1885259144459077,0.1,0.1
5873,1734995598,1734995944,346,0.5559660915724455,3.359234519686533,0.887324392485664,0.13208354023238508
5874,1734999198,1735001017,1819,2.135261834850097,4.569778498449352,0.7347184861636444,0.31765116860853687
5875,1735002798,1735006398,3600,0.17508650730053732,3.1292819719948617,0.1,0.1
5876,1735006398,1735009998,3600,0.21176803301527417,3.1935276463747693,0.1,0.1
5877,1735009998,1735012802,2804,1.9055349072439562,4.609906349754436,0.5151283421149847,0.9498887001490929
5878,1735013598,1735015180,1582,1.481582911450279,3.9951422963901773,0.6929722353496227,0.9596811685447324
5879,1735017198,1735020555,3357,2.0509907743796654,4.64725402962031,0.8594900850197255,0.8121663889750536
5880,1735020798,1735024398,3600,0.13380729867761,3.1448852082887884,0.1,0.1
5881,1735024398,1735027998,3600,0.3291368487225478,3.031278629983486,0.1,0.1
5882,1735027998,1735031598,3600,0.3634084757387025,3.0989826106827936,0.1,0.1
5883,1735031598,1735035198,3600,0.3764130833116871,3.1127512394452768,0.1,0.1
5884,1735035198,1735036273,1075,1.3931022888095288,4.031286600355388,0.23963060525844926,0.1457080748768732
5885,1735038798,1735041431,2633,1.8260459991575613,4.518136961089766,0.7526672078679697,0.21531047008889564
5886,1735042398,1735045998,3600,0.13838901067613463,3.108809231862599,0.1,0.1
5887,1735045998,1735049598,3600,0.4462133247929052,3.1556770741463303,0.1,0.1
5888,1735049598,1735051795,2197,1.6057517092539177,4.45159470617949,0.18211920219759928,0.5756608782057481
5889,1735053198,1735056461,3263,2.3557104843780565,4.5565805665436985,0.21664075177012682,0.8879289898642635
5890,1735056798,1735060398,3600,0.4240185849065319,3.1406599840048046,0.1,0.1
5891,1735060398,1735063998,3600,0.4362821594825539,3.087299413757488,0.1,0.1
5892,1735063998,1735066360,2362,1.6361177381824508,4.60568908839861,0.6352909542424844,0.8231817212426975
5893,1735067598,1735068122,524,0.7987951259662156,3.4999606379039365,0.8135735247063105,0.42745331352335514
5894,1735071198,1735071492,294,0.9503114708614686,3.695398217118996,0.5660480121480133,0.6656034114767282
5895,1735074798,1735078398,3600,0.37922772340471045,3.0363423663314077,0.1,0.1
5896,1735078398,1735081998,3600,0.1317255023021789,3.169554245798375,0.1,0.1
5897,1735081998,1735085598,3600,0.308812897684701,3.074842394730997,0.1,0.1
5898,1735085598,1735085898,300,0.5244152897029133,3.535572478005699,0.33695490363440106,0.8376802680869261
5899,1735089198,1735092798,3600,0.3240183878548992,3.136895203319846,0.1,0.1
5900,1735092798,1735092859,61,0.7738708403391027,3.506204921082526,0.1091085665560299,0.891820395961538
5901,1735096398,1735099998,3600,0.1021038088468222,3.0875848556789403,0.1,0.1
5902,1735099998,1735101593,1595,1.2699695277745469,4.071313623371324,0.9890106247603181,0.6464579317847685
5903,1735103598,1735107198,3600,0.2522563261756706,3.1886328178962753,0.1,0.1
5904,1735107198,1735107681,483,0.9087542301249182,3.3613560993037432,0.29019508252135906,0.24860153806159319
5905,1735110798,1735112288,1490,1.1857658209690067,3.8001295010510145,0.7578524211262453,0.14990879705745666
5906,1735114398,1735117998,3600,0.2133817148125733,3.035131185870069,0.1,0.1
5907,1735117998,1735118433,435,0.556669007935364,3.643760720137276,0.7381153074423751,0.8087037924191638
5908,1735121598,1735122180,582,0.9451411035792731,3.6317277350079737,0.24375817560469684,0.9796063316160497
5909,1735125198,1735126130,932,1.1604455769520579,3.821931250650775,0.3612712179326726,0.4550995097127891
5910,1735128798,1735132398,3600,0.49255704156189195,3.165848789833499,0.1,0.1
5911,1735132398,1735135411,3013,2.126234335171928,4.636357570688752,0.7789897081922293,0.9091107494880054
5912,1735135998,1735139598,3600,0.21317070970113303,3.12887575840549,0.1,0.1
5913,1735139598,1735141377,1779,1.3330224944018862,3.902608175176376,0.4108052866269919,0.8207697048190395
5914,1735143198,1735146798,3600,0.16918905217025318,3.054913597373579,0.1,0.1
5915,1735146798,1735148970,2172,1.7739427926524303,4.4395752959620065,0.35177335806695553,0.7079122904944316
5916,1735150398,1735153723,3325,1.558252089664454,4.331356000427297,0.24161050197713874,0.740877955560479
5917,1735153998,1735154612,614,1.3670541280287347,4.070423946182825,0.2949182934614011,0.5223136579806759
5918,1735157598,1735161198,3600,0.10654349282765524,3.0242980123192784,0.1,0.1
5919,1735161198,1735163156,1958,2.0005360493329105,4.69299015412224,0.2247723999899761,0.12213991375033116
5920,1735164798,1735168398,3600,0.4935899020106128,3.09268571356902,0.1,0.1
5921,1735168398,1735171998,3600,0.21116517053776548,3.16976362467538,0.1,0.1
5922,1735171998,1735175598,3600,0.2821447878255635,3.126854384352778,0.1,0.1
5923,1735175598,1735176152,554,0.5255028805737467,3.661610409643125,0.9452805043350073,0.37774427623752616
5924,1735179198,1735182504,3306,1.6907719963837433,4.331287618601013,0.7405945404090853,0.8148682865612865
5925,1735182798,1735185220,2422,2.2392184550994045,4.368676928947806,0.3389087080067618,0.7700286104100154
5926,1735186398,1735189975,3577,2.014016045896069,4.5087480610330495,0.2921687082908897,0.8870003152634368
5927,1735189998,1735192197,2199,1.6708282211603418,4.530088477482193,0.3458592529474021,0.5596811429842893
5928,1735193598,1735193688,90,0.7758548377308263,3.5650408422685715,0.10996012188580516,0.9070607773591745
5929,1735197198,1735197920,722,1.2508947547365574,4.157561679595399,0.47740472222533825,0.40837649926285824
5930,1735200798,1735204398,3600,0.36746803370947556,3.116773455284652,0.1,0.1
5931,1735204398,1735207381,2983,1.519449352597158,4.475143489080865,0.8288298292455469,0.8379281042607939
5932,1735207998,1735209237,1239,1.1999594013372632,3.902776454595713,0.9361724320610065,0.8836009065235478
5933,1735211598,1735214869,3271,1.8454263083382543,4.410423825722144,0.8267145866091944,0.8594158927117952
5934,1735215198,1735216574,1376,1.0083212236081904,4.035069361587823,0.8086098685203423,0.36569318005554596
5935,1735218798,1735222398,3600,0.460711363116986,3.0570204742869556,0.1,0.1
5936,1735222398,1735225998,3600,0.17921447393395717,3.1774952125012224,0.1,0.1
5937,1735225998,1735229598,3600,0.2538397794667867,3.0129410172525506,0.1,0.1
5938,1735229598,1735233198,3600,0.29237111456687415,3.0221246970991533,0.1,0.1
5939,1735233198,1735236798,3600,0.13664433762842748,3.1038034777374524,0.1,0.1
5940,1735236798,1735240398,3600,0.2949981580763962,3.1030087173387852,0.1,0.1
5941,1735240398,1735243588,3190,2.050443737419992,4.328547003713462,0.5068138672902738,0.9394271556017474
5942,1735243998,1735247598,3600,0.31345257660485004,3.0601922137015634,0.1,0.1
5943,1735247598,1735251198,3600,0.2755750450671869,3.0078277165173124,0.1,0.1
5944,1735251198,1735251663,465,0.7804024258485398,3.573920316827901,0.6233948463988962,0.3026624452377835
5945,1735254798,1735258398,3600,0.49144735727429967,3.16387240306827,0.1,0.1
5946,1735258398,1735258909,511,0.7955014117488948,3.6821236931989927,0.7724788588779158,0.47400631306833474
5947,1735261998,1735265598,3600,0.3931052397374025,3.067164295828577,0.1,0.1
5948,1735265598,1735267284,1686,1.4894856151569857,4.138051757843737,0.2486571378727459,0.3840520210941025
5949,1735269198,1735272720,3522,2.44131745558661,4.485571834316033,0.7789476783633212,0.3856069188697593
5950,1735272798,1735276398,3600,0.2996288847478439,3.0646751886005084,0.1,0.1
5951,1735276398,1735278694,2296,1.9617657375203186,4.653542735147631,0.8833249460936483,0.7006608248551314
5952,1735279998,1735283598,3600,0.22605377414895336,3.0590954265051318,0.1,0.1
5953,1735283598,1735286439,2841,2.1977936546068455,4.640385051903742,0.8117459687326899,0.20575220127848515
5954,1735287198,1735290798,3600,0.3841288202124654,3.052155852460714,0.1,0.1
5955,1735290798,1735292380,1582,1.3530374311063613,3.8213527792049184,0.5834095816546876,0.2486679345021744
5956,1735294398,1735296594,2196,2.0818024518808427,4.6529688132351446,0.34342079142405935,0.8938353195480044
5957,1735297998,1735299696,1698,1.1189380588712599,3.8242009292228856,0.3165189896316584,0.14492757739546072
5958,1735301598,1735305198,3600,0.4741012119145547,3.039431735525793,0.1,0.1
5959,1735305198,1735305820,622,1.4711505601430144,3.9721492895489794,0.422769899341904,0.37304234556398796
5960,1735308798,1735310831,2033,1.9019158770393143,4.3910536745291715,0.6661191540201568,0.47696056290569977
5961,1735312398,1735315260,2862,1.795120275516348,4.343342504235902,0.19300640371206867,0.6192664007190177
5962,1735315998,1735319598,3600,0.4646497351814328,3.095080573122782,0.1,0.1
5963,1735319598,1735323198,3600,0.4872402774522452,3.169800407932485,0.1,0.1
5964,1735323198,1735326338,3140,2.278032173308715,4.642893117463401,0.41819968897582527,0.23748311003570555
5965,1735326798,1735327037,239,0.8854221940784752,3.3882358952253324,0.5692263547811449,0.5141021166811791
5966,1735330398,1735330675,277,0.929888791036125,3.3379533753203443,0.41384129999243224,0.598760596232533
5967,1735333998,1735334990,992,1.2459835602055058,3.9228864939449535,0.9745370463825064,0.2826750915382148
5968,1735337598,1735341198,3600,0.4049282294829263,3.1657935358951366,0.1,0.1
5969,1735341198,1735344798,3600,0.34429654588271574,3.063572375807157,0.1,0.1
5970,1735344798,1735346057,1259,1.2357679701698543,3.8250376640819086,0.529589682175163,0.25196324653037466
5971,1735348398,1735351998,3600,0.20257581855271406,3.119244631352578,0.1,0.1
5972,1735351998,1735353549,1551,1.252689753983677,3.841201807867303,0.24998221260739745,0.7495808703264158
5973,1735355598,1735359198,3600,0.18829954005833494,3.119497620821968,0.1,0.1
5974,1735359198,1735362109,2911,2.1522711723674703,4.67267903654392,0.7802871306198275,0.8298671660723306
5975,1735362798,1735366398,3600,0.23077423678869868,3.0723591116613083,0.1,0.1
5976,1735366398,1735368341,1943,1.9043724181940593,4.5988456736182926,0.7804470191635652,0.2736884269844533
5977,1735369998,1735370812,814,1.047050983760808,3.8454679565710137,0.5257923974401943,0.19165564339332347
5978,1735373598,1735377198,3600,0.31633671180506356,3.0027645092747886,0.1,0.1
5979,1735377198,1735380621,3423,1.8856518285456587,4.3917709540525545,0.8993017509723047,0.5092514160524155
5980,1735380798,1735381246,448,0.5649520209945326,3.3532222693057205,0.7683065848387698,0.3220840713886056
5981,1735384398,1735384844,446,0.6856327801535225,3.5528635271835483,0.3441817566291334,0.5004986223979112
5982,1735387998,1735390407,2409,2.1219507432956437,4.319982690459842,0.22359235469316327,0.888366284183373
5983,1735391598,1735395198,3600,0.3386224854979544,3.1838951091404937,0.1,0.1
5984,1735395198,1735398798,3600,0.28124499666183234,3.1190982573484693,0.1,0.1
5985,1735398798,1735402398,3600,0.45604955143697035,3.0806141057600214,0.1,0.1
5986,1735402398,1735403924,1526,1.017756120817195,3.8493378266046654,0.837343680370882,0.7843855838692861
5987,1735405998,1735409598,3600,0.36812646126686677,3.069931765069693,0.1,0.1
5988,1735409598,1735412899,3301,2.2425141995569176,4.557933750059424,0.3001795959392062,0.8168614897768006
5989,1735413198,1735414845,1647,1.4218478164810984,4.07920000715881,0.5498114006563604,0.738274614233542
5990,1735416798,1735420398,3600,0.46498202649762843,3.082605118203467,0.1,0.1
5991,1735420398,1735423998,3600,0.4738804406274585,3.0870451761372566,0.1,0.1
5992,1735423998,1735427205,3207,2.352408176761534,4.505502793591044,0.39719093367027425,0.710682220916746
5993,1735427598,1735431198,3600,0.2999681595292216,3.0498020456171036,0.1,0.1
5994,1735431198,1735434798,3600,0.12071548157841133,3.0757526163691935,0.1,0.1
5995,1735434798,1735438398,3600,0.4756524692786287,3.11774485864462,0.1,0.1
5996,1735438398,1735441998,3600,0.15514764478716409,3.174961626543824,0.1,0.1
5997,1735441998,1735445598,3600,0.3340963445498044,3.0165342757947737,0.1,0.1
5998,1735445598,1735449198,3600,0.16710170036791838,3.0015712741961407,0.1,0.1
5999,1735449198,1735452798,3600,0.4266169497236021,3.1911957180219033,0.1,0.1
6000,1735452798,1735453998,1200,1.3565648089395186,3.8221491040123245,0.829889745824052,0.6225237944486078
6001,1735456398,1735459591,3193,2.3346631989103663,4.393163501386306,0.7824543353760343,0.17369466931160044
6002,1735459998,1735463598,3600,0.2544793185835087,3.1632019061520027,0.1,0.1
6003,1735463598,1735465098,1500,1.101224110492996,3.908093539762129,0.34082588182105644,0.8853672681716481
6004,1735467198,1735470798,3600,0.1655566914022144,3.0070669626798003,0.1,0.1
6005,1735470798,1735474398,3600,0.46848190939365486,3.0502876810193915,0.1,0.1
6006,1735474398,1735477998,3600,0.2604119827779706,3.1543685973667857,0.1,0.1
6007,1735477998,1735478153,155,0.8565923176991983,3.417147240005071,0.7692319568604707,0.9500169347157826
6008,1735481598,1735483037,1439,1.4635023722000629,4.171431376611847,0.6742429358819741,0.5510511945342581
6009,1735485198,1735488798,3600,0.17099814188496187,3.035333529308663,0.1,0.1
6010,1735488798,1735492163,3365,1.7590205780398058,4.319308827271765,0.8305856169768647,0.23850992369972984
6011,1735492398,1735493504,1106,1.1055985630876286,3.864769412421022,0.2531603637507244,0.31110500816239567
6012,1735495998,1735499598,3600,0.3713344994594009,3.0151882264397707,0.1,0.1
6013,1735499598,1735500277,679,1.255555243470966,4.193044387481809,0.3468185259267521,0.6629164779507545
6014,1735503198,1735503316,118,0.7407652720162686,3.6501272742796758,0.18766081929608752,0.7170518050320195
6015,1735506798,1735509254,2456,2.4550022827025924,4.484758151727098,0.636673705216211,0.7064695570598845
6016,1735510398,1735513998,3600,0.4727183680740076,3.177486233823116,0.1,0.1
6017,1735513998,1735515340,1342,1.478750565682566,3.849252114894976,0.21425934330016255,0.9633636332758044
6018,1735517598,1735521031,3433,2.2280742805694747,4.465626806852099,0.8381060191571638,0.7678592847517426
6019,1735521198,1735524798,3600,0.2990938142420022,3.0769921157305142,0.1,0.1
6020,1735524798,1735526902,2104,1.7470625587107205,4.480339627097258,0.8282723559215943,0.6726980632524628
6021,1735528398,1735529972,1574,1.3211372530195324,3.898430611073196,0.42046764947174153,0.9551930788700119
6022,1735531998,1735535598,3600,0.3287904611262712,3.0771345404316772,0.1,0.1
6023,1735535598,1735539198,3600,0.39768964507044424,3.0733558153795704,0.1,0.1
6024,1735539198,1735539702,504,0.6706546173119535,3.4277223928191978,0.7433343498679039,0.3884029562573744
6025,1735542798,1735546398,3600,0.27046083575109214,3.078987008171467,0.1,0.1
6026,1735546398,1735548098,1700,1.477838323653096,3.811907280421322,0.2384895827130801,0.17922073939381838
6027,1735549998,1735552042,2044,1.6385631357250445,4.311887928036243,0.609712092578754,0.26170541838584427
6028,1735553598,1735557198,3600,0.24317481575405384,3.0927360015987357,0.1,0.1
6029,1735557198,1735558729,1531,1.3243030048835704,4.1532151550118215,0.9934860987216146,0.7051432161596848
6030,1735560798,1735564398,3600,0.4140111361667601,3.040004617131363,0.1,0.1
6031,1735564398,1735566391,1993,1.6808716743161807,4.64848000096637,0.16367983067251798,0.6911542643972842
6032,1735567998,1735571598,3600,0.15688874212730217,3.1740836885493198,0.1,0.1
6033,1735571598,1735572163,565,0.9525997079759676,3.638278067835003,0.9782184392128813,0.543714034440142
6034,1735575198,1735578798,3600,0.2378163249443521,3.051435704010396,0.1,0.1
6035,1735578798,1735582398,3600,0.4218148591061187,3.0284943649407983,0.1,0.1
6036,1735582398,1735585998,3600,0.1383112197371907,3.0495710571598793,0.1,0.1
6037,1735585998,1735588269,2271,1.9293867610865445,4.526092848974124,0.5407021514630612,0.9953335836110986
6038,1735589598,1735593198,3600,0.18026623458692048,3.083077982938661,0.1,0.1
6039,1735593198,1735596798,3600,0.37499802332242627,3.0337661710061794,0.1,0.1
6040,1735596798,1735600398,3600,0.2605501576833778,3.1353069653241947,0.1,0.1
6041,1735600398,1735603998,3600,0.21822418676377053,3.1456393577635127,0.1,0.1
6042,1735603998,1735605238,1240,1.497079951388076,4.07062578430567,0.6404575696407289,0.9931903352984548
6043,1735607598,1735610978,3380,1.995394424375875,4.670855838920952,0.5744922651217956,0.5916834104560468
6044,1735611198,1735613245,2047,2.003120890235983,4.346080634742429,0.21316684556134613,0.690251353795211
6045,1735614798,1735618398,3600,0.2603660326135263,3.089483433544195,0.1,0.1
6046,1735618398,1735619478,1080,1.2848024151323285,3.8260137081923666,0.7116490435682963,0.8290106963371664
6047,1735621998,1735622510,512,0.5877514762295275,3.5943656891981757,0.700124858731962,0.8098615429925785
6048,1735625598,1735629198,3600,0.3756298135633137,3.1765129807043104,0.1,0.1
6049,1735629198,1735632798,3600,0.19764408088716123,3.161764382277818,0.1,0.1
6050,1735632798,1735636398,3600,0.41360781564320126,3.129333172658301,0.1,0.1
6051,1735636398,1735638091,1693,1.2905317110306718,3.983982940641464,0.10370489496354746,0.738927495589452
6052,1735639998,1735643598,3600,0.1960145538338011,3.010006577177695,0.1,0.1
6053,1735643598,1735645577,1979,1.5944531901731485,4.532770508498816,0.8851674803017844,0.8861163559754882
6054,1735647198,1735648625,1427,1.3838238590341372,3.8378110153707126,0.14256507956017744,0.7533299478673195
6055,1735650798,1735654398,3600,0.36412002449713654,3.105873061740568,0.1,0.1
6056,1735654398,1735654869,471,0.8415340745689817,3.3775148991902553,0.2553232323558029,0.719583631342011
6057,1735657998,1735661598,3600,0.37006048838763483,3.0930837002358498,0.1,0.1
6058,1735661598,1735665198,3600,0.43622648129336694,3.0338816685705683,0.1,0.1
6059,1735665198,1735668798,3600,0.29546436253130604,3.065793653990646,0.1,0.1
6060,1735668798,1735672398,3600,0.12635433122583814,3.030926595996627,0.1,0.1
6061,1735672398,1735673382,984,1.2188134448217605,4.147180639832381,0.593837547416992,0.3582507687734946
6062,1735675998,1735679598,3600,0.19963135318971928,3.0683947643976635,0.1,0.1
6063,1735679598,1735679974,376,0.84901914044188,3.363705242062958,0.867370330492531,0.5481731561047206
6064,1735683198,1735686076,2878,2.0012931669740586,4.448849246788352,0.8917157204414059,0.46603459547145676
6065,1735686798,1735688900,2102,1.738077899647933,4.428817660579876,0.8412670070832077,0.8018086889746826
6066,1735690398,1735691929,1531,1.3338462332199956,3.814307287573519,0.5400611060329861,0.883660156564501
6067,1735693998,1735697263,3265,1.621646421479877,4.445657650940519,0.39135171887996745,0.13855871649847776
6068,1735697598,1735701198,3600,0.49845231158461134,3.1862211280007857,0.1,0.1
6069,1735701198,1735702816,1618,1.452954290053741,4.120895799950284,0.9406892334603573,0.39959707629528385
6070,1735704798,1735708398,3600,0.3319730185232749,3.1752077787706274,0.1,0.1
6071,1735708398,1735710334,1936,2.0338723395175538,4.5534676730837615,0.4745524629067861,0.5937172793927488
6072,1735711998,1735715598,3600,0.32286988109110326,3.0004857019912055,0.1,0.1
6073,1735715598,1735719198,3600,0.3511774352030145,3.0941129479919667,0.1,0.1
6074,1735719198,1735722798,3600,0.4500327621225013,3.1836793000880528,0.1,0.1
6075,1735722798,1735723722,924,1.3204578008716426,4.168693124651887,0.2269118240664152,0.6204727013883911
6076,1735726398,1735728798,2400,2.0786380012293755,4.356352446012029,0.549422366001929,0.6035312997169615
6077,1735729998,1735733598,3600,0.19347484541984838,3.044400311199026,0.1,0.1
6078,1735733598,1735737198,3600,0.2473575180132731,3.13681331235158,0.1,0.1
6079,1735737198,1735740798,3600,0.1884803919039813,3.0347970797946613,0.1,0.1
6080,1735740798,1735744398,3600,0.2652072066492428,3.135639728397169,0.1,0.1
6081,1735744398,1735747770,3372,1.5831133220971463,4.533534469495016,0.920626980816269,0.9484827944043975
6082,1735747998,1735751598,3600,0.45051402459817613,3.03888863098882,0.1,0.1
6083,1735751598,1735755198,3600,0.23681130925318278,3.1971129718260287,0.1,0.1
6084,1735755198,1735758798,3600,0.17357468701902273,3.1402340015843517,0.1,0.1
6085,1735758798,1735762398,3600,0.27979307649138885,3.0795842552695087,0.1,0.1
6086,1735762398,1735765998,3600,0.232616551285975,3.1631638293798376,0.1,0.1
6087,1735765998,1735766487,489,0.5072731468760081,3.6486464862943673,0.7412594700199322,0.4167585112391222
6088,1735769598,1735771133,1535,1.4424924069032858,3.8038095722776553,0.29970113430093814,0.533429238529868
6089,1735773198,1735776798,3600,0.3263190019269409,3.0924278573046378,0.1,0.1
6090,1735776798,1735780398,3600,0.40202200076673433,3.112471100102566,0.1,0.1
6091,1735780398,1735781889,1491,1.3353305090761787,3.8178094895977885,0.6658005963627299,0.8975855967025705
6092,1735783998,1735787598,3600,0.3237611945712127,3.1423098748131486,0.1,0.1
6093,1735787598,1735788091,493,0.8798895219954763,3.537130759742888,0.766486818417346,0.9973952042301278
6094,1735791198,1735794798,3600,0.3343898205721928,3.0850938715515435,0.1,0.1
6095,1735794798,1735798398,3600,0.17823764965941954,3.1940924487147275,0.1,0.1
6096,1735798398,1735801998,3600,0.4084038370309214,3.1959730007500795,0.1,0.1
6097,1735801998,1735805598,3600,0.4963785808517934,3.188436049014001,0.1,0.1
6098,1735805598,1735808343,2745,2.0035590897683586,4.323141439318969,0.6920401279766938,0.7455274616371915
6099,1735809198,1735812798,3600,0.1658437044927601,3.0491705154577,0.1,0.1
6100,1735812798,1735816398,3600,0.10001412781502426,3.1924384401677286,0.1,0.1
6101,1735816398,1735818192,1794,1.1102756221914034,4.193045476195099,0.6037712904889385,0.8328161353537789
6102,1735819998,1735821780,1782,1.38857563136269,4.140660938843384,0.11947291320226908,0.2918820057783824
6103,1735823598,1735825618,2020,2.3142960748653563,4.4434593842474115,0.23092851326925962,0.3351679844471487
6104,1735827198,1735830667,3469,1.8361827559290345,4.456916965418571,0.9001892455629548,0.8493111761869002
6105,1735830798,1735833758,2960,1.811878553444406,4.5119521317254385,0.3122555567572006,0.198374240629912
6106,1735834398,1735834882,484,0.8701780415245739,3.479889636640919,0.9018164146009073,0.7199201817527174
6107,1735837998,1735841598,3600,0.1997859930383854,3.1987005707219778,0.1,0.1
6108,1735841598,1735845198,3600,0.13722332111952296,3.0599512454562485,0.1,0.1
6109,1735845198,1735848798,3600,0.1664749923798542,3.1634504293148855,0.1,0.1
6110,1735848798,1735852398,3600,0.15768390625344308,3.1293932620375005,0.1,0.1
6111,1735852398,1735855998,3600,0.4603040725497799,3.0262226515147863,0.1,0.1
6112,1735855998,1735858387,2389,1.6847185271832406,4.523950376992522,0.6365614178670606,0.6633534010147357
6113,1735859598,1735863198,3600,0.3391288480469959,3.0412134601224476,0.1,0.1
6114,1735863198,1735864414,1216,1.0360738849899285,4.044837239237863,0.3493971676550247,0.4725502361422944
6115,1735866798,1735869406,2608,1.820840378850189,4.429960840928352,0.10584254983898425,0.6656680325615286
6116,1735870398,1735873998,3600,0.40899394916115117,3.06505458142491,0.1,0.1
6117,1735873998,1735875604,1606,1.005736197935462,4.116496131163938,0.2954069648122011,0.5474097602505112
6118,1735877598,1735881198,3600,0.2143694493824167,3.1228856555273325,0.1,0.1
6119,1735881198,1735884798,3600,0.11851180915194691,3.194625333974734,0.1,0.1
6120,1735884798,1735888398,3600,0.23971244493850713,3.1015247647039805,0.1,0.1
6121,1735888398,1735889609,1211,1.443104383721715,3.9049674471652076,0.838024731745349,0.361770728209332
6122,1735891998,1735893003,1005,1.3181675909373223,4.059898630680842,0.9048126674217106,0.47208049074379954
6123,1735895598,1735899198,3600,0.19398035364642432,3.1661239486093575,0.1,0.1
6124,1735899198,1735900100,902,1.1763099456102706,4.164962531089887,0.5689205103307163,0.946946348099408
6125,1735902798,1735904363,1565,1.4770138217960822,4.026826738923579,0.2938978242975774,0.7308228839112463
6126,1735906398,1735909998,3600,0.22442724094794975,3.188049914421166,0.1,0.1
6127,1735909998,1735913598,3600,0.14041419384957168,3.1454477757435075,0.1,0.1
6128,1735913598,1735917198,3600,0.10600255326801329,3.044323814719132,0.1,0.1
6129,1735917198,1735920798,3600,0.4062481550393917,3.0391774944728396,0.1,0.1
6130,1735920798,1735924398,3600,0.44902469218429164,3.1930529031829846,0.1,0.1
6131,1735924398,1735926010,1612,1.1658711434474722,4.006983297300621,0.7593219316731132,0.702984004608312
6132,1735927998,1735929008,1010,1.425564901172781,3.9849967306834,0.47129195064001683,0.254260967736672
6133,1735931598,1735935198,3600,0.12028724353005416,3.1306660695753528,0.1,0.1
6134,1735935198,1735937267,2069,2.3580708374279014,4.330397674282569,0.14365420589728145,0.5103956496066681
6135,1735938798,1735942398,3600,0.12246546405895008,3.1790743976336358,0.1,0.1
6136,1735942398,1735945998,3600,0.2668526928849258,3.0568723854667326,0.1,0.1
6137,1735945998,1735948932,2934,1.699649345309631,4.606493515046317,0.38726940016776146,0.6355147883607161
6138,1735949598,1735953198,3600,0.10127147461774558,3.1164251308328144,0.1,0.1
6139,1735953198,1735956798,3600,0.3905598412796836,3.174871206805458,0.1,0.1
6140,1735956798,1735960398,3600,0.3937187547131359,3.0268963294404547,0.1,0.1
6141,1735960398,1735963998,3600,0.22804960982252043,3.158258280514667,0.1,0.1
6142,1735963998,1735967598,3600,0.3708232308222671,3.18152250883579,0.1,0.1
6143,1735967598,1735971198,3600,0.16542135884419498,3.161278506335174,0.1,0.1
6144,1735971198,1735974798,3600,0.21819473364914882,3.124919372147166,0.1,0.1
6145,1735974798,1735976806,2008,2.4256884447674736,4.545375898995063,0.2036204477195882,0.10835274110693478
6146,1735978398,1735981998,3600,0.36711101132011137,3.1892553955720446,0.1,0.1
6147,1735981998,1735985598,3600,0.418280272299938,3.148893343346741,0.1,0.1
6148,1735985598,1735988243,2645,1.6958999322537889,4.543158517299345,0.4366194531356511,0.3958333974513777
6149,1735989198,1735992798,3600,0.48857899865933807,3.1612833049058344,0.1,0.1
6150,1735992798,1735996398,3600,0.15042878472084872,3.146430239013797,0.1,0.1
6151,1735996398,1735998372,1974,2.4654546347593747,4.6550521222185575,0.8199360158229245,0.16409840713073448
6152,1735999998,1736003598,3600,0.15699329732633252,3.065681188614789,0.1,0.1
6153,1736003598,1736007198,3600,0.2566090924270255,3.1086737810239455,0.1,0.1
6154,1736007198,1736010798,3600,0.10974015700123196,3.1366508110087867,0.1,0.1
6155,1736010798,1736014190,3392,2.0490285668815043,4.644333486714219,0.5574094717387348,0.23339537138797709
6156,1736014398,1736017333,2935,2.3691771551629737,4.413964628689347,0.9282371908672705,0.21431522095547412
6157,1736017998,1736018520,522,0.7257920671099458,3.694785279679672,0.6014670517068879,0.5512815250599332
6158,1736021598,1736023639,2041,1.5409855808023893,4.39623150862815,0.7949666415729147,0.7752703154284877
6159,1736025198,1736025400,202,0.6559837767214565,3.616249328900314,0.6224438771066441,0.9998638062553304
6160,1736028798,1736032316,3518,1.8476188483069764,4.637624542918012,0.1681815769651206,0.5723484631288333
6161,1736032398,1736035548,3150,1.6930780389902018,4.501521731266927,0.9106366025315512,0.625015320094907
6162,1736035998,1736039017,3019,1.9572739300923578,4.536827190902952,0.3785388936849209,0.9185809910251447
6163,1736039598,1736041306,1708,1.3454876577209194,3.8570290398928924,0.9146949613636399,0.14427009866624263
6164,1736043198,1736044362,1164,1.062453919531504,4.169029889061249,0.17312610526584687,0.9118117026317958
6165,1736046798,1736050398,3600,0.20209734605443522,3.0971719585110504,0.1,0.1
6166,1736050398,1736053393,2995,1.6315475150570724,4.410152584792475,0.8471819714508526,0.38548413877702725
6167,1736053998,1736056329,2331,2.064897338005667,4.392721812866663,0.6257848445437897,0.60714878020386
6168,1736057598,1736061198,3600,0.3586101978471855,3.080921017846272,0.1,0.1
6169,1736061198,1736064798,3600,0.3482004654114604,3.1272055689323057,0.1,0.1
6170,1736064798,1736068398,3600,0.16844714177418335,3.1274588914883967,0.1,0.1
6171,1736068398,1736071998,3600,0.21682648365368773,3.008759727409191,0.1,0.1
6172,1736071998,1736072260,262,0.9881444690497592,3.546545181262391,0.15426428091929892,0.26771602081843193
6173,1736075598,1736079198,3600,0.2944241882588179,3.1139205338668625,0.1,0.1
6174,1736079198,1736082798,3600,0.3456828033687194,3.1048370429998124,0.1,0.1
6175,1736082798,1736086398,3600,0.21489470694825266,3.028792017589381,0.1,0.1
6176,1736086398,1736089998,3600,0.13246984489841285,3.036006254403089,0.1,0.1
6177,1736089998,1736093598,3600,0.3263085334490057,3.0530140958454624,0.1,0.1
6178,1736093598,1736097198,3600,0.48587651931671305,3.095519412656006,0.1,0.1
6179,1736097198,1736100798,3600,0.20409835673628846,3.1609952342663177,0.1,0.1
6180,1736100798,1736104163,3365,1.5863950016166124,4.332999338798706,0.9437838116344077,0.17702199849416655
6181,1736104398,1736104815,417,0.5675790784183752,3.4824439847139796,0.14248313076558142,0.5552506382032343
6182,1736107998,1736108205,207,0.7883283537892745,3.6287553869040576,0.10146958352954662,0.8635669115400699
6183,1736111598,1736115198,3600,0.12102839239911192,3.073925310539443,0.1,0.1
6184,1736115198,1736118798,3600,0.2687924844789781,3.077048115310358,0.1,0.1
6185,1736118798,1736122398,3600,0.23325909837424802,3.134936953594363,0.1,0.1
6186,1736122398,1736125462,3064,1.5508166603848053,4.426074985791998,0.7922066930135536,0.8709883626627642
6187,1736125998,1736127044,1046,1.1777067113603916,4.158566341928021,0.6518895129138107,0.3629892991178155
6188,1736129598,1736130079,481,0.6291825428742099,3.6534244799875406,0.7417890287651698,0.16006060244103545
6189,1736133198,1736134588,1390,1.0851884804398937,3.9070195597483384,0.8226375411288238,0.7033907369388143
6190,1736136798,1736140398,3600,0.4124771001275398,3.063095185979159,0.1,0.1
6191,1736140398,1736143998,3600,0.19857399369506137,3.1750404075154006,0.1,0.1
6192,1736143998,1736147598,3600,0.4655963782513718,3.0375450016644767,0.1,0.1
6193,1736147598,1736151198,3600,0.3809702343985585,3.1278581003109185,0.1,0.1
6194,1736151198,1736154798,3600,0.39389730266769807,3.0007084260416845,0.1,0.1
6195,1736154798,1736155794,996,1.3980502901903225,3.8333151398575493,0.9905779899828532,0.6125343869269342
6196,1736158398,1736161998,3600,0.29623687077501804,3.0767836325287683,0.1,0.1
6197,1736161998,1736162459,461,0.5722695858296178,3.5643516113497404,0.8038206003794484,0.5398242987927835
6198,1736165598,1736168802,3204,1.7895044658297112,4.573833032840692,0.7183131494014,0.6101036185647796
6199,1736169198,1736172798,3600,0.49976754477816554,3.0036588621771405,0.1,0.1
6200,1736172798,1736175151,2353,2.288484315815126,4.505808268520855,0.5026945662169429,0.8061677728972667
6201,1736176398,1736179998,3600,0.3407395981603175,3.139717948571293,0.1,0.1
6202,1736179998,1736183598,3600,0.3013718171583727,3.062532853390766,0.1,0.1
6203,1736183598,1736186689,3091,2.423939298509972,4.572671344824552,0.55577056878531,0.4592719989235384
6204,1736187198,1736190798,3600,0.47258043723524057,3.020697021825082,0.1,0.1
6205,1736190798,1736191377,579,0.7583516030335768,3.43843203696784,0.3377167402484677,0.501135132207796
6206,1736194398,1736197120,2722,1.8314413423446299,4.330364706861943,0.9149919001162844,0.39929652007810146
6207,1736197998,1736201169,3171,2.2621635901625226,4.41873661975322,0.18531934531525798,0.6032433764997225
6208,1736201598,1736204203,2605,2.104294447600828,4.44199905920474,0.9782131479018764,0.7332240894794876
6209,1736205198,1736208798,3600,0.401185339808077,3.156590992835252,0.1,0.1
6210,1736208798,1736212398,3600,0.4395024749397257,3.101199907232835,0.1,0.1
6211,1736212398,1736215998,3600,0.18030150834776465,3.164951704392725,0.1,0.1
6212,1736215998,1736216881,883,1.299755780741686,3.877169838184075,0.4694622441726368,0.909502770010551
6213,1736219598,1736221424,1826,2.485428885624974,4.6028159203249785,0.28219569087916296,0.1944471027638292
6214,1736223198,1736223668,470,0.6124308256287964,3.5543201551901245,0.9865179723031232,0.24415952962432588
6215,1736226798,1736230398,3600,0.3937748970646552,3.114659125446178,0.1,0.1
6216,1736230398,1736233998,3600,0.35291791340153433,3.164030380956185,0.1,0.1
6217,1736233998,1736237598,3600,0.3518701214799592,3.0736233083179823,0.1,0.1
6218,1736237598,1736240247,2649,2.370842984793498,4.532908259215366,0.39302224635342486,0.8393694418273967
6219,1736241198,1736244155,2957,2.434830210825201,4.411313845118506,0.880347626106919,0.3998060919103831
6220,1736244798,1736248398,3600,0.49982370305503543,3.1980645250332516,0.1,0.1
6221,1736248398,1736251998,3600,0.41459046350180606,3.0913155885869137,0.1,0.1
6222,1736251998,1736255598,3600,0.4340005986803215,3.1085223508166386,0.1,0.1
6223,1736255598,1736259198,3600,0.3240922507280741,3.1961689138596494,0.1,0.1
6224,1736259198,1736262798,3600,0.2748526779612762,3.192862253535328,0.1,0.1
6225,1736262798,1736266398,3600,0.38169715107654156,3.1872085011529747,0.1,0.1
6226,1736266398,1736268670,2272,1.8734195202701711,4.325194061324813,0.9077318065930694,0.662964176948072
6227,1736269998,1736271109,1111,1.0221755305384255,4.03748429170156,0.3219748856806062,0.7640367165714674
6228,1736273598,1736277198,3600,0.3850119742441591,3.186878055430954,0.1,0.1
6229,1736277198,1736280798,3600,0.39481893677753954,3.0568144806828945,0.1,0.1
6230,1736280798,1736283814,3016,2.422616015179349,4.680614754220889,0.6115171892915288,0.34576952357876733
6231,1736284398,1736287998,3600,0.42147421433674825,3.16977360613897,0.1,0.1
6232,1736287998,1736291598,3600,0.29788101813659296,3.0298978469911084,0.1,0.1
6233,1736291598,1736292651,1053,1.3773441352278009,3.970422232186793,0.5646287985188203,0.563315530514459
6234,1736295198,1736297901,2703,2.3709276070728094,4.356077295935832,0.7495026618146297,0.8596311406919179
6235,1736298798,1736298866,68,0.7403371870474004,3.466063940589927,0.357927842997812,0.3771737418125274
6236,1736302398,1736305935,3537,1.8403291397090231,4.654035281819078,0.5081657576040625,0.9541507492203734
6237,1736305998,1736309598,3600,0.2926174882200193,3.0151359934933413,0.1,0.1
6238,1736309598,1736312561,2963,2.2841002075913615,4.514891806302268,0.5163981571710272,0.5449711868251316
6239,1736313198,1736316798,3600,0.13468140781684382,3.0775981622044406,0.1,0.1
6240,1736316798,1736317625,827,1.295612149215839,3.8730858813640503,0.9758183933095742,0.7110240678395029
6241,1736320398,1736322622,2224,2.419438145116046,4.393776206165816,0.7055266660106653,0.12545677730842583
6242,1736323998,1736327496,3498,1.700410085241095,4.4688333345265585,0.9991225514882054,0.7419394214664
6243,1736327598,1736328687,1089,1.23329905829454,3.8410255896788814,0.5616077721367188,0.8196716433210889
6244,1736331198,1736332621,1423,1.354239277819887,3.9029965913566635,0.9921345393737899,0.23933163612685462
6245,1736334798,1736337765,2967,2.441016527562354,4.342889070986617,0.39827337828155895,0.42740702843133405
6246,1736338398,1736341978,3580,2.0700450105980766,4.303921257390906,0.43029786881682974,0.8424614174025452
6247,1736341998,1736344139,2141,1.6191631736755756,4.667552531723492,0.5558109656722455,0.7085682460683498
6248,1736345598,1736349198,3600,0.4433993152925573,3.05509634902796,0.1,0.1
6249,1736349198,1736351211,2013,1.6752928938535163,4.595897200168094,0.8565840544235863,0.5590202948983093
6250,1736352798,1736356398,3600,0.49433839832827464,3.008127070801274,0.1,0.1
6251,1736356398,1736357933,1535,1.4265725517967536,4.038943857593834,0.9600988909304339,0.3374994665652485
6252,1736359998,1736360728,730,1.4716630408328646,3.8573695057979345,0.9449891282871948,0.9514698784789088
6253,1736363598,1736367057,3459,2.1296690506973697,4.33241403772877,0.805562657111677,0.33823472293642953
6254,1736367198,1736368238,1040,1.1369057939687681,4.182686897950512,0.528562191578787,0.762756639972173
6255,1736370798,1736374398,3600,0.11781563328193112,3.0747504591938584,0.1,0.1
6256,1736374398,1736375123,725,1.441105616901342,3.909151628918451,0.23445245619257155,0.4588556800082487
6257,1736377998,1736381598,3600,0.21120653770963235,3.1170402155112735,0.1,0.1
6258,1736381598,1736385198,3600,0.21163505200987132,3.110049793381036,0.1,0.1
6259,1736385198,1736388798,3600,0.2893684801564762,3.129893587488404,0.1,0.1
6260,1736388798,1736392398,3600,0.10960989895372064,3.082248084767256,0.1,0.1
6261,1736392398,1736395998,3600,0.4585582866223743,3.004342330630404,0.1,0.1
6262,1736395998,1736399009,3011,1.811221847747893,4.501642804288365,0.49767002355894674,0.6417123868058682
6263,1736399598,1736402575,2977,1.7200960817705298,4.550093362152445,0.6179842717277771,0.6853703991208059
6264,1736403198,1736406798,3600,0.3465751941268625,3.002981223069827,0.1,0.1
6265,1736406798,1736409373,2575,1.8173131664696152,4.3707135421419325,0.16594480859858335,0.661950317139848
6266,1736410398,1736410968,570,0.6088132699367719,3.5736721292641684,0.4427243743085718,0.821301460838665
6267,1736413998,1736417475,3477,2.2601285117412573,4.42937430151998,0.8258319451326495,0.23731030884200266
6268,1736417598,1736421198,3600,0.1990040934886042,3.093857385955998,0.1,0.1
6269,1736421198,1736424798,3600,0.26147140240628125,3.097643433135565,0.1,0.1
6270,1736424798,1736427747,2949,1.7883909698721323,4.532960761088591,0.6493483044285693,0.5448639532965426
6271,1736428398,1736428823,425,0.8864621825041719,3.4867327992788693,0.7304958183786135,0.7196161656847803
6272,1736431998,1736435598,3600,0.32761995663834914,3.1994193908933046,0.1,0.1
6273,1736435598,1736439198,3600,0.15610701819283387,3.1905492686826515,0.1,0.1
6274,1736439198,1736442798,3600,0.2985051749907024,3.141317088126375,0.1,0.1
6275,1736442798,1736446398,3600,0.43466634981990937,3.020890795156268,0.1,0.1
6276,1736446398,1736449998,3600,0.47339728740971,3.1436079689190652,0.1,0.1
6277,1736449998,1736453598,3600,0.4508419108798468,3.195256068355436,0.1,0.1
6278,1736453598,1736457198,3600,0.2905138964125294,3.0124122318974167,0.1,0.1
6279,1736457198,1736460798,3600,0.3251180729385048,3.160065742369193,0.1,0.1
6280,1736460798,1736464398,3600,0.14948198451327707,3.117161168233939,0.1,0.1
6281,1736464398,1736465129,731,1.1546735045699625,4.049939790711935,0.4870582315165446,0.3263007788454417
6282,1736467998,1736471598,3600,0.3805850392806399,3.1678629363678814,0.1,0.1
6283,1736471598,1736475198,3600,0.22810128315817538,3.054454421623037,0.1,0.1
6284,1736475198,1736475894,696,1.4680328372332587,4.150176166392801,0.7450973775847204,0.2956032114441677
6285,1736478798,1736481718,2920,1.8598838622944744,4.578489454120959,0.3362518839943274,0.41142587214893156
6286,1736482398,1736482732,334,0.9114723392069772,3.65053342754527,0.6280880388360925,0.12815941151932406
6287,1736485998,1736486725,727,1.4181119980971577,3.9629909524728117,0.540036330637628,0.4299497190721756
6288,1736489598,1736489698,100,0.6755376510070559,3.558387285387174,0.4718594010816377,0.5324990593026028
6289,1736493198,1736496798,3600,0.16197021876196735,3.0968995766969174,0.1,0.1
6290,1736496798,1736496898,100,0.7992880182603963,3.4756908688543176,0.13846245132002993,0.6243692172411748
6291,1736500398,1736503998,3600,0.29067420070075944,3.014933604838511,0.1,0.1
6292,1736503998,1736507598,3600,0.1518523895937355,3.0233072781965276,0.1,0.1
6293,1736507598,1736511198,3600,0.41874611135143425,3.020886125292318,0.1,0.1
6294,1736511198,1736513130,1932,1.5505834644621315,4.699054422430591,0.19289595377686405,0.47645186039824605
6295,1736514798,1736518398,3600,0.42050963954072273,3.050821416553185,0.1,0.1
6296,1736518398,1736521352,2954,2.482860106032488,4.58751190661007,0.8921598210524431,0.3671676281797839
6297,1736521998,1736523968,1970,2.336551604238438,4.449314071487483,0.843405433182183,0.8296427659496205
6298,1736525598,1736526424,826,1.3599168601812268,3.8084317104007672,0.1994423936519767,0.7193981031688608
6299,1736529198,1736529749,551,0.585385853200554,3.5748981383288783,0.9203666176243616,0.31623782342323103
6300,1736532798,1736534340,1542,1.1861399539013697,3.955335919396928,0.6996443622173156,0.37894909163304247
6301,1736536398,1736536775,377,0.9288595265259396,3.4081427820264905,0.6403767654190916,0.8587994209707692
6302,1736539998,1736543598,3600,0.10827886781246399,3.1963721229910536,0.1,0.1
6303,1736543598,1736547198,3600,0.23224619803519242,3.162701658478964,0.1,0.1
6304,1736547198,1736548341,1143,1.4414090981875174,3.8451251452811905,0.11235846932526888,0.8163466078725655
6305,1736550798,1736554398,3600,0.44131411668909604,3.0330006718915836,0.1,0.1
6306,1736554398,1736557998,3600,0.30032823345789117,3.154512112360795,0.1,0.1
6307,1736557998,1736561598,3600,0.21635768201434216,3.1317124263210636,0.1,0.1
6308,1736561598,1736563021,1423,1.2712494729687882,3.934854059470601,0.603256364658073,0.9916354302476802
6309,1736565198,1736568798,3600,0.27940882005653067,3.158145372735122,0.1,0.1
6310,1736568798,1736572398,3600,0.44372130284875755,3.091609127300162,0.1,0.1
6311,1736572398,1736573566,1168,1.0778765166116062,4.093274851249559,0.9874773671721712,0.17171216739238981
6312,1736575998,1736579598,3600,0.43091202008471063,3.054658192114014,0.1,0.1
6313,1736579598,1736583198,3600,0.32583579005452845,3.0663146096907914,0.1,0.1
6314,1736583198,1736586798,3600,0.2667036016933562,3.0193200180886453,0.1,0.1
6315,1736586798,1736588196,1398,1.278290976760469,4.064462452415629,0.7226335255039142,0.8563820680764229
6316,1736590398,1736593998,3600,0.34861256143905806,3.17737891689745,0.1,0.1
6317,1736593998,1736597598,3600,0.14696022876836043,3.0348220037738605,0.1,0.1
6318,1736597598,1736600251,2653,2.2853495380759687,4.329452874543342,0.9654829233532889,0.1363631281052854
6319,1736601198,1736603134,1936,1.694845217873312,4.347636485503287,0.8649543985952967,0.7849488578906866
6320,1736604798,1736605495,697,1.3984108918551152,3.9866158747850102,0.6565185022298345,0.7462015208249404
6321,1736608398,1736611721,3323,2.217546971270587,4.512413587234275,0.6255499246231782,0.5238206240780844
6322,1736611998,1736613887,1889,2.220164029517914,4.453644410058304,0.4328659227343741,0.4626346602128353
6323,1736615598,1736619198,3600,0.3841739285372251,3.0367886008709584,0.1,0.1
6324,1736619198,1736622798,3600,0.37155829072042323,3.174303119477409,0.1,0.1
6325,1736622798,1736626398,3600,0.13282792416440145,3.002060343246687,0.1,0.1
6326,1736626398,1736628582,2184,2.407795555143114,4.527286892076756,0.18520890234852638,0.4670027388382044
6327,1736629998,1736633598,3600,0.49219396438716156,3.1718867602539835,0.1,0.1
6328,1736633598,1736637198,3600,0.15457447971928315,3.093521182676504,0.1,0.1
6329,1736637198,1736640798,3600,0.3680896469809508,3.0742261675906857,0.1,0.1
6330,1736640798,1736644398,3600,0.19990977313559163,3.005685609986549,0.1,0.1
6331,1736644398,1736646638,2240,1.7309332705819842,4.389435468950429,0.8065234860813607,0.5538523145030144
6332,1736647998,1736648937,939,1.205323244606534,4.055546492931969,0.8227858105116974,0.8951014533659474
6333,1736651598,1736655198,3600,0.2562612144101782,3.095787995177585,0.1,0.1
6334,1736655198,1736658798,3600,0.43658897784318296,3.0938405446563504,0.1,0.1
6335,1736658798,1736661731,2933,2.4211025504302492,4.633438374777888,0.5413885952756591,0.13226179748012337
6336,1736662398,1736665998,3600,0.45802432026621953,3.1660255727645668,0.1,0.1
6337,1736665998,1736669598,3600,0.2022255344662492,3.0809172021946063,0.1,0.1
6338,1736669598,1736673025,3427,2.1094478210793772,4.560747651554664,0.5847222099708451,0.24509701534829018
6339,1736673198,1736676798,3600,0.12300850077860553,3.161324911759625,0.1,0.1
6340,1736676798,1736680398,3600,0.4883886016634724,3.176977667669523,0.1,0.1
6341,1736680398,1736683838,3440,2.203793959257404,4.4923338283258865,0.3759164671424965,0.27888216163373014
6342,1736683998,1736684733,735,1.2352076987778111,4.066747199335709,0.9048284799141046,0.29967117899899687
6343,1736687598,1736688524,926,1.4509868206556327,4.152534473581489,0.68439164004244,0.6506530765943395
6344,1736691198,1736692307,1109,1.392485588669449,3.992431088952122,0.8232331753228792,0.6743402558379435
6345,1736694798,1736698192,3394,2.392235636914096,4.543004529390609,0.22867389744105301,0.9864870364313958
6346,1736698398,1736701447,3049,2.482348012163709,4.557715687684794,0.35597229966731936,0.9740555914201288
6347,1736701998,1736704371,2373,1.8842748036243786,4.359281698807661,0.2878082423421875,0.856978788982965
6348,1736705598,1736709198,3600,0.37593518790274494,3.157066270717509,0.1,0.1
6349,1736709198,1736711866,2668,2.3382388518585535,4.551814173743975,0.2694499645966006,0.8641233072678906
6350,1736712798,1736716398,3600,0.22249033755829864,3.1561421812035007,0.1,0.1
6351,1736716398,1736719998,3600,0.19875773685998058,3.0458935851183657,0.1,0.1
6352,1736719998,1736723117,3119,2.4931494540514114,4.529742526961911,0.6417290106245667,0.48139400980184155
6353,1736723598,1736727198,3600,0.46932305892100956,3.19077995143421,0.1,0.1
6354,1736727198,1736728813,1615,1.2915761905914327,4.152447213526449,0.44511270076025156,0.6987591939803224
6355,1736730798,1736734398,3600,0.4893527596311992,3.132228730901131,0.1,0.1
6356,1736734398,1736737044,2646,2.387504962375429,4.478265423510011,0.31286775024445146,0.10403381111004018
6357,1736737998,1736741598,3600,0.38759591964972806,3.02296639162045,0.1,0.1
6358,1736741598,1736745198,3600,0.12884152066539123,3.1642202211877004,0.1,0.1
6359,1736745198,1736748798,3600,0.47665279502385827,3.027534824619303,0.1,0.1
6360,1736748798,1736750007,1209,1.1870620642230358,3.9522348825335487,0.10294858358992721,0.1216914496798226
6361,1736752398,1736752474,76,0.8423817482896224,3.301781457324563,0.9574010568672637,0.20498381886146286
6362,1736755998,1736759598,3600,0.24968486480722643,3.023982407368409,0.1,0.1
6363,1736759598,1736762458,2860,2.119917038109901,4.350119092803727,0.3956346951763633,0.4357170517115354
6364,1736763198,1736763534,336,0.8179204782375722,3.4179436274862423,0.3762152207414561,0.778627641404975
6365,1736766798,1736769645,2847,2.381740183916417,4.461446039786478,0.4720750000255546,0.14589938046195888
6366,1736770398,1736773998,3600,0.25864998983901244,3.006638055442099,0.1,0.1
6367,1736773998,1736775763,1765,1.2218305294428,3.976608979781815,0.44037616918352485,0.2736561086479061
6368,1736777598,1736777796,198,0.9270643141486907,3.4939892835019934,0.46771448874013577,0.4396047954595429
6369,1736781198,1736784798,3600,0.19403209310344116,3.1321648964488817,0.1,0.1
6370,1736784798,1736788398,3600,0.3039264615450257,3.1888914857511783,0.1,0.1
6371,1736788398,1736789365,967,1.3396926775488756,3.883275032422945,0.30362380414627255,0.6099228741747361
6372,1736791998,1736792825,827,1.3061592650495273,3.8368476377520873,0.9715011217793571,0.8789128074275352
6373,1736795598,1736797643,2045,1.5800368224053314,4.432054223181262,0.5305122798768307,0.7888209808885573
6374,1736799198,1736802798,3600,0.13395567800114547,3.1545548956570184,0.1,0.1
6375,1736802798,1736806370,3572,2.451671400584006,4.3241747763561555,0.67037256969633,0.7090998479447727
6376,1736806398,1736808612,2214,1.6289973427962674,4.590183864182771,0.7068229694448303,0.5201130528160484
6377,1736809998,1736812226,2228,2.359326897967693,4.368392100444458,0.32653616341094055,0.8949202063595798
6378,1736813598,1736817198,3600,0.4811479805930633,3.0208264654946024,0.1,0.1
6379,1736817198,1736820798,3600,0.13577911219662983,3.042104508675668,0.1,0.1
6380,1736820798,1736824398,3600,0.12326065805124649,3.0646174827486186,0.1,0.1
6381,1736824398,1736827998,3600,0.19214264929612065,3.1376373706209733,0.1,0.1
6382,1736827998,1736831598,3600,0.4613753856734669,3.1129460311656665,0.1,0.1
6383,1736831598,1736835198,3600,0.40169816130642344,3.0420648346142407,0.1,0.1
6384,1736835198,1736837673,2475,2.125440856239866,4.31777956416037,0.3634959300094356,0.7130946371654028
6385,1736838798,1736840167,1369,1.1241718959787046,4.066588090177862,0.9410787248802794,0.30217678722175856
6386,1736842398,1736845998,3600,0.44820394747570647,3.1060511048231962,0.1,0.1
6387,1736845998,1736846726,728,1.4033022423307475,4.135384439906053,0.8737589037644018,0.3212713249087281
6388,1736849598,1736853198,3600,0.44810839326801855,3.0994400147195744,0.1,0.1
6389,1736853198,1736855686,2488,1.5816996701678616,4.585934830471162,0.8564648417374519,0.22161776903891703
6390,1736856798,1736859517,2719,2.179789099697141,4.330494800348137,0.35800213182205254,0.7886669062782087
6391,1736860398,1736863998,3600,0.42539218609774576,3.045809685517143,0.1,0.1
6392,1736863998,1736866580,2582,1.7524318833872883,4.53957220853651,0.21637187297699417,0.7263974298085216
6393,1736867598,1736868316,718,1.3343862394218866,3.9054834595496075,0.28357274601351096,0.33372577307411144
6394,1736871198,1736874798,3600,0.2917560874302687,3.012142954331007,0.1,0.1
6395,1736874798,1736875464,666,1.115333556766606,4.184115840944293,0.6643982611430762,0.7697178233809209
6396,1736878398,1736880273,1875,2.438643153425346,4.3326511755779675,0.3059425239105767,0.5993137988800621
6397,1736881998,1736882692,694,1.1369767618029236,4.1898837047477455,0.3879719133081888,0.5654787504149605
6398,1736885598,1736889198,3600,0.15829470359086614,3.0136177080207847,0.1,0.1
6399,1736889198,1736889359,161,0.5278018016047603,3.6478338445344525,0.2703446675773905,0.40198847146418537
6400,1736892798,1736894015,1217,1.455328607851849,4.018985432299564,0.10347148192905503,0.2953197571500784
6401,1736896398,1736896672,274,0.6980076017581105,3.4897350445199304,0.7278066503670461,0.8445194828174287
6402,1736899998,1736903598,3600,0.29016057622433833,3.0569352350681362,0.1,0.1
6403,1736903598,1736907198,3600,0.18248770834136419,3.1509726146725425,0.1,0.1
6404,1736907198,1736910798,3600,0.3533594592431102,3.093377878905104,0.1,0.1
6405,1736910798,1736912912,2114,2.2932472153770034,4.558597629555924,0.492689631157222,0.6415425714127744
6406,1736914398,1736916662,2264,2.17881713198251,4.502903862126328,0.5209646341795904,0.8389588066273587
6407,1736917998,1736921598,3600,0.3019453167098845,3.186101921590135,0.1,0.1
6408,1736921598,1736922219,621,1.229310120131053,3.914349026020605,0.6974447877782541,0.9099501102758919
6409,1736925198,1736928798,3600,0.127527576305511,3.136591594678692,0.1,0.1
6410,1736928798,1736932398,3600,0.1105635064069349,3.1340575846823895,0.1,0.1
6411,1736932398,1736935998,3600,0.2117210723044515,3.121375202677587,0.1,0.1
6412,1736935998,1736939598,3600,0.11609661928162329,3.070780497104864,0.1,0.1
6413,1736939598,1736940455,857,1.3434901278296945,3.981808920380243,0.20044284242654348,0.10769659354261822
6414,1736943198,1736946798,3600,0.178762323501266,3.194479349318704,0.1,0.1
6415,1736946798,1736949581,2783,2.4823949573589443,4.464598266407645,0.2173193847365843,0.5241657809996301
6416,1736950398,1736952955,2557,2.185428220299573,4.582858973335135,0.9181472667494474,0.7432644011092177
6417,1736953998,1736957598,3600,0.4941701096483968,3.020344663644427,0.1,0.1
6418,1736957598,1736961198,3600,0.1972928361633339,3.123309533128213,0.1,0.1
6419,1736961198,1736963479,2281,2.1246840934782525,4.650712711552887,0.5963599658856122,0.33959449572643596
6420,1736964798,1736966228,1430,1.0394851471717674,4.15336270541502,0.11757038261745142,0.8430574837258374
6421,1736968398,1736971231,2833,2.1439014501134706,4.323553225339794,0.7721794298221043,0.6351871915459975
6422,1736971998,1736975598,3600,0.29492586545001276,3.1339155327805854,0.1,0.1
6423,1736975598,1736979198,3600,0.2899608403509544,3.160225351555331,0.1,0.1
6424,1736979198,1736980288,1090,1.0022131018884768,3.8206250934391677,0.3755839006358681,0.6621667825494515
6425,1736982798,1736983861,1063,1.1692314652170275,4.143378918109088,0.4406673375353316,0.5478516501710109
6426,1736986398,1736989785,3387,2.408391043308161,4.3832359679801085,0.4767819366218288,0.1686330787619001
6427,1736989998,1736993598,3600,0.4255713617765501,3.090902261805634,0.1,0.1
6428,1736993598,1736997198,3600,0.49588168272833555,3.1736229167080796,0.1,0.1
6429,1736997198,1737000798,3600,0.3987690398702861,3.185839336921119,0.1,0.1
6430,1737000798,1737002635,1837,1.8294688141019955,4.315807158759397,0.6182932343600201,0.2615927851133718
6431,1737004398,1737005782,1384,1.2299083280023377,4.198975461714725,0.3338668191280687,0.20775870564570378
6432,1737007998,1737008345,347,0.5245225076063798,3.541557669957971,0.46492983876975036,0.7318420670252492
6433,1737011598,1737013656,2058,2.357971055180738,4.675855481671745,0.89644976811666,0.26266014885018857
6434,1737015198,1737018798,3600,0.1607239769426189,3.1899832081980977,0.1,0.1
6435,1737018798,1737019161,363,0.8527417159775617,3.6994829061028764,0.8459799088613402,0.3292440342427998
6436,1737022398,1737025085,2687,2.1148586108436955,4.317506274855361,0.4846319492404647,0.23435767324828724
6437,1737025998,1737027058,1060,1.3809212505642312,3.8698699646146295,0.6891991877368463,0.6932488108500364
6438,1737029598,1737031463,1865,1.7654590052322936,4.662272078137368,0.21044590792444476,0.5147380708380006
6439,1737033198,1737036798,3600,0.36640414801352783,3.169870570336116,0.1,0.1
6440,1737036798,1737038316,1518,1.2108069385017142,3.8927737079711133,0.4938988009399431,0.4060355362782321
6441,1737040398,1737041347,949,1.0344446328436647,3.9921554630455907,0.2610415911200735,0.41748928010578623
6442,1737043998,1737047406,3408,2.363856830382113,4.448356514959575,0.9850773616395528,0.36678857199246884
6443,1737047598,1737051198,3600,0.36358873192099206,3.0026278606433845,0.1,0.1
6444,1737051198,1737054798,3600,0.26450906535266916,3.1425652288641643,0.1,0.1
6445,1737054798,1737058398,3600,0.4602609431039483,3.1985798660970466,0.1,0.1
6446,1737058398,1737060044,1646,1.271570719425655,3.931745438774959,0.20422634472956086,0.42004607323467624
6447,1737061998,1737065598,3600,0.31029647755298273,3.0927835601984297,0.1,0.1
6448,1737065598,1737069198,3600,0.10909003958046118,3.0302127373797787,0.1,0.1
6449,1737069198,1737069993,795,1.0130502891992255,4.085623294638593,0.668526332882052,0.57839463924379
6450,1737072798,1737074518,1720,1.1906210085334765,3.978463208666539,0.9813522460286525,0.47349655184546
6451,1737076398,1737079998,3600,0.30690551766054763,3.1006406824712056,0.1,0.1
6452,1737079998,1737082725,2727,2.3992534161609163,4.601894020606015,0.5817385579651005,0.4546500861944436
6453,1737083598,1737087198,3600,0.2537524796294644,3.0989288949508316,0.1,0.1
6454,1737087198,1737088240,1042,1.0376348152850206,4.082866820853604,0.4986977570360923,0.21659607173305834
6455,1737090798,1737094398,3600,0.41620118770424563,3.1303727310014606,0.1,0.1
6456,1737094398,1737094969,571,0.5253630365771476,3.5859686044742642,0.5585294768899288,0.21464491581051448
6457,1737097998,1737098871,873,1.025256462902337,4.186383969341012,0.41529870411796943,0.5718556622382295
6458,1737101598,1737102580,982,1.0060481575292088,4.080392139121579,0.19539916182286488,0.872514000483703
6459,1737105198,1737108798,3600,0.4587298078778339,3.0007590188728144,0.1,0.1
6460,1737108798,1737112159,3361,1.8907565272965865,4.381043792405889,0.7880287600047541,0.721790919680304
6461,1737112398,1737115470,3072,1.9400252087465943,4.325793800825953,0.34619156738694745,0.8758703537298866
6462,1737115998,1737119598,3600,0.26802385133214923,3.037615746613578,0.1,0.1
6463,1737119598,1737123198,3600,0.20675478540775633,3.0131953678558965,0.1,0.1
6464,1737123198,1737125987,2789,2.3205086255653833,4.610316159164773,0.37158664190130675,0.19996930163638751
6465,1737126798,1737130398,3600,0.3708569364347194,3.1188202489364842,0.1,0.1
6466,1737130398,1737133998,3600,0.24207061260385532,3.12382951803374,0.1,0.1
6467,1737133998,1737137598,3600,0.36373320598987957,3.1938118684433308,0.1,0.1
6468,1737137598,1737139388,1790,1.338294775411539,3.928145068074375,0.7548260870425902,0.550363529224382
6469,1737141198,1737143833,2635,2.0979182433959096,4.4075601988036635,0.6416994719308116,0.9885977554622236
6470,1737144798,1737145511,713,1.3843569249828687,4.196846886601138,0.9522939618946878,0.8134300137861126
6471,1737148398,1737151998,3600,0.11315236461992245,3.0433476616266697,0.1,0.1
6472,1737151998,1737152964,966,1.4947453899775744,3.834050354676595,0.33230893984823007,0.10718735788990125
6473,1737155598,1737156719,1121,1.1940039878784587,3.9999867231357324,0.9294069337043636,0.8868712445056521
6474,1737159198,1737161597,2399,1.9803020670301912,4.633516882764322,0.6270745544247394,0.2846321589690787
6475,1737162798,1737166398,3600,0.4273568796402102,3.115438814547413,0.1,0.1
6476,1737166398,1737168777,2379,1.9984685897883907,4.51388917879919,0.9826586134145046,0.19738123403659197
6477,1737169998,1737171015,1017,1.1930181594713751,3.969752490509176,0.29704668517965965,0.8609401984067185
6478,1737173598,1737177198,3600,0.2500763844482352,3.127252365992518,0.1,0.1
6479,1737177198,1737178317,1119,1.4951117753231715,3.9772132912755507,0.7690725316619195,0.23460730310324027
6480,1737180798,1737184398,3600,0.35432969654960234,3.014724939966489,0.1,0.1
6481,1737184398,1737186466,2068,2.3005571203683925,4.662261414779684,0.1476538925933372,0.7232385790866848
6482,1737187998,1737190017,2019,1.679191008981727,4.518891611464433,0.859872556082854,0.19471168420805818
6483,1737191598,1737195198,3600,0.3839132550283644,3.150827894097114,0.1,0.1
6484,1737195198,1737198798,3600,0.1271073170198137,3.0638226606172076,0.1,0.1
6485,1737198798,1737200658,1860,2.399266003971926,4.481782667052777,0.3960420310015682,0.15129048619509097
6486,1737202398,1737205998,3600,0.2370863535417895,3.104711338381876,0.1,0.1
6487,1737205998,1737209598,3600,0.2661262742824596,3.048317422746825,0.1,0.1
6488,1737209598,1737213198,3600,0.48789085321030956,3.011877576028988,0.1,0.1
6489,1737213198,1737215550,2352,2.2257409946732585,4.347281709632055,0.7447626191508522,0.6169655205871101
6490,1737216798,1737218083,1285,1.2701149940171248,4.122927007688487,0.7957808198787364,0.13117232170485885
6491,1737220398,1737223942,3544,2.353569296222094,4.533123812018464,0.12873578789350373,0.134391938135204
6492,1737223998,1737227598,3600,0.18522880726874225,3.1215507350102416,0.1,0.1
6493,1737227598,1737231198,3600,0.12849535288008362,3.0253153325253797,0.1,0.1
6494,1737231198,1737234798,3600,0.24215040630855633,3.0697871312859326,0.1,0.1
6495,1737234798,1737236104,1306,1.0124396564194444,3.8632209282487837,0.14301731784480412,0.22462774042373984
6496,1737238398,1737241356,2958,2.0602428362885057,4.67936970004298,0.972195888316838,0.5974620507897063
6497,1737241998,1737245598,3600,0.47497987358619265,3.134280515355353,0.1,0.1
6498,1737245598,1737245740,142,0.8489521131225863,3.4853723742732052,0.46590980117950176,0.23757033821950968
6499,1737249198,1737249617,419,0.9330208455018215,3.528342692185355,0.45775817040572553,0.6201570034303456
6500,1737252798,1737255841,3043,2.0746740983442415,4.336612575468376,0.934816363937304,0.2156385893451307
6501,1737256398,1737258000,1602,1.0773183800135455,3.8158354371934955,0.6647103874724238,0.4288167832394215
6502,1737259998,1737263598,3600,0.41962614808185816,3.0667047875970557,0.1,0.1
6503,1737263598,1737267198,3600,0.4608932698901478,3.122762886396501,0.1,0.1
6504,1737267198,1737267519,321,0.9240528888191988,3.3614084686488,0.4187599635236744,0.8205088946336143
6505,1737270798,1737271782,984,1.219785119847962,4.083317647816252,0.1208335525278148,0.33925549167230395
6506,1737274398,1737277888,3490,2.4875120558246033,4.6916007707784555,0.7358314844991387,0.7994981052518689
6507,1737277998,1737279168,1170,1.3101120725380817,4.158968879409498,0.6992396254618752,0.427307752674949
6508,1737281598,1737282649,1051,1.1354418051121802,4.147120932990227,0.8191953140997196,0.6295731145967615
6509,1737285198,1737288798,3600,0.49931575327569655,3.1107127377082238,0.1,0.1
6510,1737288798,1737292398,3600,0.29333769122155245,3.137322517606769,0.1,0.1
6511,1737292398,1737294810,2412,2.0360347465005173,4.3611710790096065,0.7169444985794978,0.9174976420951279
6512,1737295998,1737299598,3600,0.38919960161551725,3.113163784346798,0.1,0.1
6513,1737299598,1737303198,3600,0.3946239437513589,3.189188012136754,0.1,0.1
6514,1737303198,1737303569,371,0.5311809120063407,3.4614277140249445,0.6266790816540074,0.49254910270883967
6515,1737306798,1737309571,2773,1.8789270308279615,4.689852512241748,0.9626024322717696,0.3531984439278436
6516,1737310398,1737313998,3600,0.2834449330334321,3.1948114326578523,0.1,0.1
6517,1737313998,1737317598,3600,0.40212526710656105,3.1829722663654056,0.1,0.1
6518,1737317598,1737321198,3600,0.1527581413775404,3.1865048696214227,0.1,0.1
6519,1737321198,1737324798,3600,0.15143608064304753,3.1559378606162736,0.1,0.1
6520,1737324798,1737328398,3600,0.44285832965739236,3.096739580042346,0.1,0.1
6521,1737328398,1737331998,3600,0.28279156066661426,3.1184692900084965,0.1,0.1
6522,1737331998,1737335513,3515,1.8461385096878198,4.695160638184839,0.19210720996843314,0.951928545289593
6523,1737335598,1737339198,3600,0.24301438732311886,3.1049968058335953,0.1,0.1
6524,1737339198,1737340777,1579,1.4298541035847847,3.9803250898471125,0.2400189448345755,0.32140116849742284
6525,1737342798,1737345888,3090,1.9397621897561934,4.521215945541338,0.5612108673240115,0.8844237624918327
6526,1737346398,1737349014,2616,2.4916446104260133,4.397231052318345,0.7087110884444947,0.9654549470528729
6527,1737349998,1737353598,3600,0.13838976384854773,3.1135277880961887,0.1,0.1
6528,1737353598,1737354103,505,0.6383960715069037,3.4797355332164877,0.13048747574469782,0.4607558915075629
6529,1737357198,1737360798,3600,0.2642270827712161,3.1862941826950935,0.1,0.1
6530,1737360798,1737364398,3600,0.18786297869250226,3.155299762232737,0.1,0.1
6531,1737364398,1737367998,3600,0.12247423462399301,3.021130562456308,0.1,0.1
6532,1737367998,1737371598,3600,0.4090828224602504,3.0870150798229323,0.1,0.1
6533,1737371598,1737374813,3215,2.061929713452784,4.6909526473997385,0.15762699675876976,0.12445947000524549
6534,1737375198,1737375706,508,0.9988834779751776,3.3196943289204173,0.7205626754936517,0.3203130971034298
6535,1737378798,1737378982,184,0.6283302212004764,3.512891883162899,0.770432540201918,0.1959083456549427
6536,1737382398,1737383497,1099,1.0979372596406405,3.91608306214769,0.5662597050590825,0.48481464241603045
6537,1737385998,1737388188,2190,2.1596938767812075,4.6662553382809255,0.40631701625799366,0.8958513475812151
6538,1737389598,1737391048,1450,1.2452721906199047,3.9600195778999234,0.8263781830053157,0.17567042650735126
6539,1737393198,1737396798,3600,0.4549830557050589,3.1162575578042526,0.1,0.1
6540,1737396798,1737400398,3600,0.36131982658981177,3.0830162798300695,0.1,0.1
6541,1737400398,1737401034,636,1.1177650707631797,4.035196280886533,0.8599791754295665,0.9587416919002314
6542,1737403998,1737404730,732,1.01784990483432,3.801652709538617,0.8121309317593715,0.5472658693936696
6543,1737407598,1737408661,1063,1.421322785771856,4.066178150426605,0.37901907965824655,0.7694908143439119
6544,1737411198,1737414798,3600,0.1610568620073909,3.187186410295157,0.1,0.1
6545,1737414798,1737418104,3306,1.9587538732814007,4.4020400637652415,0.27370175115600337,0.48650294113427417
6546,1737418398,1737420975,2577,1.5619595197843734,4.406580798388287,0.7060563836770547,0.5970890082156282
6547,1737421998,1737425598,3600,0.32454439733479945,3.0104645585629717,0.1,0.1
6548,1737425598,1737428589,2991,1.8765023561877494,4.425987475079633,0.6620609949294914,0.8449068941207183
6549,1737429198,1737431476,2278,2.131167061267144,4.553119571988025,0.10991094125680488,0.44501508621103225
6550,1737432798,1737433781,983,1.4298788005829666,3.8047735239215097,0.22314748850276583,0.17023412198098858
6551,1737436398,1737439998,3600,0.33831310463385167,3.133602231598498,0.1,0.1
6552,1737439998,1737443598,3600,0.3029771810187677,3.066532319808755,0.1,0.1
6553,1737443598,1737444148,550,0.6931558639266164,3.3104089731246207,0.8878642948107635,0.6085849402656897
6554,1737447198,1737449327,2129,2.0597618977131527,4.349988074820047,0.7085301892372616,0.5745147935365869
6555,1737450798,1737453458,2660,2.0810515900465,4.460356825104693,0.6091983686250826,0.9692083453661965
6556,1737454398,1737455901,1503,1.3436319347547807,3.872672709954924,0.945596729774844,0.2818467433240122
6557,1737457998,1737461598,3600,0.3837370296263961,3.107676475479524,0.1,0.1
6558,1737461598,1737465198,3600,0.2878577788600535,3.070854945854481,0.1,0.1
6559,1737465198,1737468798,3600,0.21902927463637442,3.0841148697709575,0.1,0.1
6560,1737468798,1737472398,3600,0.12301085034337467,3.089552997547131,0.1,0.1
6561,1737472398,1737475501,3103,2.2428223526738487,4.456053497695311,0.9014953750701069,0.9193285796796363
6562,1737475998,1737479598,3600,0.4066496778030133,3.07145618059358,0.1,0.1
6563,1737479598,1737483198,3600,0.3864087931537482,3.0236738166648567,0.1,0.1
6564,1737483198,1737486798,3600,0.26305247183535974,3.058457785267179,0.1,0.1
6565,1737486798,1737488289,1491,1.3447762059381194,3.8580014425722413,0.5835715953203141,0.7906833817253294
6566,1737490398,1737493998,3600,0.24007595146792915,3.018632449388671,0.1,0.1
6567,1737493998,1737497598,3600,0.2066556785697324,3.0322338190474514,0.1,0.1
6568,1737497598,1737497892,294,0.5739250958508834,3.3954306014244877,0.8145819360278344,0.5645772926210026
6569,1737501198,1737503161,1963,1.7525464271777584,4.3278446782071995,0.8997396358141353,0.5759563479637961
6570,1737504798,1737505690,892,1.2224360050536833,4.192160295587879,0.6927960876487641,0.2933755930262317
6571,1737508398,1737511294,2896,1.502778198907973,4.6130386338068945,0.543146941750019,0.18744312504209432
6572,1737511998,1737515598,3600,0.4134136088040996,3.085277633440907,0.1,0.1
6573,1737515598,1737519198,3600,0.19723603379071286,3.083678913437428,0.1,0.1
6574,1737519198,1737521797,2599,2.4026986248232878,4.697641805408923,0.8070584994236468,0.9330693026263751
6575,1737522798,1737526398,3600,0.4815705973393073,3.1784905239110803,0.1,0.1
6576,1737526398,1737529998,3600,0.482735595759227,3.1978487892874097,0.1,0.1
6577,1737529998,1737531918,1920,1.5517349002905982,4.593810387492967,0.40060879680429884,0.5148321303847753
6578,1737533598,1737537198,3600,0.4794062725147413,3.0274779311332902,0.1,0.1
6579,1737537198,1737540798,3600,0.21169869219424428,3.1885818517847784,0.1,0.1
6580,1737540798,1737544398,3600,0.4917146229406957,3.1189276013877443,0.1,0.1
6581,1737544398,1737547998,3600,0.3356970369807363,3.1605054677083753,0.1,0.1
6582,1737547998,1737550878,2880,2.2202150338626176,4.523152134769441,0.28867659108955207,0.9920524091520719
6583,1737551598,1737555198,3600,0.3954298040513037,3.1391911474554197,0.1,0.1
6584,1737555198,1737557513,2315,2.072910964188962,4.556399552777881,0.4550656584018653,0.563427465276482
6585,1737558798,1737562398,3600,0.4727201557302385,3.136429942092061,0.1,0.1
6586,1737562398,1737565998,3600,0.4840479580117262,3.168648628884673,0.1,0.1
6587,1737565998,1737569598,3600,0.13629178340878548,3.1950076253710327,0.1,0.1
6588,1737569598,1737573198,3600,0.1110330022726124,3.177929287904904,0.1,0.1
6589,1737573198,1737576798,3600,0.3186098730567326,3.191477757570193,0.1,0.1
6590,1737576798,1737579448,2650,2.18680447063102,4.306282765727374,0.8043448807520621,0.9961306816067824
6591,1737580398,1737583998,3600,0.3185978082864699,3.182635098460717,0.1,0.1
6592,1737583998,1737585573,1575,1.4346765196422646,4.096591563278001,0.7423353195050318,0.670326801739432
6593,1737587598,1737591198,3600,0.2701826283533816,3.0544002672982002,0.1,0.1
6594,1737591198,1737594798,3600,0.3502489085858126,3.0918435236048687,0.1,0.1
6595,1737594798,1737596714,1916,2.063355275983082,4.340156356349389,0.4933952711727626,0.10167207099085636
6596,1737598398,1737599629,1231,1.0891905019839814,4.125314109140786,0.9856705136282381,0.3763411791891802
6597,1737601998,1737602301,303,0.7538658161040368,3.6300395647775034,0.13065852039102568,0.21201343784161578
6598,1737605598,1737609198,3600,0.16840086370157126,3.1757242031018333,0.1,0.1
6599,1737609198,1737612594,3396,2.3374866911696266,4.66847930963229,0.3785070323934193,0.13351649349763192
6600,1737612798,1737616398,3600,0.355237764298748,3.1305743692411525,0.1,0.1
6601,1737616398,1737619998,3600,0.1691359208185267,3.188145042974954,0.1,0.1
6602,1737619998,1737623598,3600,0.2533526906140934,3.129525858478178,0.1,0.1
6603,1737623598,1737623836,238,0.5717133300113949,3.3899706530733362,0.2775782272622695,0.2502470531504915
6604,1737627198,1737629585,2387,1.5344033467035874,4.61402474371895,0.7970158280341382,0.3139453191350262
6605,1737630798,1737634398,3600,0.29539181512726165,3.097468683489638,0.1,0.1
6606,1737634398,1737635682,1284,1.0815353929310192,4.03201691774148,0.6503650684963459,0.684686027000495
6607,1737637998,1737641598,3600,0.45590027852727977,3.0020930006923754,0.1,0.1
6608,1737641598,1737645198,3600,0.23103969867858815,3.176724548255557,0.1,0.1
6609,1737645198,1737646810,1612,1.2334339499958091,3.8904063534159525,0.3193398280190367,0.5875337206723615
6610,1737648798,1737650973,2175,2.4532359523861174,4.360025902399672,0.230388200055817,0.4374957911304568
6611,1737652398,1737654546,2148,2.402785925183291,4.646383559769116,0.6127558277610767,0.813340697444481
6612,1737655998,1737659598,3600,0.14879738506960516,3.0474707066367213,0.1,0.1
6613,1737659598,1737662198,2600,1.875134449302121,4.65907122898686,0.22131077091558643,0.8552957066150322
6614,1737663198,1737666798,3600,0.3110979076932924,3.1350602113789807,0.1,0.1
6615,1737666798,1737667404,606,1.306110192977628,3.846285681538471,0.4394803076048245,0.9562380554819256
6616,1737670398,1737673851,3453,2.1606468181475282,4.388200169926892,0.9678494566591083,0.5913977346577716
6617,1737673998,1737674107,109,0.6555831168704056,3.373807404539557,0.22136594448904978,0.3330248855178627
6618,1737677598,1737679558,1960,2.244382480071944,4.333351923493253,0.8110109354171526,0.6580098745964205
6619,1737681198,1737684798,3600,0.3354706583397916,3.108322082104204,0.1,0.1
6620,1737684798,1737688311,3513,2.00724217683189,4.349566227511201,0.7145334783004867,0.1918673545732182
6621,1737688398,1737691998,3600,0.4301143261420931,3.1765149991724093,0.1,0.1
6622,1737691998,1737695598,3600,0.21919790089666039,3.165532366546218,0.1,0.1
6623,1737695598,1737698018,2420,2.145155309706585,4.6117819389864385,0.1420484930728116,0.44481781345212934
6624,1737699198,1737702798,3600,0.3342268565746359,3.106492359525818,0.1,0.1
6625,1737702798,1737705241,2443,2.1464272592460514,4.56664148411977,0.5728872471862939,0.8514614506698778
6626,1737706398,1737709998,3600,0.11384477161114868,3.053835310609196,0.1,0.1
6627,1737709998,1737712917,2919,1.8082689117897237,4.356185948878154,0.7742314455311508,0.7684709975940711
6628,1737713598,1737715918,2320,2.3376850980484174,4.593727028853439,0.11383862611254005,0.20230087856763845
6629,1737717198,1737717620,422,0.5824255615443905,3.682446134912019,0.183049076687461,0.38688946209991104
6630,1737720798,1737722637,1839,1.836559112349351,4.420401740857975,0.6966131421859292,0.48501516220363217
6631,1737724398,1737727662,3264,2.247553338747183,4.379200386274292,0.6761107790109623,0.9649200123891083
6632,1737727998,1737731598,3600,0.33994307989692285,3.0694167961418093,0.1,0.1
6633,1737731598,1737732775,1177,1.3765624553259084,4.01410140227217,0.8736992032876588,0.18598373937575297
6634,1737735198,1737738452,3254,2.075376461850775,4.38123064307446,0.3015779023819578,0.11275170053955527
6635,1737738798,1737740493,1695,1.4745576251972412,4.15580044064992,0.6138640866279798,0.24244821603784947
6636,1737742398,1737745998,3600,0.42818189573521825,3.1929413429292794,0.1,0.1
6637,1737745998,1737749598,3600,0.2627405314336053,3.095741800396573,0.1,0.1
6638,1737749598,1737753198,3600,0.18242273759281447,3.146628005596456,0.1,0.1
6639,1737753198,1737756798,3600,0.19383200447740354,3.176635079407191,0.1,0.1
6640,1737756798,1737759193,2395,1.7920935884155265,4.474732654816038,0.31905458819463306,0.9447562104102697
6641,1737760398,1737763998,3600,0.14138321863212436,3.138786228281168,0.1,0.1
6642,1737763998,1737767598,3600,0.4200004792642279,3.0283808078049663,0.1,0.1
6643,1737767598,1737769309,1711,1.432658851503093,3.9582971641462317,0.32840580468215363,0.27746884492024043
6644,1737771198,1737774798,3600,0.17964917408379721,3.168675996608291,0.1,0.1
6645,1737774798,1737776660,1862,1.53335142653407,4.579723778625971,0.7879670736283371,0.89279513820663
6646,1737778398,1737780950,2552,1.6434058138220884,4.350351825736765,0.7704899041788793,0.6439565248892677
6647,1737781998,1737785598,3600,0.4658175055808338,3.000044223920555,0.1,0.1
6648,1737785598,1737789198,3600,0.36323033469736565,3.0889366656128256,0.1,0.1
6649,1737789198,1737792798,3600,0.1672435116060173,3.196565302709391,0.1,0.1
6650,1737792798,1737795362,2564,1.897938798567877,4.319930309260452,0.2057260815715618,0.9034403876291432
6651,1737796398,1737797119,721,1.0639401791884102,3.953075017723422,0.42204778926687414,0.9207153415309514
6652,1737799998,1737803598,3600,0.11912519155296933,3.1826465964156174,0.1,0.1
6653,1737803598,1737807198,3600,0.29177292812474853,3.1977326280987843,0.1,0.1
6654,1737807198,1737810798,3600,0.4241754834296758,3.084214121762589,0.1,0.1
6655,1737810798,1737814398,3600,0.1902776297103257,3.1191746415161443,0.1,0.1
6656,1737814398,1737817998,3600,0.22395464963563072,3.0971234236366705,0.1,0.1
6657,1737817998,1737821598,3600,0.36163585558333555,3.052731520244245,0.1,0.1
6658,1737821598,1737825198,3600,0.17652518395729225,3.1941396024004574,0.1,0.1
6659,1737825198,1737828798,3600,0.4122995608557015,3.075019940964477,0.1,0.1
6660,1737828798,1737830283,1485,1.482658992458271,4.016136169571165,0.1953376113997241,0.12738270327043652
6661,1737832398,1737834348,1950,2.036701671223651,4.57549955014172,0.20437870200652136,0.31896780275969494
6662,1737835998,1737839598,3600,0.39197863350544837,3.175684228930614,0.1,0.1
6663,1737839598,1737842965,3367,1.5388334263347607,4.41122750992113,0.20207776277320455,0.9170355056627632
6664,1737843198,1737846798,3600,0.19830303318318956,3.018012353107766,0.1,0.1
6665,1737846798,1737850398,3600,0.40644635578836685,3.0705423873494277,0.1,0.1
6666,1737850398,1737853541,3143,2.1976710555236263,4.607202357529588,0.10863296822420171,0.9431558221951762
6667,1737853998,1737854755,757,1.200634145382555,3.916653210037734,0.45670123804312757,0.9251450666626381
6668,1737857598,1737861198,3600,0.25714807769961656,3.1244006716544535,0.1,0.1
6669,1737861198,1737862602,1404,1.0617860063665105,3.967439858662416,0.4678673137791991,0.5405461414657402
6670,1737864798,1737868259,3461,2.2210586849014686,4.349333268582054,0.7151796406096305,0.7076960984588064
6671,1737868398,1737871998,3600,0.12796684495445937,3.0596586794473315,0.1,0.1
6672,1737871998,1737874627,2629,2.2790420124170514,4.352507879374692,0.918949763873046,0.5034553163430622
6673,1737875598,1737879198,3600,0.16979950667349736,3.181606185243788,0.1,0.1
6674,1737879198,1737882798,3600,0.31952741117653627,3.180809660791384,0.1,0.1
6675,1737882798,1737886398,3600,0.42268550679958117,3.1815958380932265,0.1,0.1
6676,1737886398,1737889998,3600,0.36621185628507036,3.0616623524490434,0.1,0.1
6677,1737889998,1737893569,3571,1.6442727002963826,4.5263749138215434,0.3915017472375586,0.354543533300285
6678,1737893598,1737897198,3600,0.2954882130450276,3.081060794005617,0.1,0.1
6679,1737897198,1737900798,3600,0.40617563646999344,3.1937581342825987,0.1,0.1
6680,1737900798,1737901156,358,0.9350120347389648,3.5585898863921903,0.6991535734107485,0.9676889038574222
6681,1737904398,1737906221,1823,2.187687408462314,4.471491040646642,0.8742503521275494,0.2107881161883936
6682,1737907998,1737909627,1629,1.4063750265664583,4.051445050786134,0.7800214529403642,0.7141013901793457
6683,1737911598,1737915198,3600,0.3609947991414678,3.1546454358156,0.1,0.1
6684,1737915198,1737918798,3600,0.37600448796913855,3.0676267046871306,0.1,0.1
6685,1737918798,1737922198,3400,1.6158988480575855,4.6993308579185475,0.8064013723486833,0.5433593698257372
6686,1737922398,1737925906,3508,2.29465226915691,4.353128850352745,0.7530516786804301,0.4472622978484424
6687,1737925998,1737929598,3600,0.3377595043959272,3.1088404887522616,0.1,0.1
6688,1737929598,1737933198,3600,0.31009222146972104,3.090475082861917,0.1,0.1
6689,1737933198,1737936798,3600,0.3867298415204118,3.1764598788838625,0.1,0.1
6690,1737936798,1737940398,3600,0.23412142902749777,3.073009050778513,0.1,0.1
6691,1737940398,1737940988,590,0.9650448904509206,3.522147718227906,0.23956461507250948,0.8212599370723569
6692,1737943998,1737944357,359,0.7073046680626309,3.682811625785925,0.11592885536688396,0.4430830114977161
6693,1737947598,1737950122,2524,2.0908004606160557,4.490704065160362,0.5018019040509402,0.45987959604055284
6694,1737951198,1737951438,240,0.9420337352511785,3.587238866147878,0.414259131886221,0.16403617704379259
6695,1737954798,1737958398,3600,0.25384740021933394,3.011236790857853,0.1,0.1
6696,1737958398,1737961133,2735,1.6582581489831083,4.585369908460793,0.7328937869524438,0.4349066637097633
6697,1737961998,1737963908,1910,2.172420946056497,4.359253159230971,0.3233731827693288,0.24666189854470744
6698,1737965598,1737969198,3600,0.4023437558194727,3.0149381399965547,0.1,0.1
6699,1737969198,1737972798,3600,0.3990424925453956,3.0622213572686627,0.1,0.1
6700,1737972798,1737976398,3600,0.4086481703144854,3.0442182358828394,0.1,0.1
6701,1737976398,1737976993,595,0.9211303337432504,3.600471026289412,0.2984043088412952,0.8703265953939073
6702,1737979998,1737983598,3600,0.18670572057409185,3.185277302563554,0.1,0.1
6703,1737983598,1737987198,3600,0.35257160814895394,3.1750120305663145,0.1,0.1
6704,1737987198,1737990798,3600,0.3794562542845291,3.136944520181167,0.1,0.1
6705,1737990798,1737994398,3600,0.49799222507828733,3.0948934339111664,0.1,0.1
6706,1737994398,1737997998,3600,0.48547695281875425,3.046928707008718,0.1,0.1
6707,1737997998,1738001598,3600,0.2925689335315208,3.0277110453165346,0.1,0.1
6708,1738001598,1738005198,3600,0.39876250754970877,3.0454900394805686,0.1,0.1
6709,1738005198,1738008798,3600,0.41246600542414835,3.040840839992566,0.1,0.1
6710,1738008798,1738012398,3600,0.3755599987903614,3.0733439544448107,0.1,0.1
6711,1738012398,1738015998,3600,0.2590602208163715,3.018205145592074,0.1,0.1
6712,1738015998,1738019598,3600,0.4274864151005745,3.1781537151143113,0.1,0.1
6713,1738019598,1738022958,3360,2.1004715233914246,4.487115281530356,0.8353505340118259,0.11362369668848743
6714,1738023198,1738026798,3600,0.37057227682615157,3.036435747729012,0.1,0.1
6715,1738026798,1738029799,3001,1.671372648929257,4.564368853590291,0.46932822220576653,0.5740538155828201
6716,1738030398,1738033998,3600,0.3994235190133292,3.1424266683732482,0.1,0.1
6717,1738033998,1738037038,3040,2.3298707709718327,4.681444100647067,0.7758757217294582,0.451403394579751
6718,1738037598,1738041140,3542,2.393984980871104,4.401157276746491,0.522515248205743,0.4127626608651588
6719,1738041198,1738043967,2769,2.4205632522402754,4.480882112672415,0.4063106440113522,0.3990450796535693
6720,1738044798,1738046787,1989,1.5603122899938868,4.506486956409332,0.9783109028227558,0.5258144336786907
6721,1738048398,1738050048,1650,1.1315823704604133,4.123457271768942,0.7581801338083267,0.35048964988762044
6722,1738051998,1738055598,3600,0.1518837504057781,3.117039329852129,0.1,0.1
6723,1738055598,1738058736,3138,2.151154169921318,4.3908953639467745,0.3871991478894893,0.6282992849098743
6724,1738059198,1738061914,2716,2.1801067820100295,4.402463590098961,0.16654815345958376,0.7101070432541717
6725,1738062798,1738066398,3600,0.1380714769614546,3.1438366104310935,0.1,0.1
6726,1738066398,1738068316,1918,1.7869092605268464,4.616817483319184,0.316758438324823,0.6446484149509019
6727,1738069998,1738073598,3600,0.16522595389735328,3.112160306956795,0.1,0.1
6728,1738073598,1738076943,3345,2.099745218035693,4.486607090541459,0.7003101667442749,0.24679220029602073
6729,1738077198,1738080635,3437,1.6685719287049623,4.62590641699141,0.5968384512953121,0.8402372495203402
6730,1738080798,1738084398,3600,0.10259928116340561,3.1171925600408086,0.1,0.1
6731,1738084398,1738087998,3600,0.2332975581869047,3.0912997731406233,0.1,0.1
6732,1738087998,1738091598,3600,0.22622154670968136,3.0443086273515596,0.1,0.1
6733,1738091598,1738092670,1072,1.3336202080729496,3.868183637944203,0.5519840219435556,0.9032678991794062
6734,1738095198,1738098798,3600,0.41666326756099803,3.0768176529006266,0.1,0.1
6735,1738098798,1738102398,3600,0.14854137952371907,3.0599720444825973,0.1,0.1
6736,1738102398,1738105998,3600,0.3005142776957487,3.005626647342073,0.1,0.1
6737,1738105998,1738106437,439,0.846697174595362,3.5289360798949767,0.7271205203846275,0.4758812109473477
6738,1738109598,1738113155,3557,2.2578057968145115,4.355139913326328,0.2553722097969757,0.4838574749361436
6739,1738113198,1738114260,1062,1.2059021860267007,3.850619091927415,0.8274057944756976,0.32276062798709976
6740,1738116798,1738116938,140,0.5494047984430352,3.462230672791777,0.6973702566572417,0.9391994560437597
6741,1738120398,1738123998,3600,0.42977706334922583,3.194844353570776,0.1,0.1
6742,1738123998,1738127598,3600,0.34285265371348195,3.110872073140738,0.1,0.1
6743,1738127598,1738128066,468,0.9401017922544992,3.6688619489758727,0.40739820829408324,0.5698335910767371
6744,1738131198,1738134211,3013,2.2101203166569636,4.4393187967755505,0.5675676820754165,0.6260802095068554
6745,1738134798,1738136610,1812,2.1508378472010277,4.395958961936252,0.5523502345859104,0.8886879575878046
6746,1738138398,1738141014,2616,2.4005377552135165,4.399468825818473,0.7727111191551479,0.12546762856825192
6747,1738141998,1738144549,2551,1.540744603772854,4.570973249517547,0.4285616873218855,0.43070944597553684
6748,1738145598,1738149198,3600,0.11007329520327147,3.0404062913397256,0.1,0.1
6749,1738149198,1738150211,1013,1.488808983240791,4.190047335120035,0.3043957447062177,0.9344406421793188
6750,1738152798,1738154122,1324,1.4036408395417335,4.167963087991147,0.9287850540254436,0.11236038929757941
6751,1738156398,1738159988,3590,2.3192363008126007,4.523838293955513,0.7294969625187674,0.5047432102330599
6752,1738159998,1738163598,3600,0.3547898653847623,3.0361467389354564,0.1,0.1
6753,1738163598,1738167198,3600,0.37161184260849456,3.1350417858088213,0.1,0.1
6754,1738167198,1738167627,429,0.7648752823655187,3.3232460444484984,0.5839668553674277,0.9737454351931492
6755,1738170798,1738171173,375,0.9937283968661211,3.5957583899474796,0.6855179577270638,0.4551504403599579
6756,1738174398,1738177998,3600,0.44757689822882407,3.0990340115057577,0.1,0.1
6757,1738177998,1738178198,200,0.6427736001667618,3.458833345958693,0.8299809001182089,0.2505672915497883
6758,1738181598,1738182512,914,1.0862227901656456,4.152905370137505,0.12566227527825205,0.39436943983662176
6759,1738185198,1738188798,3600,0.4295741892463967,3.067408598279773,0.1,0.1
6760,1738188798,1738191336,2538,2.187026645606132,4.4812006413766,0.5305941679572664,0.8372211948953604
6761,1738192398,1738192870,472,0.7375134217077941,3.612881896053526,0.295630762962172,0.8367766937286386
6762,1738195998,1738197706,1708,1.4175507847293116,4.150086200000402,0.33927997765493123,0.40941894296202164
6763,1738199598,1738203198,3600,0.15970349508378967,3.0722921399879337,0.1,0.1
6764,1738203198,1738206798,3600,0.161698447012128,3.047195923300762,0.1,0.1
6765,1738206798,1738210398,3600,0.43647413459883866,3.0596536266497862,0.1,0.1
6766,1738210398,1738213998,3600,0.3466008298706801,3.1274078472014595,0.1,0.1
6767,1738213998,1738217598,3600,0.3598962079346215,3.1209935626401895,0.1,0.1
6768,1738217598,1738221198,3600,0.48126057164512315,3.180626826014295,0.1,0.1
6769,1738221198,1738221338,140,0.9457986151780668,3.382758615934963,0.9623474424058014,0.6091689527545971
6770,1738224798,1738227191,2393,1.8553077452312645,4.569456055252874,0.29731279964172264,0.32889244917321986
6771,1738228398,1738230584,2186,2.47990124625148,4.612970882890258,0.22185680058750953,0.5292210064962085
6772,1738231998,1738234861,2863,1.8188319512830509,4.688419485471923,0.7633717436387571,0.3836715346210958
6773,1738235598,1738239198,3600,0.27908917618162354,3.009061676172831,0.1,0.1
6774,1738239198,1738241310,2112,2.428466605149721,4.553489461228644,0.3666434980971597,0.8439474070867832
6775,1738242798,1738245557,2759,2.375605623941575,4.433417824432073,0.3793678754620208,0.4178764895074306
6776,1738246398,1738249194,2796,2.1844214967512015,4.373591982886144,0.1782033552353285,0.11694076426664735
6777,1738249998,1738253598,3600,0.41153384403604565,3.0311327180922163,0.1,0.1
6778,1738253598,1738257198,3600,0.10473989472490919,3.0878758207137684,0.1,0.1
6779,1738257198,1738258507,1309,1.3001997440608333,4.01398711734188,0.5968747258357375,0.5190245582637514
6780,1738260798,1738264398,3600,0.47743632589268914,3.1599193312703546,0.1,0.1
6781,1738264398,1738267998,3600,0.12865715542180756,3.1986849872104157,0.1,0.1
6782,1738267998,1738269732,1734,1.4334781400542123,4.0102104887473615,0.8721018624965963,0.656189478435138
6783,1738271598,1738275198,3600,0.4820675916330469,3.093603491133324,0.1,0.1
6784,1738275198,1738278050,2852,1.8865784937678103,4.302850736209784,0.759003784939407,0.540622697037138
6785,1738278798,1738281560,2762,2.077225789396062,4.479046571127822,0.13098590788846037,0.1858602976756238
6786,1738282398,1738285998,3600,0.4736562996366923,3.192856264364083,0.1,0.1
6787,1738285998,1738289598,3600,0.22668786206483793,3.154195244144523,0.1,0.1
6788,1738289598,1738293198,3600,0.14513987736828216,3.1656622348396795,0.1,0.1
6789,1738293198,1738296798,3600,0.28237913542204196,3.1382443543755953,0.1,0.1
6790,1738296798,1738300398,3600,0.10623004758296842,3.0324124047379377,0.1,0.1
6791,1738300398,1738303998,3600,0.22368750988301,3.1905493708597725,0.1,0.1
6792,1738303998,1738307598,3600,0.2792410789967974,3.143482274654296,0.1,0.1
6793,1738307598,1738309589,1991,2.2870305818389944,4.629836651112444,0.5128265498519701,0.327799512295331
6794,1738311198,1738314798,3600,0.2151640873020592,3.095291791980087,0.1,0.1
6795,1738314798,1738317196,2398,2.498310615543669,4.58288652672423,0.18875777534061233,0.595073958256009
6796,1738318398,1738321998,3600,0.4019239579672962,3.118987179834731,0.1,0.1
6797,1738321998,1738325598,3600,0.33672780088603893,3.084567236838272,0.1,0.1
6798,1738325598,1738327689,2091,1.5846736128632535,4.524591555935568,0.7804553686635318,0.5622523541514423
6799,1738329198,1738331003,1805,1.6070171393678714,4.667778155852495,0.9934353471470275,0.15834889336560007
6800,1738332798,1738336398,3600,0.48293523665389027,3.1960679420534843,0.1,0.1
6801,1738336398,1738339998,3600,0.3263124600720133,3.1312064220393214,0.1,0.1
6802,1738339998,1738343598,3600,0.4823293053335135,3.120683603016945,0.1,0.1
6803,1738343598,1738347198,3600,0.13980347274804675,3.147765325707902,0.1,0.1
6804,1738347198,1738350798,3600,0.14438193013446687,3.0814348895350907,0.1,0.1
6805,1738350798,1738354398,3600,0.1512888923798805,3.035897264094009,0.1,0.1
6806,1738354398,1738356537,2139,2.419541690193988,4.485192389388376,0.805441999798513,0.2936403698396788
6807,1738357998,1738361598,3600,0.19236864753795724,3.1713820454785355,0.1,0.1
6808,1738361598,1738365198,3600,0.21694694047972476,3.178368749206659,0.1,0.1
6809,1738365198,1738368798,3600,0.3279235373286439,3.1914324216877437,0.1,0.1
6810,1738368798,1738372398,3600,0.3390360897575304,3.176708459867511,0.1,0.1
6811,1738372398,1738375280,2882,1.873293369056207,4.658849004699538,0.2801191774699198,0.7673499573303412
6812,1738375998,1738379598,3600,0.17431414129969547,3.1224512226847754,0.1,0.1
6813,1738379598,1738383198,3600,0.3352659605569943,3.1747010594980987,0.1,0.1
6814,1738383198,1738384524,1326,1.401953905197645,4.066467906895557,0.38921677626541884,0.2922816649688579
6815,1738386798,1738390398,3600,0.42700556057612216,3.03012194950066,0.1,0.1
6816,1738390398,1738393998,3600,0.2983968154890433,3.0405800436597996,0.1,0.1
6817,1738393998,1738394452,454,0.9905418740586078,3.688185374748081,0.43204606349194397,0.9676915986095367
6818,1738397598,1738399226,1628,1.404330754286852,4.06272512327475,0.72656577735936,0.5580745350664134
6819,1738401198,1738404798,3600,0.42359790528240926,3.139182594116756,0.1,0.1
6820,1738404798,1738408398,3600,0.25153160940473185,3.172130939815684,0.1,0.1
6821,1738408398,1738411998,3600,0.24082203011173797,3.004452441867459,0.1,0.1
6822,1738411998,1738415598,3600,0.37844746601342405,3.1421795452029624,0.1,0.1
6823,1738415598,1738419183,3585,2.224385595600399,4.693113233709878,0.6264574182418765,0.690328982149174
6824,1738419198,1738421060,1862,1.9120529370772088,4.478629877170124,0.11318905224456195,0.8535361465854662
6825,1738422798,1738426398,3600,0.28141923926205015,3.1881232224127367,0.1,0.1
6826,1738426398,1738429998,3600,0.35609294529338786,3.00907896574716,0.1,0.1
6827,1738429998,1738433292,3294,2.2852234284014026,4.6250864789949055,0.1335699665696473,0.44468675068549934
6828,1738433598,1738437198,3600,0.39370753196134833,3.055859221998949,0.1,0.1
6829,1738437198,1738440798,3600,0.42822427252378936,3.160868984045633,0.1,0.1
6830,1738440798,1738443796,2998,2.2260961202126364,4.485103296567849,0.6727832401387165,0.4046766598638667
6831,1738444398,1738446159,1761,1.2969731223474272,4.03371815797226,0.9259042954177747,0.450527241328454
6832,1738447998,1738451598,3600,0.33261524604922277,3.179761002594071,0.1,0.1
6833,1738451598,1738454483,2885,1.6599795678305684,4.497986050055297,0.37337665372450335,0.14835831393921958
6834,1738455198,1738458798,3600,0.11005820326784087,3.0306114474587957,0.1,0.1
6835,1738458798,1738462398,3600,0.3741935163565103,3.069021768220708,0.1,0.1
6836,1738462398,1738465998,3600,0.21465765431511313,3.1971602310957836,0.1,0.1
6837,1738465998,1738469598,3600,0.10486043504769041,3.0058162363898737,0.1,0.1
6838,1738469598,1738471345,1747,1.4718757512901441,3.810987433826527,0.7374774052689855,0.6601195485180829
6839,1738473198,1738473911,713,1.2016497838108733,3.8928025880180446,0.9067023129683291,0.5501470117417695
6840,1738476798,1738480398,3600,0.49052444446810295,3.078355545296506,0.1,0.1
6841,1738480398,1738483474,3076,2.4491498912364533,4.509596959128389,0.3313774958891078,0.9734028856532798
6842,1738483998,1738486906,2908,1.6745869862016507,4.421065080333138,0.5387836129453074,0.8083857477811616
6843,1738487598,1738490334,2736,2.229788920522622,4.531342460554194,0.49076506484986393,0.249648163212837
6844,1738491198,1738494798,3600,0.2117065277977087,3.0672059507780913,0.1,0.1
6845,1738494798,1738496796,1998,1.7044711258465803,4.306142624476807,0.5812379443102986,0.5743006736346546
6846,1738498398,1738501998,3600,0.3693396955664334,3.041196868959599,0.1,0.1
6847,1738501998,1738505598,3600,0.22701405533111269,3.078085572369717,0.1,0.1
6848,1738505598,1738506527,929,1.1680942597744848,4.127262315532896,0.5382923010356075,0.45608728739230686
6849,1738509198,1738512798,3600,0.43824346597931363,3.144099289904632,0.1,0.1
6850,1738512798,1738512858,60,0.8799929879063817,3.575426066588886,0.4274588089149962,0.9459311540353632
6851,1738516398,1738519700,3302,1.7972218865467247,4.5992937825145646,0.25080841421946853,0.8014985439997666
6852,1738519998,1738520532,534,0.6668268778663426,3.4813069454809376,0.21287448648802731,0.5019499191350465
6853,1738523598,1738526545,2947,1.8153418053579804,4.679346440885024,0.7527785757712027,0.8648037734547327
6854,1738527198,1738528221,1023,1.2184482930803504,4.174835375145521,0.32184565032527707,0.46034189295353733
6855,1738530798,1738534200,3402,1.7148816581054638,4.654788888257396,0.5582168590956126,0.44409053921092045
6856,1738534398,1738537998,3600,0.44674292372952773,3.1112975903785887,0.1,0.1
6857,1738537998,1738541275,3277,2.4512810925403916,4.326687527804134,0.38085704095295925,0.43454813757846755
6858,1738541598,1738541836,238,0.9488389527003653,3.6986964301854273,0.2324330313462215,0.3617293929542461
6859,1738545198,1738547021,1823,1.7794713839193257,4.640687929759394,0.6720442997464925,0.40073513437656216
6860,1738548798,1738551773,2975,1.9304542664535016,4.434510427765688,0.8704121153976357,0.9989724904827847
6861,1738552398,1738555998,3600,0.433579806854251,3.085313010765652,0.1,0.1
6862,1738555998,1738558689,2691,1.5572399691571175,4.667287624198142,0.6708600972926053,0.23972512777244193
6863,1738559598,1738563198,3600,0.19466674901101844,3.1094197697962165,0.1,0.1
6864,1738563198,1738565190,1992,2.369239871823719,4.367072934665516,0.24521386618506658,0.3464259327360043
6865,1738566798,1738568063,1265,1.1811194527983164,4.190224740631768,0.5807758580728479,0.5640614576720305
6866,1738570398,1738573441,3043,1.7659433701475544,4.343064971408447,0.4974886535662594,0.5643805903257154
6867,1738573998,1738576928,2930,2.0764413496750196,4.643237019387628,0.8520003500911842,0.5364860060804468
6868,1738577598,1738581198,3600,0.1767494774226302,3.090466900367932,0.1,0.1
6869,1738581198,1738584675,3477,2.2534664527500423,4.653840391038804,0.9439515718834542,0.39751077625100917
6870,1738584798,1738588373,3575,1.8338980702994392,4.637507808168343,0.6188247795731043,0.3399332651172162
6871,1738588398,1738589979,1581,1.1712526710766715,3.9026039768793384,0.2670825592522511,0.8862408371601995
6872,1738591998,1738595598,3600,0.42659180879968217,3.1209510912141907,0.1,0.1
6873,1738595598,1738595972,374,0.5905698954777869,3.4413353013606356,0.1207296679377821,0.5064128595032373
6874,1738599198,1738602729,3531,1.9260550687758387,4.491080728634616,0.8959734947501165,0.3731689580193642
6875,1738602798,1738606398,3600,0.4593313822342967,3.0480911322784627,0.1,0.1
6876,1738606398,1738608447,2049,2.064449328958941,4.565442604673119,0.7296130953345669,0.4126488965074625
6877,1738609998,1738613598,3600,0.30281819725178794,3.1778019059985456,0.1,0.1
6878,1738613598,1738617198,3600,0.16856172856604307,3.0501063326280766,0.1,0.1
6879,1738617198,1738620798,3600,0.21438876278212288,3.084133840637983,0.1,0.1
6880,1738620798,1738621118,320,0.6595916604496516,3.34691014302755,0.6669050589038215,0.22974245575308982
6881,1738624398,1738627998,3600,0.3723429559363265,3.1905364175133686,0.1,0.1
6882,1738627998,1738631598,3600,0.3157521998758043,3.1211515200341053,0.1,0.1
6883,1738631598,1738634128,2530,2.059470608513522,4.576305673594262,0.7839086065772459,0.9602002004777167
6884,1738635198,1738638798,3600,0.36432573935041757,3.000277579258812,0.1,0.1
6885,1738638798,1738642398,3600,0.4708251298175449,3.1837902038607746,0.1,0.1
6886,1738642398,1738645998,3600,0.22268517621619638,3.1585008762428535,0.1,0.1
6887,1738645998,1738649598,3600,0.49210541788232265,3.185201912446446,0.1,0.1
6888,1738649598,1738653198,3600,0.4517491493370551,3.1633129179173665,0.1,0.1
6889,1738653198,1738653854,656,1.1645804246300786,4.031310042289408,0.7223854261718856,0.5202495871068119
6890,1738656798,1738656889,91,0.5928332869611919,3.5746833143466428,0.8726626451583338,0.6236864755644408
6891,1738660398,1738663889,3491,1.7478700215021876,4.399141563817634,0.6140981203058503,0.6921671382939577
6892,1738663998,1738667554,3556,1.8909618050515582,4.395718113658693,0.6676226913589237,0.4657992249178201
6893,1738667598,1738668151,553,0.6048133063804169,3.5912505577844107,0.7120123810527531,0.42690982015784473
6894,1738671198,1738673113,1915,1.5878362263812105,4.51122183114851,0.4287118617746095,0.49507718780592935
6895,1738674798,1738675472,674,1.2886022045193,4.02142259217659,0.5297745852173328,0.2798886838281796
6896,1738678398,1738679292,894,1.1568886435934598,4.043229890457394,0.9612689078942372,0.588530012875995
6897,1738681998,1738685505,3507,2.0770084638232476,4.479264029528761,0.6958711088347824,0.4467892947766203
6898,1738685598,1738688798,3200,1.8501933743800199,4.5157090178152925,0.164788881743741,0.5368103695364371
6899,1738689198,1738691193,1995,1.7496675399593276,4.578314043867958,0.9284648970605276,0.268089521764477
6900,1738692798,1738696398,3600,0.11955993997517554,3.096806729353766,0.1,0.1
6901,1738696398,1738699580,3182,2.1802342186709716,4.442750279142162,0.7724610099878662,0.7321145751579178
6902,1738699998,1738703598,3600,0.41109079859440734,3.062846591324911,0.1,0.1
6903,1738703598,1738707198,3600,0.37045626824345856,3.1365997152426317,0.1,0.1
6904,1738707198,1738710798,3600,0.288691615425295,3.145269401355305,0.1,0.1
6905,1738710798,1738711166,368,0.8246028860607534,3.645732608590933,0.13808956717340368,0.7615303331876042
6906,1738714398,1738717998,3600,0.49185610844464855,3.1203431450791905,0.1,0.1
6907,1738717998,1738718847,849,1.023061379322386,4.078889130586719,0.5560845348744625,0.16238343974682368
6908,1738721598,1738725198,3600,0.20272967036386663,3.1456368719060452,0.1,0.1
6909,1738725198,1738728101,2903,2.439798840780956,4.427279250345657,0.25742456346821774,0.5951293742867608
6910,1738728798,1738729538,740,1.2297098863000413,4.014075430459891,0.7112662351336348,0.8845724725832137
6911,1738732398,1738735998,3600,0.1648368738783917,3.05875927392808,0.1,0.1
6912,1738735998,1738739598,3600,0.28763269299909455,3.043669049393332,0.1,0.1
6913,1738739598,1738740655,1057,1.2609745567146524,4.001494942726731,0.817084582573007,0.17843536635791057
6914,1738743198,1738746798,3600,0.2828099011870078,3.135101695339561,0.1,0.1
6915,1738746798,1738748828,2030,2.3819431907908313,4.4016291993800065,0.9694886589801982,0.2326433943291554
6916,1738750398,1738753998,3600,0.20494539958760521,3.1025769996210424,0.1,0.1
6917,1738753998,1738754682,684,1.3570709385487478,3.9079330443934506,0.6990976063781696,0.5071406661741181
6918,1738757598,1738761198,3600,0.3327171532252733,3.112060611771637,0.1,0.1
6919,1738761198,1738763031,1833,1.5540913124052462,4.508750417825217,0.8861214910006258,0.8942732653372651
6920,1738764798,1738767378,2580,2.493760811398699,4.343067575977705,0.155939054147196,0.6000050435394849
6921,1738768398,1738771998,3600,0.25290925482049487,3.003585854120001,0.1,0.1
6922,1738771998,1738775598,3600,0.18060667434993005,3.0246223864105795,0.1,0.1
6923,1738775598,1738777787,2189,2.485680557878768,4.472073014205382,0.6921157424175121,0.13732379834496794
6924,1738779198,1738782798,3600,0.18560230190419413,3.0854653007389437,0.1,0.1
6925,1738782798,1738783253,455,0.7874492565812421,3.468784799879483,0.22047210090708647,0.24457443813018884
6926,1738786398,1738789882,3484,2.0769751572771473,4.395978705015161,0.9116724430510635,0.8715918441972036
6927,1738789998,1738793598,3600,0.3156076870570269,3.0464777348131005,0.1,0.1
6928,1738793598,1738795159,1561,1.282046194100677,4.145395756666166,0.9611700917624919,0.86489201753599
6929,1738797198,1738799421,2223,1.8231497297555737,4.468736081130879,0.3829278971570237,0.6878283000091097
6930,1738800798,1738802656,1858,1.8688446705729416,4.448542726459711,0.5281424116178977,0.9126482653221858
6931,1738804398,1738805371,973,1.4541293734712282,4.130514242944996,0.6387371591076345,0.5351183772642424
6932,1738807998,1738811598,3600,0.4463532239203233,3.0700793418175714,0.1,0.1
6933,1738811598,1738814838,3240,2.2176216240210747,4.360508362423581,0.6373616285135304,0.8092052024845081
6934,1738815198,1738818393,3195,2.093702291336782,4.408265824164958,0.7511294611845665,0.43299784182898127
6935,1738818798,1738820109,1311,1.3410013098081262,4.008698819509534,0.26685936453843817,0.48756475202596694
6936,1738822398,1738825998,3600,0.2799718789594593,3.0988354171623396,0.1,0.1
6937,1738825998,1738828137,2139,1.7833947239261774,4.504030246342876,0.43945920522473125,0.45866932490219825
6938,1738829598,1738833198,3600,0.43518982299406417,3.099863043968302,0.1,0.1
6939,1738833198,1738836798,3600,0.3724755027866177,3.1177478909906977,0.1,0.1
6940,1738836798,1738839705,2907,2.4401332848993182,4.479282389994885,0.22838466135792237,0.6161909700698459
6941,1738840398,1738843998,3600,0.20215684896489128,3.0517197397608,0.1,0.1
6942,1738843998,1738847598,3600,0.43554451976793485,3.0340584031850177,0.1,0.1
6943,1738847598,1738851198,3600,0.2931147235836867,3.176349861788586,0.1,0.1
6944,1738851198,1738852078,880,1.4278510761494592,3.90693005092729,0.1288817502927551,0.20029047576371117
6945,1738854798,1738858398,3600,0.2853663470276967,3.034457666746937,0.1,0.1
6946,1738858398,1738858833,435,0.5908515254007818,3.5974518044186015,0.4709741793185124,0.65035921209517
6947,1738861998,1738862503,505,0.8765617834508324,3.388543501467895,0.7775571409438388,0.20470671952660702
6948,1738865598,1738869198,3600,0.275251107726347,3.025583717676984,0.1,0.1
6949,1738869198,1738872798,3600,0.21284499807163526,3.068889847398249,0.1,0.1
6950,1738872798,1738874345,1547,1.2627256775721967,3.8094759502814477,0.918561946356703,0.390834316247607
6951,1738876398,1738878416,2018,2.1663995080689684,4.505103285482053,0.8731577529162108,0.660443219987277
6952,1738879998,1738883598,3600,0.12530751623559477,3.1504647429158834,0.1,0.1
6953,1738883598,1738887198,3600,0.15883340654482325,3.100208744538528,0.1,0.1
6954,1738887198,1738888767,1569,1.4667132960876454,3.944679215883202,0.9663778161811516,0.6761120800254707
6955,1738890798,1738894398,3600,0.292905296760012,3.0993801281637596,0.1,0.1
6956,1738894398,1738894536,138,0.9029769181365709,3.4190252911412835,0.9920236226439509,0.1939768378496806
6957,1738897998,1738899100,1102,1.0665713748008205,4.138149826925202,0.7760014281657391,0.30985184130915683
6958,1738901598,1738905198,3600,0.1444708926151349,3.053891009142254,0.1,0.1
6959,1738905198,1738907316,2118,1.745604797156497,4.484849721296674,0.3252258734381488,0.9020978336877399
6960,1738908798,1738912398,3600,0.12778442374657084,3.0160131383179425,0.1,0.1
6961,1738912398,1738915998,3600,0.3650692929490724,3.1179365008156363,0.1,0.1
6962,1738915998,1738919442,3444,2.0298862451685102,4.546313705574222,0.7835323896242303,0.33598885650525767
6963,1738919598,1738920147,549,0.8267813209403732,3.426586045231714,0.351587476054565,0.3645027126991853
6964,1738923198,1738926798,3600,0.44016962060061127,3.070544563886775,0.1,0.1
6965,1738926798,1738930398,3600,0.44758181509302275,3.0864640875046883,0.1,0.1
6966,1738930398,1738933721,3323,1.5018892352020705,4.671556796254109,0.4125018620742942,0.58400553349919
6967,1738933998,1738937598,3600,0.2518100283994147,3.1836443220883006,0.1,0.1
6968,1738937598,1738941198,3600,0.18007518457533678,3.040771568811022,0.1,0.1
6969,1738941198,1738942035,837,1.499153739368351,4.083910767047916,0.43848585534138484,0.7890214953692449
6970,1738944798,1738948398,3600,0.30001042860475696,3.1221774600048406,0.1,0.1
6971,1738948398,1738949365,967,1.3436689783501137,3.996011934958058,0.6094616370371218,0.48836297455596966
6972,1738951998,1738955598,3600,0.155616354029205,3.051556748459708,0.1,0.1
6973,1738955598,1738958111,2513,2.4626387337469637,4.674974058086729,0.879517937511447,0.18502153095094737
6974,1738959198,1738960494,1296,1.0121115227386328,3.938540901205549,0.45137073764986124,0.593408847686795
6975,1738962798,1738966398,3600,0.435663376065323,3.0034472581887703,0.1,0.1
6976,1738966398,1738969998,3600,0.2601686989880743,3.125575962657362,0.1,0.1
6977,1738969998,1738973598,3600,0.17256100758081586,3.115514758189671,0.1,0.1
6978,1738973598,1738974435,837,1.176647900971982,4.022719560758371,0.4743192594671166,0.9209598934570097
6979,1738977198,1738978799,1601,1.4098602459035972,4.035259147260947,0.9695385945652021,0.46537873205654745
6980,1738980798,1738984398,3600,0.3660934063135982,3.195984601338566,0.1,0.1
6981,1738984398,1738987998,3600,0.41342542180376995,3.098505308363751,0.1,0.1
6982,1738987998,1738991598,3600,0.22033242912956086,3.0759540895173094,0.1,0.1
6983,1738991598,1738991937,339,0.5627273569508802,3.385358580753127,0.36051220795674543,0.8581601911302777
6984,1738995198,1738998798,3600,0.2669319243330307,3.0939427633982017,0.1,0.1
6985,1738998798,1739001698,2900,1.843513572523273,4.347755920795468,0.37935732349126416,0.4233544818606454
6986,1739002398,1739005998,3600,0.1875986573961726,3.1079998262449475,0.1,0.1
6987,1739005998,1739006085,87,0.5872418297998034,3.5476213728866273,0.43016937489003093,0.280899550790728
6988,1739009598,1739013069,3471,1.7177043581952103,4.511321292037888,0.33371856425804813,0.4456396144923128
6989,1739013198,1739016122,2924,2.4139200360266972,4.655854215587609,0.11600655565213515,0.6292858744340836
6990,1739016798,1739020398,3600,0.27673002189403995,3.069852820640484,0.1,0.1
6991,1739020398,1739023998,3600,0.4474508453850897,3.0096665524522304,0.1,0.1
6992,1739023998,1739027598,3600,0.4211287939403048,3.0485119456045426,0.1,0.1
6993,1739027598,1739031198,3600,0.14296325175146893,3.1556206538737577,0.1,0.1
6994,1739031198,1739033996,2798,1.6039337801151343,4.558942564876111,0.8721135545725575,0.597136204328963
6995,1739034798,1739037772,2974,2.2323084592274993,4.389497297183766,0.8278241629516984,0.9932433522530194
6996,1739038398,1739041998,3600,0.44422755234082756,3.161573594810698,0.1,0.1
6997,1739041998,1739045598,3600,0.18404143804024586,3.156258811158546,0.1,0.1
6998,1739045598,1739049198,3600,0.40606526913498187,3.165171700263598,0.1,0.1
6999,1739049198,1739049963,765,1.3324126405419543,4.01532263090232,0.9168553514547148,0.16292785994552247
7000,1739052798,1739054053,1255,1.2521745626440548,3.929505045376111,0.8508020376730404,0.37570644141170917
7001,1739056398,1739059998,3600,0.4230775455571205,3.0092993460722113,0.1,0.1
7002,1739059998,1739062332,2334,1.7057411520118395,4.466036768183412,0.11794797832792195,0.44873171857654903
7003,1739063598,1739067073,3475,2.1267629223230253,4.495722770243441,0.42973458959439426,0.7909811881246919
7004,1739067198,1739070292,3094,2.3544674086824484,4.520505960550811,0.8170367306039003,0.9606202158096058
7005,1739070798,1739074398,3600,0.16921923398221753,3.1185032722282946,0.1,0.1
7006,1739074398,1739077998,3600,0.24369054515666755,3.0893386091022554,0.1,0.1
7007,1739077998,1739079159,1161,1.2316906405393935,3.9924264657711297,0.41857437669900155,0.9882448322920339
7008,1739081598,1739084429,2831,1.681523395354446,4.653139501746376,0.5454464119020132,0.6100369705824459
7009,1739085198,1739086298,1100,1.3510530437684305,4.161998400183131,0.4031212819273965,0.211409450583095
7010,1739088798,1739092398,3600,0.19547233442250664,3.12657453256439,0.1,0.1
7011,1739092398,1739095998,3600,0.48284135238691883,3.1404824655986725,0.1,0.1
7012,1739095998,1739099598,3600,0.482599758174587,3.118449175562946,0.1,0.1
7013,1739099598,1739101654,2056,1.664180248803024,4.523731906799484,0.9911465655014711,0.26533713382400914
7014,1739103198,1739104125,927,1.0776177476519493,4.074271334776592,0.9592653661771747,0.7427550017278368
7015,1739106798,1739109387,2589,1.6195737578444085,4.567274562332809,0.1207138426918658,0.8350902895055274
7016,1739110398,1739110495,97,0.7108808161887417,3.3990767465854157,0.9701787687395043,0.3855150275072833
7017,1739113998,1739116304,2306,1.8720342394170342,4.554122371246869,0.759380928058894,0.30876105838042534
7018,1739117598,1739118271,673,1.4140461156609248,3.94718408437135,0.5833520838427383,0.5604921718365087
7019,1739121198,1739124798,3600,0.3371475635342207,3.180651496982636,0.1,0.1
7020,1739124798,1739128398,3600,0.48885058963831096,3.169328107663047,0.1,0.1
7021,1739128398,1739129536,1138,1.0742315240323541,4.115585796365033,0.6772932450197376,0.8712830965888749
7022,1739131998,1739135598,3600,0.18893853156018278,3.083869241495178,0.1,0.1
7023,1739135598,1739139198,3600,0.4176817671193743,3.0842033220323923,0.1,0.1
7024,1739139198,1739142798,3600,0.21047737496245167,3.189392532421838,0.1,0.1
7025,1739142798,1739144923,2125,2.3137124554101227,4.443792243317755,0.16463697132231175,0.7726560706408265
7026,1739146398,1739148603,2205,2.252696452474544,4.422811525086494,0.16415298313169568,0.22799080512247477
7027,1739149998,1739153598,3600,0.4485707664489681,3.117160941606824,0.1,0.1
7028,1739153598,1739157198,3600,0.1419539220697962,3.0838919154698297,0.1,0.1
7029,1739157198,1739158745,1547,1.0028740601162585,3.9597498899702814,0.521319216542536,0.23062298638147943
7030,1739160798,1739164398,3600,0.2599666462476583,3.0705693177771063,0.1,0.1
7031,1739164398,1739165863,1465,1.485967538741249,4.134654091470899,0.19334890779115138,0.6329741529122868
7032,1739167998,1739169320,1322,1.0307195512164076,3.9493224208190765,0.157215144619142,0.38137884737254724
7033,1739171598,1739175198,3600,0.45198078177497014,3.0728365940794227,0.1,0.1
7034,1739175198,1739175261,63,0.7126044610972382,3.347374731743195,0.7446216585556941,0.14204727193829328
7035,1739178798,1739179705,907,1.0898730166863095,3.9215191680422024,0.10232607995567183,0.10237292049977206
7036,1739182398,1739182527,129,0.5619514165309978,3.451422332283168,0.26075416386278905,0.5481606912112418
7037,1739185998,1739189437,3439,1.9824526750608347,4.378013611788686,0.8177165887411195,0.664256983847045
7038,1739189598,1739193198,3600,0.48649022134309294,3.0414137653365665,0.1,0.1
7039,1739193198,1739193315,117,0.6468423937655758,3.5826182897267906,0.41223043731173215,0.6926282880372128
7040,1739196798,1739200398,3600,0.46226831101137145,3.0274535278083747,0.1,0.1
7041,1739200398,1739201031,633,1.253878265512598,3.940197784370665,0.6342255412890858,0.9959529831136599
7042,1739203998,1739205294,1296,1.0824115191512198,3.8994610918436465,0.891569507743462,0.38395629359518557
7043,1739207598,1739211198,3600,0.12158810130321474,3.0073450412570635,0.1,0.1
7044,1739211198,1739214798,3600,0.15090307545613874,3.133065906350895,0.1,0.1
7045,1739214798,1739218398,3600,0.1387871074632782,3.0947510068171886,0.1,0.1
7046,1739218398,1739219094,696,1.1549735789023812,4.159370164097162,0.8724100727188729,0.5554012007001993
7047,1739221998,1739225598,3600,0.22100236172423948,3.0529180324764407,0.1,0.1
7048,1739225598,1739227540,1942,2.1471998519527427,4.60732438351916,0.24351043622718122,0.4422356780869069
7049,1739229198,1739232798,3600,0.40416150321606736,3.1002501303523635,0.1,0.1
7050,1739232798,1739233637,839,1.3312857874335697,3.873949780845028,0.5823797995555109,0.1091038473565602
7051,1739236398,1739239998,3600,0.23477000322674965,3.1449811030253323,0.1,0.1
7052,1739239998,1739243598,3600,0.40860401393309176,3.152212213484187,0.1,0.1
7053,1739243598,1739247198,3600,0.20081890149102977,3.1231189112734175,0.1,0.1
7054,1739247198,1739247283,85,0.812521426411946,3.4472712228745133,0.4295924740896814,0.8502680555577677
7055,1739250798,1739254398,3600,0.12624823915200942,3.0187268727470853,0.1,0.1
7056,1739254398,1739257998,3600,0.4173008326636979,3.1437205276200535,0.1,0.1
7057,1739257998,1739261598,3600,0.475484209161099,3.1477795008471845,0.1,0.1
7058,1739261598,1739265198,3600,0.4463226536175574,3.0537807548522484,0.1,0.1
7059,1739265198,1739268798,3600,0.3458418188180812,3.1531324380941044,0.1,0.1
7060,1739268798,1739272398,3600,0.25002302696415263,3.048808785694854,0.1,0.1
7061,1739272398,1739275998,3600,0.268913454747856,3.011829717633613,0.1,0.1
7062,1739275998,1739277569,1571,1.2056417317103665,3.9294240100147144,0.3557713240559838,0.2390299354197496
7063,1739279598,1739283198,3600,0.13079369269238128,3.191071278243129,0.1,0.1
7064,1739283198,1739286798,3600,0.24116733564198767,3.0944213352751873,0.1,0.1
7065,1739286798,1739288890,2092,1.8626784223387867,4.348910044275814,0.4523761805794223,0.6815352627778989
7066,1739290398,1739292092,1694,1.3626933357999966,4.0959687498779935,0.7501234377083743,0.9697350427400815
7067,1739293998,1739297052,3054,1.8903113053115352,4.694809211138076,0.5488485778816393,0.16617577292745
7068,1739297598,1739301198,3600,0.3641571347229039,3.1984960419165147,0.1,0.1
7069,1739301198,1739304798,3600,0.18414737455024355,3.177159148194795,0.1,0.1
7070,1739304798,1739308398,3600,0.38779295784165346,3.13696062208356,0.1,0.1
7071,1739308398,1739308622,224,0.9616515403336539,3.4785800161484546,0.5953886158530484,0.7472548490218118
7072,1739311998,1739315598,3600,0.42659903416197986,3.0188443996087906,0.1,0.1
7073,1739315598,1739317580,1982,2.0656322209531393,4.444590854524039,0.21901629299608102,0.6608689232737998
7074,1739319198,1739322798,3600,0.32763637462305273,3.066315986026177,0.1,0.1
7075,1739322798,1739326116,3318,2.0198807130168914,4.6532639029707505,0.5866867494471375,0.3457144869981542
7076,1739326398,1739327668,1270,1.4686900638146163,3.960836474535256,0.18578754331451014,0.312874739008274
7077,1739329998,1739331752,1754,1.3979407579654763,3.9670471233300324,0.7577704034443492,0.7319248378837704
7078,1739333598,1739333822,224,0.7715900982491717,3.681470479335004,0.37181194964506814,0.3280357042710751
7079,1739337198,1739340798,3600,0.14588649785229185,3.17448299680874,0.1,0.1
7080,1739340798,1739343583,2785,2.0319654061367363,4.315721802474236,0.3247697608969801,0.8571117944959473
7081,1739344398,1739347582,3184,2.0716563739579446,4.662018005331701,0.4855547971527967,0.989399333153719
7082,1739347998,1739351598,3600,0.30283392957518507,3.026167798140424,0.1,0.1
7083,1739351598,1739351756,158,0.664607042287237,3.631089150169611,0.49940102328902747,0.35694537993316156
7084,1739355198,1739358798,3600,0.23640572142778726,3.0276521360922004,0.1,0.1
7085,1739358798,1739362398,3600,0.43532165514477894,3.1722882074986565,0.1,0.1
7086,1739362398,1739364009,1611,1.257419106435404,3.931196051479839,0.595911006903197,0.8997221718795427
7087,1739365998,1739366809,811,1.1737105440231197,4.163513882138374,0.3429662779730984,0.1606352142239932
7088,1739369598,1739373073,3475,2.2433289090355615,4.463191752545512,0.9886993448695184,0.20537997870188007
7089,1739373198,1739376798,3600,0.11677274254499666,3.1703510435494384,0.1,0.1
7090,1739376798,1739377719,921,1.149091452237771,4.101796775883588,0.837955012003451,0.38993929137858974
7091,1739380398,1739383391,2993,2.4343375854662486,4.539459636772105,0.7462649368912339,0.6466503321530798
7092,1739383998,1739386927,2929,1.6448710416504686,4.4605332340357515,0.9457561706899987,0.1645310414489027
7093,1739387598,1739391198,3600,0.16689825540355413,3.009171117352709,0.1,0.1
7094,1739391198,1739392155,957,1.1770188637147463,3.979706706189158,0.1391555611235128,0.8834132482421507
7095,1739394798,1739396891,2093,2.28740711271925,4.452090982866087,0.8300383580579351,0.23767053715722394
7096,1739398398,1739401998,3600,0.48785739719142096,3.1926435066769794,0.1,0.1
7097,1739401998,1739404625,2627,1.6467899417555092,4.437782295887653,0.29168537536299016,0.1479972065402635
7098,1739405598,1739409198,3600,0.49000323748958774,3.089670136668495,0.1,0.1
7099,1739409198,1739412798,3600,0.30796662588736945,3.186941799838713,0.1,0.1
7100,1739412798,1739416398,3600,0.4548554404476396,3.0640364855582933,0.1,0.1
7101,1739416398,1739417252,854,1.0009917536304942,3.8265213016478254,0.6308033565463587,0.9767579825737142
7102,1739419998,1739423598,3600,0.4618058038181625,3.1846517095910727,0.1,0.1
7103,1739423598,1739424573,975,1.2573168480945769,4.0922032002989575,0.29288470158388746,0.8570803831758286
7104,1739427198,1739430798,3600,0.25486071349654893,3.084977372070692,0.1,0.1
7105,1739430798,1739434352,3554,2.0907661914199265,4.634506593342725,0.16467058126483977,0.8031471494773916
7106,1739434398,1739436666,2268,1.5498411943855825,4.532552925736366,0.607708818703295,0.991910825118875
7107,1739437998,1739439269,1271,1.0304021360790114,4.1185505769418445,0.7984328319396897,0.6504559425676946
7108,1739441598,1739445198,3600,0.3477321808393459,3.057473272717002,0.1,0.1
7109,1739445198,1739447659,2461,2.4893035201353677,4.578623421536698,0.5288250151836895,0.16608384755620847
7110,1739448798,1739452398,3600,0.30179410153153824,3.120445520255391,0.1,0.1
7111,1739452398,1739454417,2019,1.980439035972863,4.394442185713899,0.4629177289487971,0.7512007171710721
7112,1739455998,1739456495,497,0.560207225808975,3.478736446388015,0.6187415199130282,0.5633410303419465
7113,1739459598,1739463198,3600,0.11582774197052284,3.1285128956553248,0.1,0.1
7114,1739463198,1739466798,3600,0.15945567928631516,3.1136304978224825,0.1,0.1
7115,1739466798,1739467488,690,1.1967975558272115,4.132056707500335,0.28485277539133463,0.6687023266433493
7116,1739470398,1739473741,3343,2.3043955071922984,4.649947792025422,0.31596492453022706,0.4979403124163755
7117,1739473998,1739477598,3600,0.48595784199436587,3.0459114137431897,0.1,0.1
7118,1739477598,1739481198,3600,0.19544452608979973,3.031995343608898,0.1,0.1
7119,1739481198,1739484798,3600,0.45012412634801613,3.198257571574634,0.1,0.1
7120,1739484798,1739488398,3600,0.3528043756062712,3.022556279055045,0.1,0.1
7121,1739488398,1739491230,2832,1.9468063481033915,4.62100155956643,0.5158881453063099,0.20016904367190885
7122,1739491998,1739494411,2413,1.5152119277419347,4.512695565303972,0.53752110496292,0.8910615713949124
7123,1739495598,1739499198,3600,0.312998719731827,3.1500855752315724,0.1,0.1
7124,1739499198,1739499797,599,0.6028564390785042,3.5117867404187972,0.23202117442539583,0.33437474458847294
7125,1739502798,1739503129,331,0.8923852425720074,3.65154804993443,0.34104194272011246,0.8412930621647868
7126,1739506398,1739509998,3600,0.3984339803863831,3.1385719317219154,0.1,0.1
7127,1739509998,1739513598,3600,0.489209940708084,3.0901013745825074,0.1,0.1
7128,1739513598,1739517198,3600,0.32779752377978966,3.054141853984928,0.1,0.1
7129,1739517198,1739520798,3600,0.2607662142160947,3.1780755384519837,0.1,0.1
7130,1739520798,1739520978,180,0.850823189341088,3.3012101114743433,0.43552938920606266,0.38619744362237196
7131,1739524398,1739527998,3600,0.441720998533748,3.198013760946524,0.1,0.1
7132,1739527998,1739531598,3600,0.42986720542937784,3.035720862006844,0.1,0.1
7133,1739531598,1739534637,3039,2.4318333061226194,4.487441179724559,0.639496315101701,0.20374834218877502
7134,1739535198,1739538798,3600,0.33080682132109684,3.03733304217494,0.1,0.1
7135,1739538798,1739540683,1885,1.9106446451851506,4.357009776358439,0.6551929266405948,0.5074866779566977
7136,1739542398,1739545998,3600,0.23528232829659396,3.086060900048411,0.1,0.1
7137,1739545998,1739549391,3393,2.421296724099445,4.501027058724754,0.39222180527213235,0.26439384423085627
7138,1739549598,1739553198,3600,0.33635707905063505,3.164631239114543,0.1,0.1
7139,1739553198,1739556798,3600,0.24006167466991282,3.111693734815142,0.1,0.1
7140,1739556798,1739560398,3600,0.4262667866271125,3.0753205471199623,0.1,0.1
7141,1739560398,1739563998,3600,0.23021370733846475,3.1779805031547084,0.1,0.1
7142,1739563998,1739567598,3600,0.37865053285693506,3.1296269846705167,0.1,0.1
7143,1739567598,1739571198,3600,0.2302032753287842,3.17966857208332,0.1,0.1
7144,1739571198,1739572583,1385,1.2409745688796228,3.9557591332698334,0.6627075839114921,0.30792723362639407
7145,1739574798,1739576993,2195,2.4914715088326522,4.528803140155336,0.32451365381044,0.8232139546621052
7146,1739578398,1739581998,3600,0.36735410211896224,3.1370072097992403,0.1,0.1
7147,1739581998,1739585598,3600,0.18317214370215806,3.0820137117127175,0.1,0.1
7148,1739585598,1739585815,217,0.870075790985434,3.3484622938758126,0.8970803549534333,0.5468194341367623
7149,1739589198,1739592798,3600,0.24953572285659012,3.191764190890691,0.1,0.1
7150,1739592798,1739596398,3600,0.22553305736556262,3.0321561264988164,0.1,0.1
7151,1739596398,1739599998,3600,0.20492800146462567,3.144044526148443,0.1,0.1
7152,1739599998,1739603598,3600,0.4428110807764689,3.0115477464320684,0.1,0.1
7153,1739603598,1739604213,615,1.0612312070424679,3.958500305078379,0.2939575832437582,0.26330769945337945
7154,1739607198,1739607417,219,0.6546139985197783,3.482143642740133,0.4707738547981055,0.41524822920589455
7155,1739610798,1739614398,3600,0.37765732090063864,3.1028979609023195,0.1,0.1
7156,1739614398,1739617308,2910,2.389383656090616,4.4635288796216175,0.7469414421280851,0.3549711793510776
7157,1739617998,1739621598,3600,0.3407197825101481,3.052955740332178,0.1,0.1
7158,1739621598,1739622415,817,1.0251210605461503,4.1038148773254495,0.30624605024888907,0.23809211384840281
7159,1739625198,1739628798,3600,0.2670229045940018,3.1491547051998703,0.1,0.1
7160,1739628798,1739632398,3600,0.2763332158145984,3.0246064451309853,0.1,0.1
7161,1739632398,1739635998,3600,0.36448687877075336,3.074975021870502,0.1,0.1
7162,1739635998,1739639598,3600,0.17438505902613582,3.117471032078267,0.1,0.1
7163,1739639598,1739642112,2514,1.919871313310936,4.464721047706219,0.43923479544357824,0.2991328048981796
7164,1739643198,1739643540,342,0.68255178055796,3.399974212476938,0.16374661481926966,0.375665364258865
7165,1739646798,1739649041,2243,2.2331707932931244,4.346953337357177,0.2261501586327983,0.361964417401781
7166,1739650398,1739653890,3492,1.5573952463190743,4.3852455667859696,0.6324804391373963,0.9863547680648256
7167,1739653998,1739654952,954,1.3805187673203863,3.816952983298344,0.9583748920883847,0.38575905861120785
7168,1739657598,1739661198,3600,0.10051493608422657,3.1631639284325437,0.1,0.1
7169,1739661198,1739662524,1326,1.252821133153315,4.027847548790606,0.7021875110274802,0.4539067064576634
7170,1739664798,1739666306,1508,1.3943538852532187,3.9871912974822648,0.8540247920980837,0.6313919987964878
7171,1739668398,1739671998,3600,0.17138665263348757,3.198520730519383,0.1,0.1
7172,1739671998,1739674471,2473,1.8493491541299139,4.376637931214088,0.801901766664451,0.8928426262098044
7173,1739675598,1739679198,3600,0.34830610284392916,3.0057651757957684,0.1,0.1
7174,1739679198,1739680369,1171,1.3832150955859672,3.955474174075807,0.4075477562465928,0.5670568821493854
7175,1739682798,1739686398,3600,0.3237705167271254,3.1939588713492775,0.1,0.1
7176,1739686398,1739689998,3600,0.4173878781723207,3.1015807444187224,0.1,0.1
7177,1739689998,1739692857,2859,2.402785283474059,4.517232343494717,0.21419693611825913,0.5422830095616784
7178,1739693598,1739696675,3077,2.245035624357259,4.352065042049623,0.15530179539590713,0.8174465029805895
7179,1739697198,1739700798,3600,0.23100731630238283,3.0227626335480204,0.1,0.1
7180,1739700798,1739702897,2099,2.29973825538397,4.528952051804836,0.23688793573692754,0.7163191405288012
7181,1739704398,1739707998,3600,0.30530747047242823,3.0286439844319033,0.1,0.1
7182,1739707998,1739708182,184,0.9347598364883218,3.6692395178228225,0.6170785896411711,0.727815370459925
7183,1739711598,1739714011,2413,2.1437080704459457,4.679948999639246,0.8402923644177643,0.5640109693243969
7184,1739715198,1739718798,3600,0.3613517179498723,3.0058579038302162,0.1,0.1
7185,1739718798,1739719663,865,1.497946392202352,3.9412162215163846,0.11806995683493456,0.4211549397611347
7186,1739722398,1739725998,3600,0.17145733786969103,3.0709593115275533,0.1,0.1
7187,1739725998,1739728092,2094,1.5946999933207289,4.386127846465054,0.42401491302439653,0.9147423911176074
7188,1739729598,1739733198,3600,0.1655761351512131,3.1141752786442845,0.1,0.1
7189,1739733198,1739736450,3252,1.8476155845894062,4.592336160898486,0.61037598590421,0.6693299950145059
7190,1739736798,1739740058,3260,2.062011978034112,4.3466408271901065,0.4840841987246164,0.4633956227643221
7191,1739740398,1739743998,3600,0.49031474345596415,3.0987367580178553,0.1,0.1
7192,1739743998,1739745468,1470,1.1299336005473146,4.038243630506703,0.9160650992090017,0.10000643435556655
7193,1739747598,1739749309,1711,1.180678785733979,3.9971884105735294,0.7978224863776839,0.8035196860090641
7194,1739751198,1739754798,3600,0.2836135107908624,3.060568640442614,0.1,0.1
7195,1739754798,1739758398,3600,0.20385714292130053,3.0664832303249674,0.1,0.1
7196,1739758398,1739761998,3600,0.19794447267071003,3.1572864885838623,0.1,0.1
7197,1739761998,1739763308,1310,1.4466122865946867,4.150593098790418,0.949532586558038,0.74043182114925
7198,1739765598,1739766365,767,1.4528632845332785,4.158176478268282,0.5698443930578307,0.9362603745188818
7199,1739769198,1739772798,3600,0.20434023684292907,3.177518435761765,0.1,0.1
7200,1739772798,1739775313,2515,2.1296257616810554,4.522585497978843,0.2575157074354173,0.580040729490768
7201,1739776398,1739779998,3600,0.27170522188285556,3.0727569911270702,0.1,0.1
7202,1739779998,1739783598,3600,0.2644810268880272,3.1754862925897807,0.1,0.1
7203,1739783598,1739785299,1701,1.4230742088350377,3.9813763870230163,0.6626578230368705,0.6852658696226491
7204,1739787198,1739790598,3400,1.876651789093628,4.451259567979688,0.34415521650444797,0.6994820081928717
7205,1739790798,1739793345,2547,1.8079819340349594,4.530706392234974,0.10357729536319227,0.9632483802642234
7206,1739794398,1739795646,1248,1.4468811829231136,3.969097417358779,0.26300831720993856,0.5167218996545596
7207,1739797998,1739801467,3469,1.9378158641259167,4.528911075599848,0.3920048064005842,0.9787420900773228
7208,1739801598,1739805198,3600,0.1782132970040268,3.0655664087519225,0.1,0.1
7209,1739805198,1739805524,326,0.9286223371877802,3.3005251063503347,0.6508405029535761,0.5507839832781467
7210,1739808798,1739809157,359,0.5144895508420696,3.6258095355759083,0.7780932648434019,0.5209516113837982
7211,1739812398,1739815492,3094,1.6421080024996808,4.5433846666202955,0.6326192714794573,0.12914612215746094
7212,1739815998,1739817217,1219,1.4345748947681027,4.032509240070099,0.37600429449422457,0.8100843939179994
7213,1739819598,1739823198,3600,0.34848643224873865,3.005714009763569,0.1,0.1
7214,1739823198,1739825737,2539,2.4835496196924005,4.357105324661786,0.704384118758669,0.41919643494294423
7215,1739826798,1739830398,3600,0.2872748806145301,3.0455425227344963,0.1,0.1
7216,1739830398,1739833998,3600,0.44039693980769135,3.0647424625040927,0.1,0.1
7217,1739833998,1739837598,3600,0.1345015555835803,3.1142368345821887,0.1,0.1
7218,1739837598,1739841198,3600,0.34509432604258883,3.1190451595780386,0.1,0.1
7219,1739841198,1739842471,1273,1.1053729776789556,3.818773483224894,0.11268660602902844,0.6862812756209314
7220,1739844798,1739848361,3563,2.37953185914703,4.583726846842764,0.7738467589586646,0.9667516824234236
7221,1739848398,1739851998,3600,0.13795441133424574,3.0976418251873907,0.1,0.1
7222,1739851998,1739855598,3600,0.439901919051342,3.0703858888048234,0.1,0.1
7223,1739855598,1739858993,3395,1.9614077320072405,4.42147539481545,0.9459632348803588,0.26279757014391614
7224,1739859198,1739862798,3600,0.20711370431914744,3.11376108661946,0.1,0.1
7225,1739862798,1739866398,3600,0.15512094183279368,3.1339169718274626,0.1,0.1
7226,1739866398,1739869998,3600,0.20393259701195118,3.107071258729515,0.1,0.1
7227,1739869998,1739873598,3600,0.4546150874252992,3.034813106931766,0.1,0.1
7228,1739873598,1739876965,3367,1.9011393892012944,4.3636309320304285,0.24006312174142216,0.3062954799294697
7229,1739877198,1739880798,3600,0.22999021385018767,3.1254197392461416,0.1,0.1
7230,1739880798,1739880980,182,0.9357724591216539,3.3975257937187506,0.641819333465811,0.9092297506437708
7231,1739884398,1739885064,666,1.1607877678068954,3.8164109642522326,0.8990775245407592,0.23493408320466974
7232,1739887998,1739888111,113,0.9933740476784199,3.3031075393834293,0.31063233084124664,0.41094318758654347
7233,1739891598,1739892881,1283,1.2480252020853952,3.890137651981247,0.7312255557485684,0.39971457971477964
7234,1739895198,1739898798,3600,0.200957865573696,3.164003007832496,0.1,0.1
7235,1739898798,1739902398,3600,0.2475603213914714,3.0384839783687623,0.1,0.1
7236,1739902398,1739903772,1374,1.4553841568497266,4.118825840381285,0.5579124904432302,0.6865729161091216
7237,1739905998,1739909598,3600,0.2526481069678359,3.1981890625863048,0.1,0.1
7238,1739909598,1739913198,3600,0.17634456306551197,3.0744258961748403,0.1,0.1
7239,1739913198,1739913635,437,0.8222972957004735,3.5994808481964906,0.5186782316166986,0.8696065627278061
7240,1739916798,1739919510,2712,1.6415861892630792,4.380369200275041,0.6595368385497956,0.7100285087234635
7241,1739920398,1739922094,1696,1.4912086724339744,3.9235381712105823,0.7984746966335998,0.2519241165796029
7242,1739923998,1739927598,3600,0.3612002739791299,3.1067649332799765,0.1,0.1
7243,1739927598,1739928955,1357,1.4832834838606348,3.9330403445365048,0.9374996662337427,0.9318443147892163
7244,1739931198,1739932493,1295,1.4585276780093461,3.960558670274274,0.46330544499898196,0.3537893330898607
7245,1739934798,1739938398,3600,0.4357271574740199,3.1488443847781498,0.1,0.1
7246,1739938398,1739941998,3600,0.16606112629083775,3.106326750904353,0.1,0.1
7247,1739941998,1739942972,974,1.2492155317472355,4.156935637479852,0.6509254058608432,0.7424350958268625
7248,1739945598,1739948842,3244,2.2913804318403947,4.32871739320652,0.5110926774469198,0.11597933183702513
7249,1739949198,1739952798,3600,0.11404756498214189,3.1215374861059906,0.1,0.1
7250,1739952798,1739953690,892,1.4286137749134624,3.8112408487043967,0.4879981744715767,0.1058116628954896
7251,1739956398,1739959688,3290,2.345117573270424,4.513226733881476,0.6052641378084135,0.29335965454945767
7252,1739959998,1739960860,862,1.0134722079659464,3.9933282015094567,0.390882150344522,0.21149226065568805
7253,1739963598,1739967198,3600,0.34272914913247576,3.178890064013292,0.1,0.1
7254,1739967198,1739970798,3600,0.13244124858613204,3.190362105027192,0.1,0.1
7255,1739970798,1739973882,3084,1.7200591255930067,4.461166336925984,0.9287696066218591,0.5812674061203312
7256,1739974398,1739975878,1480,1.2866338643083814,3.880274562083856,0.6941790421196253,0.1897357450947012
7257,1739977998,1739980139,2141,2.305148135357625,4.313188321593993,0.4730505740453931,0.48013720136654847
7258,1739981598,1739985198,3600,0.47525011832737984,3.194743814144611,0.1,0.1
7259,1739985198,1739986846,1648,1.376553340316411,4.136502754760303,0.9521783857664211,0.5589130189116862
7260,1739988798,1739992398,3600,0.134185234965581,3.1280195166940783,0.1,0.1
7261,1739992398,1739994083,1685,1.0654905585358605,3.8085800611188954,0.43209861686071316,0.2972199871003696
7262,1739995998,1739999598,3600,0.2928778965635359,3.1529632153172304,0.1,0.1
7263,1739999598,1740000757,1159,1.4977755884709754,3.8853342724543007,0.9850143744775021,0.6408633032349458
7264,1740003198,1740006798,3600,0.42273507137927013,3.192961856762111,0.1,0.1
7265,1740006798,1740010398,3600,0.3520936908567961,3.140463128566495,0.1,0.1
7266,1740010398,1740013998,3600,0.14137574509375708,3.1204051215376403,0.1,0.1
7267,1740013998,1740017598,3600,0.19614329259587016,3.000053688010426,0.1,0.1
7268,1740017598,1740020153,2555,1.8678860963438741,4.685573341533577,0.7104504164922567,0.5765559322141937
7269,1740021198,1740022081,883,1.2348499758742506,4.030729398897478,0.12311214000739162,0.7863932844318978
7270,1740024798,1740027734,2936,1.8589027086086798,4.382832357745305,0.13352196399082605,0.31777255074284255
7271,1740028398,1740031562,3164,2.1951542592905495,4.604871338589237,0.7044386820080794,0.6329244070086288
7272,1740031998,1740033249,1251,1.2961665502394824,3.835191964222516,0.9654790384547294,0.5645392463244129
7273,1740035598,1740038620,3022,1.543025344716955,4.672264131345207,0.34668862489046437,0.4745661251171387
7274,1740039198,1740041165,1967,1.5519390171802603,4.5297247940461585,0.21921071886209595,0.42130686680071017
7275,1740042798,1740046199,3401,2.3732562275642257,4.498403758031485,0.6732659967376954,0.924648421924603
7276,1740046398,1740049426,3028,2.438260547776988,4.501830199993125,0.4363590597606758,0.6517518647596932
7277,1740049998,1740053598,3600,0.36924238092409634,3.1397800936568823,0.1,0.1
7278,1740053598,1740056044,2446,1.60679299779522,4.659630729361837,0.6910120248624188,0.797460377579432
7279,1740057198,1740060798,3600,0.47193538433836546,3.190425253630949,0.1,0.1
7280,1740060798,1740064398,3600,0.13459758636345562,3.1700794519222173,0.1,0.1
7281,1740064398,1740067998,3600,0.17902230111988138,3.0008630807937724,0.1,0.1
7282,1740067998,1740071598,3600,0.339551744630018,3.1660196462233303,0.1,0.1
7283,1740071598,1740073489,1891,1.8788082893476776,4.315080448257956,0.40149741697250585,0.7876290982485544
7284,1740075198,1740078798,3600,0.4045861037678762,3.1682009592092477,0.1,0.1
7285,1740078798,1740082398,3600,0.4841904391659124,3.1252353608201195,0.1,0.1
7286,1740082398,1740083351,953,1.393381957471001,4.107269423345571,0.36214805999318567,0.8811068137203971
7287,1740085998,1740089598,3600,0.3939792862883007,3.1015407223276017,0.1,0.1
7288,1740089598,1740093198,3600,0.38085479442127046,3.170592068816424,0.1,0.1
7289,1740093198,1740096786,3588,1.6897423334258175,4.688292228803054,0.926752152586076,0.48073078301477934
7290,1740096798,1740100398,3600,0.42798255069065694,3.0783612792347244,0.1,0.1
7291,1740100398,1740103998,3600,0.3449738336316351,3.071428148483668,0.1,0.1
7292,1740103998,1740107150,3152,2.1158744320924665,4.4462222264866496,0.28936963886124834,0.3694135362875238
7293,1740107598,1740111198,3600,0.4548752745491186,3.1614302557790097,0.1,0.1
7294,1740111198,1740114798,3600,0.4021152907127764,3.1962141830313313,0.1,0.1
7295,1740114798,1740117047,2249,2.2846170112371724,4.5421344807749655,0.6213759468583864,0.26591133356485597
7296,1740118398,1740121998,3600,0.1695294456522546,3.1621152808790294,0.1,0.1
7297,1740121998,1740122810,812,1.3245950884467943,4.109389720066678,0.9511209984220005,0.34130962703041184
7298,1740125598,1740126992,1394,1.1506216406303127,3.928016526323623,0.9874951721510374,0.7977368420047792
7299,1740129198,1740132798,3600,0.2608616869059296,3.078053644373494,0.1,0.1
7300,1740132798,1740134600,1802,1.8962666559731824,4.314583109207834,0.8578270971468325,0.28531678010896766
7301,1740136398,1740139998,3600,0.16994446567223148,3.0767252974536774,0.1,0.1
7302,1740139998,1740141340,1342,1.1488050409420922,4.133971649000925,0.6229646101729771,0.49911237547356524
7303,1740143598,1740147198,3600,0.3151487351938277,3.040741688481902,0.1,0.1
7304,1740147198,1740150798,3600,0.32243604807165205,3.1460693095708394,0.1,0.1
7305,1740150798,1740153397,2599,1.820352044829725,4.569175750704348,0.2088321205700356,0.8717674140052932
7306,1740154398,1740157998,3600,0.18983568365719983,3.074837226364887,0.1,0.1
7307,1740157998,1740158825,827,1.0346429157674797,3.827032520759346,0.7599468930852881,0.5334075172646784
7308,1740161598,1740165198,3600,0.40518279957263215,3.1438018903657894,0.1,0.1
7309,1740165198,1740168798,3600,0.3517498015786127,3.0091178247805037,0.1,0.1
7310,1740168798,1740169733,935,1.1692323926154313,3.8364351290807672,0.39164346273485207,0.7425747467025355
7311,1740172398,1740175998,3600,0.4549019649388084,3.158254542152663,0.1,0.1
7312,1740175998,1740179598,3600,0.45008079261963374,3.161672997641018,0.1,0.1
7313,1740179598,1740182428,2830,1.6557862210814687,4.497863238348061,0.8684054745562633,0.1168672547512428
7314,1740183198,1740185828,2630,1.5429183091225633,4.303046749221383,0.60230899433417,0.5450893671257566
7315,1740186798,1740190398,3600,0.4635847992026888,3.1825439231099355,0.1,0.1
7316,1740190398,1740193831,3433,2.1766137151281764,4.672558412446271,0.18652330912647003,0.291884935712569
7317,1740193998,1740197598,3600,0.1454037824418363,3.059888711406919,0.1,0.1
7318,1740197598,1740200281,2683,1.530906038086144,4.526245667027955,0.663071269689064,0.3410481512608075
7319,1740201198,1740204798,3600,0.46885359622384415,3.197991082527121,0.1,0.1
7320,1740204798,1740205110,312,0.7636492469143121,3.6624376785018335,0.22162123136004752,0.7793127422024076
7321,1740208398,1740211998,3600,0.19271110221272722,3.171979367137345,0.1,0.1
7322,1740211998,1740213209,1211,1.2593957350411917,4.050076589114117,0.569937786830784,0.9942756756308117
7323,1740215598,1740216370,772,1.0885759462975153,4.00019551471673,0.18844638686117599,0.6912616995764055
7324,1740219198,1740220126,928,1.365469147944268,3.8323911533779422,0.28883203051720785,0.40923097992847945
7325,1740222798,1740224162,1364,1.328736285812573,4.000466489229111,0.9309691642271981,0.7084079056969242
7326,1740226398,1740229998,3600,0.29924772472019306,3.021855880633022,0.1,0.1
7327,1740229998,1740232004,2006,2.104631251536564,4.324844709251462,0.5259022702026149,0.39191339670297687
7328,1740233598,1740237149,3551,2.268285084084935,4.540031266678732,0.8139626821770132,0.4331267912902721
7329,1740237198,1740240798,3600,0.4658473956317766,3.151676355475424,0.1,0.1
7330,1740240798,1740244398,3600,0.2083130120213088,3.143000508247615,0.1,0.1
7331,1740244398,1740244726,328,0.9735890760059466,3.621678028678886,0.9237686779487208,0.8320568955702314
7332,1740247998,1740251598,3600,0.3652608809599992,3.1463477935127617,0.1,0.1
7333,1740251598,1740253987,2389,1.8574905730256472,4.532469696184044,0.5088206091390379,0.16253078516935632
7334,1740255198,1740257901,2703,2.186110703082148,4.646374154635499,0.868133496680048,0.34941251502309556
7335,1740258798,1740262398,3600,0.22428801743541113,3.0527097545783928,0.1,0.1
7336,1740262398,1740265998,3600,0.4327368230204246,3.053855365201905,0.1,0.1
7337,1740265998,1740269598,3600,0.39856523810403177,3.1361067756917818,0.1,0.1
7338,1740269598,1740273198,3600,0.3374846668384218,3.013896609501249,0.1,0.1
7339,1740273198,1740276798,3600,0.20768174537941625,3.123059341734771,0.1,0.1
7340,1740276798,1740280398,3600,0.4251230937592003,3.1628090535102866,0.1,0.1
7341,1740280398,1740282134,1736,1.141247517388659,4.089676155507336,0.5658577776658483,0.29333518182063445
7342,1740283998,1740286544,2546,2.002661620958929,4.436870000351498,0.38584726627780264,0.3707700439720548
7343,1740287598,1740291198,3600,0.3606731632272251,3.143967747206479,0.1,0.1
7344,1740291198,1740292455,1257,1.4845488410209589,4.0106707237742505,0.36480083054131063,0.3948066905430254
7345,1740294798,1740298398,3600,0.4653281361960785,3.1906162050768536,0.1,0.1
7346,1740298398,1740301998,3600,0.47864953293705437,3.1363430535929986,0.1,0.1
7347,1740301998,1740302654,656,1.070080403737172,3.8255927577457975,0.6619111132932564,0.8194371403664555
7348,1740305598,1740308066,2468,2.143388952954957,4.487403228796321,0.18585192970598188,0.7260283944969844
7349,1740309198,1740312798,3600,0.397740412025991,3.177840219370904,0.1,0.1
7350,1740312798,1740316398,3600,0.44014104216718675,3.044588641390432,0.1,0.1
7351,1740316398,1740319998,3600,0.4619392746601684,3.0443695565786033,0.1,0.1
7352,1740319998,1740323598,3600,0.42105857162129856,3.1917491727371745,0.1,0.1
7353,1740323598,1740323711,113,0.5653438779395752,3.331813584329448,0.2643082475855679,0.3807474375427764
7354,1740327198,1740328544,1346,1.0451421364033453,3.9462563082742212,0.9095125454732517,0.595140126303324
7355,1740330798,1740334398,3600,0.1876625324614264,3.127782613475344,0.1,0.1
7356,1740334398,1740337998,3600,0.41378376751660484,3.177078033126855,0.1,0.1
7357,1740337998,1740341205,3207,2.008109894695137,4.671340692880192,0.1615644521374907,0.47744011999640645
7358,1740341598,1740345198,3600,0.3555191649566537,3.026065730275839,0.1,0.1
7359,1740345198,1740348798,3600,0.30234073746076084,3.142578254381681,0.1,0.1
7360,1740348798,1740352398,3600,0.4184318568952914,3.0650320462657623,0.1,0.1
7361,1740352398,1740355998,3600,0.19066607159691765,3.1924320813150038,0.1,0.1
7362,1740355998,1740359598,3600,0.11571905809861259,3.1788909982279714,0.1,0.1
7363,1740359598,1740363198,3600,0.26516210136070983,3.040630719097199,0.1,0.1
7364,1740363198,1740366798,3600,0.3033647327700367,3.0229527149551796,0.1,0.1
7365,1740366798,1740367833,1035,1.4445390274340462,4.080247028300318,0.16376503089098843,0.5940264822944651
7366,1740370398,1740373998,3600,0.42877367631962393,3.0702559751762557,0.1,0.1
7367,1740373998,1740377598,3600,0.39219047505081295,3.150881838725174,0.1,0.1
7368,1740377598,1740381198,3600,0.11550887964966035,3.185275172128033,0.1,0.1
7369,1740381198,1740381714,516,0.7996756639307045,3.5449102475533953,0.9948181324943174,0.20470603771992857
7370,1740384798,1740388398,3600,0.22175928020133673,3.1192218822145286,0.1,0.1
7371,1740388398,1740391998,3600,0.10629987358041092,3.1634446251678114,0.1,0.1
7372,1740391998,1740394920,2922,2.3790717099852454,4.340579069454789,0.7570691471760013,0.9211834584813945
7373,1740395598,1740398734,3136,2.3832681321315614,4.5519602065489035,0.7459999872002567,0.49956576870616576
7374,1740399198,1740402748,3550,1.9006012589678005,4.377472600293242,0.5804257700808249,0.6822673970189306
7375,1740402798,1740406398,3600,0.2154616404305763,3.136087717306106,0.1,0.1
7376,1740406398,1740409998,3600,0.13983507138920867,3.081576879272197,0.1,0.1
7377,1740409998,1740413553,3555,2.026441247845255,4.475859934762921,0.20000276931139035,0.4744844741840968
7378,1740413598,1740417198,3600,0.13311835689113694,3.0598639477365746,0.1,0.1
7379,1740417198,1740420798,3600,0.3593185712442327,3.163119795685283,0.1,0.1
7380,1740420798,1740422137,1339,1.3170217908157504,4.052489442092265,0.9461665245398316,0.7949806561929564
7381,1740424398,1740427998,3600,0.4922846366735658,3.004150889489314,0.1,0.1
7382,1740427998,1740431598,3600,0.14641005335001048,3.1012117154974774,0.1,0.1
7383,1740431598,1740432285,687,1.0615893842050512,4.091197101892198,0.37468131662343107,0.7895359681544682
7384,1740435198,1740438798,3600,0.3177987201000952,3.1403798974110897,0.1,0.1
7385,1740438798,1740440236,1438,1.2935926053183837,3.879622765097274,0.2208581303773829,0.2739480478170609
7386,1740442398,1740443078,680,1.1995014449641797,4.072031470491961,0.6179885316592227,0.42523962377759084
7387,1740445998,1740449598,3600,0.3689148501685998,3.0690398092518976,0.1,0.1
7388,1740449598,1740453198,3600,0.3229890874180068,3.0767696566421248,0.1,0.1
7389,1740453198,1740454759,1561,1.391642297268652,4.195816676016315,0.8228646172458618,0.6886685532159867
7390,1740456798,1740460398,3600,0.496433106559791,3.0509028451538542,0.1,0.1
7391,1740460398,1740463998,3600,0.11057071655929401,3.1363463218862875,0.1,0.1
7392,1740463998,1740467598,3600,0.2680702837902863,3.1027638851667594,0.1,0.1
7393,1740467598,1740471198,3600,0.174039921504226,3.181065885663827,0.1,0.1
7394,1740471198,1740474798,3600,0.29027818925013615,3.141409549250427,0.1,0.1
7395,1740474798,1740478398,3600,0.1919932155902112,3.1918864922176797,0.1,0.1
7396,1740478398,1740481998,3600,0.3759818205936666,3.014153959778698,0.1,0.1
7397,1740481998,1740484057,2059,2.0947428342645686,4.474301958138555,0.8502004979152797,0.45520776425805953
7398,1740485598,1740486276,678,1.495328921720766,3.994120271373357,0.18876887509592505,0.4674458008939092
7399,1740489198,1740492197,2999,2.1408267867308752,4.316000459881235,0.5087906397939701,0.7281503902513821
7400,1740492798,1740496398,3600,0.22176681614240323,3.0477491467273676,0.1,0.1
7401,1740496398,1740499998,3600,0.4641337224501577,3.1807345965306677,0.1,0.1
7402,1740499998,1740503598,3600,0.34417006746306844,3.0949079784006766,0.1,0.1
7403,1740503598,1740507198,3600,0.32139331977956515,3.120636721591518,0.1,0.1
7404,1740507198,1740510798,3600,0.16564759697254772,3.1209461051204705,0.1,0.1
7405,1740510798,1740514398,3600,0.17495073593611615,3.0621199658301173,0.1,0.1
7406,1740514398,1740517998,3600,0.27684705146657873,3.1588557058714786,0.1,0.1
7407,1740517998,1740520287,2289,1.7245143111150845,4.594655874790614,0.507739818040183,0.6348269914829742
7408,1740521598,1740525198,3600,0.17699243522286223,3.0027843562881342,0.1,0.1
7409,1740525198,1740527341,2143,1.976361181418988,4.606207041366151,0.3576475639042833,0.777747342080213
7410,1740528798,1740531211,2413,2.125661587240481,4.6776621523097015,0.5196565850268351,0.9580809375526812
7411,1740532398,1740532508,110,0.7001037258346452,3.649879892294511,0.6495706134460676,0.41101645054687275
7412,1740535998,1740539598,3600,0.2582951144312212,3.0928310397723364,0.1,0.1
7413,1740539598,1740543198,3600,0.42474358030253445,3.0794546358966444,0.1,0.1
7414,1740543198,1740546798,3600,0.17099600262997533,3.040608954873014,0.1,0.1
7415,1740546798,1740550398,3600,0.4126090438745075,3.132685197886138,0.1,0.1
7416,1740550398,1740550957,559,0.8191208637016281,3.598946297698466,0.4694687103824451,0.5103158161334103
7417,1740553998,1740557598,3600,0.12739755392050106,3.1996097020509593,0.1,0.1
7418,1740557598,1740558337,739,1.1115157880249964,4.019535632487849,0.43161707361524193,0.39652917987018765
7419,1740561198,1740564798,3600,0.4565739555100634,3.1580977430008215,0.1,0.1
7420,1740564798,1740567754,2956,1.5454925432018398,4.303705960161726,0.3096884553002916,0.4720006869553649
7421,1740568398,1740571998,3600,0.1514363561197786,3.1961924693295884,0.1,0.1
7422,1740571998,1740572078,80,0.9640696531872537,3.552710790880651,0.7435644850731822,0.585641814556858
7423,1740575598,1740579198,3600,0.14558358454726303,3.0325350841792225,0.1,0.1
7424,1740579198,1740579529,331,0.767281103217773,3.692417893480436,0.4516778729659905,0.8083018892859982
7425,1740582798,1740583380,582,0.8517738512855316,3.43712626055919,0.574534365624351,0.7428515489375117
7426,1740586398,1740589998,3600,0.3439486560502898,3.154353759037532,0.1,0.1
7427,1740589998,1740593598,3600,0.3378349147119191,3.1597152207886,0.1,0.1
7428,1740593598,1740597198,3600,0.47240352811436437,3.0392123050436997,0.1,0.1
7429,1740597198,1740600798,3600,0.43184928368392306,3.1581667549881622,0.1,0.1
7430,1740600798,1740604398,3600,0.4165480107311169,3.02975339882211,0.1,0.1
7431,1740604398,1740607998,3600,0.1310850167579996,3.091974572345014,0.1,0.1
7432,1740607998,1740610848,2850,1.9911592390427448,4.3086759028843975,0.9142571229630343,0.6363532184741865
7433,1740611598,1740615198,3600,0.10758177383211552,3.0236365088269603,0.1,0.1
7434,1740615198,1740618798,3600,0.2618593948780077,3.073285698844725,0.1,0.1
7435,1740618798,1740622398,3600,0.24685028091469313,3.1908995804368723,0.1,0.1
7436,1740622398,1740625998,3600,0.174845659190806,3.102427510690683,0.1,0.1
7437,1740625998,1740628293,2295,1.7321529458627625,4.318210687652003,0.4499864075528647,0.34445763212748925
7438,1740629598,1740633198,3600,0.35260465075450353,3.0993842916978656,0.1,0.1
7439,1740633198,1740634293,1095,1.4244527669254783,4.092987948425266,0.7353203099266032,0.9926587156356911
7440,1740636798,1740640398,3600,0.37480745768301815,3.02732344093989,0.1,0.1
7441,1740640398,1740643316,2918,2.403354753269964,4.408471800408387,0.12281030172591101,0.2628308060113078
7442,1740643998,1740645896,1898,1.860425536611808,4.445813146389448,0.16853160709259274,0.8297059281466971
7443,1740647598,1740651198,3600,0.44720875508931923,3.0137519267576045,0.1,0.1
7444,1740651198,1740654095,2897,2.4965736754042056,4.424138024911954,0.13406199236979427,0.5337650716921775
7445,1740654798,1740658398,3600,0.38197265922942225,3.0495561218575333,0.1,0.1
7446,1740658398,1740659665,1267,1.0795768759921238,3.8647421581477417,0.15164956031264462,0.4160216651441212
7447,1740661998,1740662596,598,0.8329134535010764,3.638030243124833,0.5236343644874359,0.8800305394559629
7448,1740665598,1740667487,1889,1.5786221339870774,4.624103757896812,0.198736660868727,0.876935408517949
7449,1740669198,1740672798,3600,0.3812648034202726,3.118754684445749,0.1,0.1
7450,1740672798,1740673237,439,0.999426188832,3.3617386733998327,0.8507840758945575,0.9057878971084719
7451,1740676398,1740679998,3600,0.12247194604918432,3.0474043436119813,0.1,0.1
7452,1740679998,1740683598,3600,0.4895417844260954,3.1520517405625337,0.1,0.1
7453,1740683598,1740687198,3600,0.44442011731764264,3.1087308615090987,0.1,0.1
7454,1740687198,1740690252,3054,2.2764757673852465,4.579354316378558,0.15535233841837404,0.4793040034114292
7455,1740690798,1740693016,2218,2.336783254004648,4.6492884352106865,0.3798101928528631,0.660057961752148
7456,1740694398,1740696355,1957,2.3638916588559864,4.420824012023582,0.4859931220471082,0.11201389075557887
7457,1740697998,1740699843,1845,2.094746064509821,4.678837656093164,0.9579158882235002,0.8807559121848981
7458,1740701598,1740705111,3513,1.5046592884465166,4.66149852285628,0.932519849245369,0.19915603336776896
7459,1740705198,1740708798,3600,0.3517998195709283,3.119907450610221,0.1,0.1
7460,1740708798,1740712398,3600,0.45338872466893065,3.122603734146996,0.1,0.1
7461,1740712398,1740715998,3600,0.12353585921345367,3.1258347910939777,0.1,0.1
7462,1740715998,1740717284,1286,1.3934598908755373,3.9512560939954198,0.504874403647797,0.901881053427988
7463,1740719598,1740721793,2195,1.5978383999831616,4.448829692095848,0.41293303892649913,0.45766745955209787
7464,1740723198,1740726798,3600,0.2695684076409939,3.0518686727002744,0.1,0.1
7465,1740726798,1740730398,3600,0.48851728564968777,3.1147674582497915,0.1,0.1
7466,1740730398,1740732303,1905,1.5584418163877518,4.529996476859422,0.5032599789095821,0.4250376503261569
7467,1740733998,1740737169,3171,1.5439552694588201,4.614046605531317,0.27283150731239575,0.8933061219441554
7468,1740737598,1740741198,3600,0.3237539821970948,3.123885275361251,0.1,0.1
7469,1740741198,1740742408,1210,1.200327439667002,3.926738290271444,0.6514604040292971,0.4823625102050956
7470,1740744798,1740747386,2588,2.451757606775356,4.652590404804309,0.7667497450804024,0.17003823848520078
7471,1740748398,1740749761,1363,1.4877398084275035,4.141755340657901,0.5821006789447254,0.3278199723491756
7472,1740751998,1740752658,660,1.2843838366782974,3.899357106996895,0.4400691944233679,0.7738422313987273
7473,1740755598,1740759198,3600,0.16003105800289968,3.1640280815359,0.1,0.1
7474,1740759198,1740762798,3600,0.4469367262345757,3.0660192678951,0.1,0.1
7475,1740762798,1740765553,2755,1.8904579775481407,4.496843048920231,0.4213699519192903,0.6322924626650287
7476,1740766398,1740769998,3600,0.15066135752109658,3.1235121526804255,0.1,0.1
7477,1740769998,1740773598,3600,0.39598740699175794,3.152864120801702,0.1,0.1
7478,1740773598,1740776223,2625,2.0097815690411154,4.485853530055398,0.38034814764039027,0.9175791908573583
7479,1740777198,1740780055,2857,2.33872154659033,4.661460974851758,0.7234375398802307,0.17910905010036055
7480,1740780798,1740781595,797,1.0946247096004291,4.120129585848043,0.4001419264878533,0.15005414134084782
7481,1740784398,1740787998,3600,0.13353657412310801,3.0484689144137604,0.1,0.1
7482,1740787998,1740791598,3600,0.36306323492041825,3.0871299747758,0.1,0.1
7483,1740791598,1740795198,3600,0.2795873144527797,3.1739156951947427,0.1,0.1
7484,1740795198,1740796488,1290,1.2477369281394988,3.9193906096264746,0.14626182946748592,0.8534749877021108
7485,1740798798,1740802398,3600,0.1397088484243419,3.067621419148353,0.1,0.1
7486,1740802398,1740804781,2383,1.9316787021588642,4.586539768983772,0.4280910385581095,0.106227336740779
7487,1740805998,1740809598,3600,0.3383864474855065,3.047489454825988,0.1,0.1
7488,1740809598,1740813198,3600,0.2672497182674168,3.1486066162703747,0.1,0.1
7489,1740813198,1740815715,2517,1.8467234999120352,4.411587872449941,0.5423191645463092,0.5240145285517951
7490,1740816798,1740817696,898,1.2699783094973056,4.1809297325492425,0.2480884358550234,0.6415643217540122
7491,1740820398,1740823998,3600,0.14281908986637412,3.1043363014256515,0.1,0.1
7492,1740823998,1740827598,3600,0.20659066059282938,3.112152908459757,0.1,0.1
7493,1740827598,1740828149,551,0.8429381687244163,3.5005267246693226,0.5332269686539629,0.689309654385166
7494,1740831198,1740831587,389,0.6956908222136299,3.4323944733011698,0.4496338973853894,0.2222611754044169
7495,1740834798,1740838398,3600,0.1607698391379754,3.123557307153523,0.1,0.1
7496,1740838398,1740840565,2167,1.7623294319036233,4.309101731963566,0.9932020075848206,0.6885157363692244
7497,1740841998,1740844069,2071,2.243799575948754,4.694647362215158,0.10456335812914726,0.9296633260926211
7498,1740845598,1740846779,1181,1.3890020538815775,4.050364562846861,0.3559802870314205,0.9620398845146746
7499,1740849198,1740852798,3600,0.232712388128246,3.093834782039302,0.1,0.1
7500,1740852798,1740853969,1171,1.0877242116070558,3.836201906959168,0.76662629567201,0.6100063866469105
7501,1740856398,1740857500,1102,1.0199188815235147,4.014034670614716,0.9301534760723087,0.6582712628605626
7502,1740859998,1740863598,3600,0.3432053841586724,3.175831907168823,0.1,0.1
7503,1740863598,1740867198,3600,0.49565341617540015,3.1350191633719455,0.1,0.1
7504,1740867198,1740870798,3600,0.2035671368775944,3.169579574463017,0.1,0.1
7505,1740870798,1740874398,3600,0.2036811758720478,3.194228528228329,0.1,0.1
7506,1740874398,1740876455,2057,1.604745712083536,4.353709744518649,0.9655248798244781,0.9246605839112388
7507,1740877998,1740881598,3600,0.23387939723169257,3.1008463868298173,0.1,0.1
7508,1740881598,1740883817,2219,1.546505663471358,4.4792087199855875,0.19586113629543545,0.6503474710442025
7509,1740885198,1740885310,112,0.6364256071428589,3.4676020630703217,0.9617466345528457,0.8052300484336614
7510,1740888798,1740892398,3600,0.11151655192915683,3.0232169994441676,0.1,0.1
7511,1740892398,1740895547,3149,1.9434963669631813,4.621104932017515,0.7296578624652428,0.24367494349462462
7512,1740895998,1740896788,790,1.4606505085312014,4.185060135851371,0.9827090060315146,0.26523034821630653
7513,1740899598,1740903198,3600,0.40271340457917293,3.0911882516018343,0.1,0.1
7514,1740903198,1740906798,3600,0.24981017201407704,3.1276372295687813,0.1,0.1
7515,1740906798,1740908205,1407,1.4730819385319593,3.8989648732189455,0.12256033413612899,0.9532793196065036
7516,1740910398,1740913624,3226,1.616425303203096,4.499912372941767,0.47047543986519136,0.6393627882826247
7517,1740913998,1740915251,1253,1.0109810541474633,4.009911485109387,0.37718334010296495,0.703972554379675
7518,1740917598,1740921198,3600,0.3033706254862881,3.1276088154131543,0.1,0.1
7519,1740921198,1740921472,274,0.9824446134893323,3.4200627395579373,0.26550595019889,0.3194016614081083
7520,1740924798,1740928398,3600,0.24140052285398816,3.014595875811473,0.1,0.1
7521,1740928398,1740928509,111,0.6293306150520652,3.4539338493303378,0.7144718309155301,0.46454311850652985
7522,1740931998,1740933769,1771,1.3824651053125965,3.949507350341479,0.966658254844019,0.9943024601410411
7523,1740935598,1740939198,3600,0.437488120134781,3.1672910479029794,0.1,0.1
7524,1740939198,1740940881,1683,1.1899454073359044,4.0532083579105445,0.21063094860378695,0.9519703652667253
7525,1740942798,1740943017,219,0.5938369724861031,3.6896832931949106,0.40257760793323094,0.7210271850372035
7526,1740946398,1740949998,3600,0.39040018245148,3.0278905189870633,0.1,0.1
7527,1740949998,1740953598,3600,0.4643348240808486,3.19460677711038,0.1,0.1
7528,1740953598,1740956006,2408,1.8351272643033592,4.463752502642282,0.7224573913797167,0.7704596249809165
7529,1740957198,1740960125,2927,1.820837604574955,4.511532724010338,0.42843622117109414,0.506620466006399
7530,1740960798,1740964398,3600,0.3845510167684506,3.0242778099433756,0.1,0.1
7531,1740964398,1740967998,3600,0.1395621741930181,3.0520455169593075,0.1,0.1
7532,1740967998,1740968758,760,1.4135840589032376,4.105865994814861,0.8690078605024222,0.501879942859389
7533,1740971598,1740975198,3600,0.17117269037982086,3.1430906207962432,0.1,0.1
7534,1740975198,1740978798,3600,0.29433739076402216,3.0295908614651563,0.1,0.1
7535,1740978798,1740979325,527,0.5743942845421909,3.500093870950413,0.5842076164284562,0.8442125656441146
7536,1740982398,1740985226,2828,2.363640009314334,4.369691013674278,0.6850440584082124,0.5949215944742833
7537,1740985998,1740986087,89,0.658790404390677,3.6770857700370203,0.32314475780085294,0.1901149180203083
7538,1740989598,1740989775,177,0.6908023334579776,3.6256249123334907,0.9335502249373036,0.8878390050976723
7539,1740993198,1740996798,3600,0.47530219191360745,3.141537909962837,0.1,0.1
7540,1740996798,1741000398,3600,0.37257896615495156,3.06330717368897,0.1,0.1
7541,1741000398,1741003998,3600,0.16411446891204967,3.0529831794849844,0.1,0.1
7542,1741003998,1741007598,3600,0.39273632550531823,3.1978635951785925,0.1,0.1
7543,1741007598,1741011198,3600,0.2876088995702518,3.105110907282545,0.1,0.1
7544,1741011198,1741014798,3600,0.2670134161694007,3.1611878498091923,0.1,0.1
7545,1741014798,1741018398,3600,0.3633064738226668,3.1849830332950786,0.1,0.1
7546,1741018398,1741019094,696,1.2356755440290188,4.009440520449524,0.3317369707774955,0.20256776010988653
7547,1741021998,1741025598,3600,0.12783476695603718,3.1131952012906265,0.1,0.1
7548,1741025598,1741029198,3600,0.31906962571498476,3.152951619925926,0.1,0.1
7549,1741029198,1741032798,3600,0.2502914141264321,3.10012855423499,0.1,0.1
7550,1741032798,1741036398,3600,0.2733883353584917,3.0893106083192117,0.1,0.1
7551,1741036398,1741039055,2657,1.5037054195835537,4.391595097180246,0.37439328138374195,0.33957033066602493
7552,1741039998,1741043598,3600,0.21040811704630002,3.0103609553289976,0.1,0.1
7553,1741043598,1741044222,624,1.097493366877164,4.1898495599706775,0.35765648349792434,0.41485709631288015
7554,1741047198,1741050798,3600,0.17587558001737605,3.111216377663398,0.1,0.1
7555,1741050798,1741053839,3041,1.8481829648321926,4.398463503927491,0.7282501763085344,0.3271135892059203
7556,1741054398,1741057998,3600,0.26719297602071246,3.03819645618131,0.1,0.1
7557,1741057998,1741061598,3600,0.1448335187510956,3.091535921380501,0.1,0.1
7558,1741061598,1741065198,3600,0.2058460211640759,3.04453498087113,0.1,0.1
7559,1741065198,1741068798,3600,0.25603846964245836,3.008681315150996,0.1,0.1
7560,1741068798,1741072398,3600,0.23918537426223643,3.1660898675881612,0.1,0.1
7561,1741072398,1741075998,3600,0.22460384456399216,3.118472367566019,0.1,0.1
7562,1741075998,1741077694,1696,1.0055737801536295,3.944259166193709,0.8036299566124675,0.10960548868011326
7563,1741079598,1741083198,3600,0.262899163150052,3.1429725393325776,0.1,0.1
7564,1741083198,1741086759,3561,1.9250459818392105,4.4385904564369945,0.4379691971326115,0.5747760958781604
7565,1741086798,1741089785,2987,1.894401963082589,4.537178458138468,0.2508118749975956,0.3905402437347193
7566,1741090398,1741093828,3430,2.2942100814589295,4.660040460973855,0.13886649676766644,0.7853707789587724
7567,1741093998,1741097598,3600,0.31939999987451456,3.081983665286488,0.1,0.1
7568,1741097598,1741099059,1461,1.2674629106618056,3.8076237805282376,0.14010965576697532,0.3444677783907245
7569,1741101198,1741103076,1878,1.7316453400329537,4.4155145281891155,0.46482608503041634,0.2370943466580932
7570,1741104798,1741108398,3600,0.2523985357204023,3.043624852264576,0.1,0.1
7571,1741108398,1741111053,2655,1.6098688060006205,4.670722178308267,0.4942133972955528,0.9768104327143118
7572,1741111998,1741113097,1099,1.0568748359713607,3.9956021717615453,0.137853763366521,0.7596412540672642
7573,1741115598,1741119198,3600,0.26457712351587237,3.0386990894673382,0.1,0.1
7574,1741119198,1741122798,3600,0.2261452215977439,3.0562602654543194,0.1,0.1
7575,1741122798,1741124403,1605,1.2701113765858192,3.971868994111852,0.8242439113271948,0.832872180502478
7576,1741126398,1741129963,3565,1.8497362111590205,4.441017894258913,0.21958418551973902,0.6903198742692922
7577,1741129998,1741133598,3600,0.31323145468985314,3.1569706091321317,0.1,0.1
7578,1741133598,1741137198,3600,0.18973365436764517,3.0371493159992955,0.1,0.1
7579,1741137198,1741137372,174,0.5583977741633257,3.5951282587946287,0.6910359776108742,0.6778655207599453
7580,1741140798,1741144398,3600,0.12330731034199807,3.1354373586958997,0.1,0.1
7581,1741144398,1741145083,685,1.3037142519665603,3.9767854304057457,0.4937873655197569,0.332141687550905
7582,1741147998,1741151598,3600,0.3654070740697991,3.1480540372378836,0.1,0.1
7583,1741151598,1741154482,2884,1.5266760247261844,4.515136439952539,0.6147001509204973,0.989676889250238
7584,1741155198,1741157056,1858,1.7017410972311207,4.615574243604549,0.9582377310665288,0.9570792646659694
7585,1741158798,1741162398,3600,0.46637991214893604,3.1002831391094325,0.1,0.1
7586,1741162398,1741165998,3600,0.2525366488817107,3.0676506497061973,0.1,0.1
7587,1741165998,1741169598,3600,0.4419452269013543,3.1069016811414087,0.1,0.1
7588,1741169598,1741172481,2883,1.571821143112268,4.449786869966647,0.8412914304663233,0.12266043440858768
7589,1741173198,1741175942,2744,2.06761422984283,4.5016472909142005,0.22258919116729986,0.635558817615389
7590,1741176798,1741180398,3600,0.3760464373859129,3.0377850781672064,0.1,0.1
7591,1741180398,1741180564,166,0.9575245972561478,3.459069216286728,0.5379590012256181,0.12467427402890424
7592,1741183998,1741187598,3600,0.45104848932766595,3.1269107991288116,0.1,0.1
7593,1741187598,1741190490,2892,2.4999844171995496,4.646842755729679,0.7055386196965021,0.2506225458156984
7594,1741191198,1741194100,2902,1.9391423336584352,4.567263609212526,0.8601518355453125,0.9152878557193025
7595,1741194798,1741198398,3600,0.17244221407648397,3.0156746413468953,0.1,0.1
7596,1741198398,1741199424,1026,1.333694102401456,4.058096622041398,0.45243914539068164,0.5766882633424447
7597,1741201998,1741205598,3600,0.43870951455407403,3.093709572360981,0.1,0.1
7598,1741205598,1741206930,1332,1.4156161100417723,4.002941556860327,0.9168599232017415,0.255498807515369
7599,1741209198,1741212798,3600,0.11068256175366038,3.159199944144886,0.1,0.1
7600,1741212798,1741216398,3600,0.12350295579845479,3.0143556261459357,0.1,0.1
7601,1741216398,1741217706,1308,1.412858678066701,3.8775216190771324,0.35526000069646224,0.48379107688814416
7602,1741219998,1741223598,3600,0.3632566533402096,3.130932633797731,0.1,0.1
7603,1741223598,1741225799,2201,1.878173200483523,4.631749522051219,0.4994938770311942,0.16878874026265017
7604,1741227198,1741229193,1995,1.7911622774048368,4.348281087849262,0.7052899353727509,0.5539319072279341
7605,1741230798,1741234398,3600,0.4487049647016985,3.155849861018397,0.1,0.1
7606,1741234398,1741237998,3600,0.28289927741806564,3.0208572815507626,0.1,0.1
7607,1741237998,1741238224,226,0.5029544896976585,3.5770525065351753,0.3926099115239796,0.8350999380764232
7608,1741241598,1741245198,3600,0.1679835153232665,3.1470463329573963,0.1,0.1
7609,1741245198,1741246461,1263,1.4530554904792332,3.8610422290774857,0.5688960597675489,0.5897376618874323
7610,1741248798,1741252398,3600,0.17888925760098023,3.0921919473080197,0.1,0.1
7611,1741252398,1741255998,3600,0.3465060881714972,3.1125826757926003,0.1,0.1
7612,1741255998,1741257378,1380,1.3199241461451667,3.8224827074172594,0.6411963876053666,0.6699913896975798
7613,1741259598,1741263198,3600,0.2874493261863025,3.146036468331889,0.1,0.1
7614,1741263198,1741266798,3600,0.2852837046968343,3.1359900453540774,0.1,0.1
7615,1741266798,1741270398,3600,0.29533035974300337,3.1103189130823212,0.1,0.1
7616,1741270398,1741273998,3600,0.25028457423009265,3.0326798984978125,0.1,0.1
7617,1741273998,1741274303,305,0.9712553830343764,3.3339605004214374,0.40185176128723565,0.83221672979174
7618,1741277598,1741281198,3600,0.2208609426790481,3.072817039083174,0.1,0.1
7619,1741281198,1741283115,1917,1.9962666585038074,4.642669954352334,0.8672145184251132,0.11414806441931655
7620,1741284798,1741287689,2891,2.180884993020199,4.408355477693207,0.4151246732351459,0.968381762012061
7621,1741288398,1741291998,3600,0.21005998291868244,3.0992168322569786,0.1,0.1
7622,1741291998,1741295598,3600,0.20361628474081228,3.0615503357345317,0.1,0.1
7623,1741295598,1741296955,1357,1.1257626548227182,3.9183747530848114,0.3899546601916317,0.5261946941739565
7624,1741299198,1741302798,3600,0.1501736891615234,3.06901402549384,0.1,0.1
7625,1741302798,1741306398,3600,0.2562477325745268,3.0729989333081367,0.1,0.1
7626,1741306398,1741309998,3600,0.3970654480800947,3.019051579107914,0.1,0.1
7627,1741309998,1741313598,3600,0.2562550525691343,3.141905453806742,0.1,0.1
7628,1741313598,1741314754,1156,1.4508041747331153,4.170624162538904,0.34734001957241106,0.9763094631910187
7629,1741317198,1741320798,3600,0.36858211903851656,3.057289071802657,0.1,0.1
7630,1741320798,1741323949,3151,1.7272769215744996,4.436522943192588,0.7197269771265788,0.6670826141155857
7631,1741324398,1741327998,3600,0.30051605966243233,3.015230842743345,0.1,0.1
7632,1741327998,1741331469,3471,1.6896747051566625,4.327032297539747,0.5848992793824275,0.6003788156789622
7633,1741331598,1741335198,3600,0.2213736457173841,3.0498045990850726,0.1,0.1
7634,1741335198,1741338798,3600,0.1166006125613134,3.013848948464777,0.1,0.1
7635,1741338798,1741342398,3600,0.12352270183328495,3.145980059502582,0.1,0.1
7636,1741342398,1741345724,3326,1.672249041870708,4.326827600489673,0.7473298042491663,0.3627378334288317
7637,1741345998,1741346957,959,1.3929494608254531,4.038326160949527,0.8124266347081719,0.9735697992489833
7638,1741349598,1741349902,304,0.8884258024869252,3.568322652637601,0.1161241231815196,0.5844403092478424
7639,1741353198,1741356798,3600,0.4993096977875757,3.1953309932691716,0.1,0.1
7640,1741356798,1741360398,3600,0.4559674051539482,3.0746502553801767,0.1,0.1
7641,1741360398,1741363998,3600,0.3631538076647276,3.1328001139316615,0.1,0.1
7642,1741363998,1741366076,2078,1.8796980127023757,4.685840279824335,0.9353941208344709,0.9910424793509433
7643,1741367598,1741369029,1431,1.13076206615733,3.887892437375713,0.8648300624199682,0.9283044130080764
7644,1741371198,1741374798,3600,0.24979003880591952,3.163435673787168,0.1,0.1
7645,1741374798,1741378398,3600,0.45588399715185013,3.166446380872164,0.1,0.1
7646,1741378398,1741381998,3600,0.40781984826782125,3.000506078905463,0.1,0.1
7647,1741381998,1741385598,3600,0.11838414779590845,3.0062315565206736,0.1,0.1
7648,1741385598,1741388583,2985,2.3534983551653124,4.517214690680723,0.8225557264750992,0.5758427991926727
7649,1741389198,1741391266,2068,2.2656450709854004,4.488126798839157,0.3209706835489681,0.8391722783111553
7650,1741392798,1741396398,3600,0.21313724125856834,3.0550244658378216,0.1,0.1
7651,1741396398,1741397516,1118,1.1406163413217405,4.185145296857952,0.335033824562078,0.41027215908787784
7652,1741399998,1741401875,1877,2.165650364254709,4.572850671898483,0.10099169316996973,0.7490969740742635
7653,1741403598,1741407198,3600,0.32471813274452155,3.075725387236934,0.1,0.1
7654,1741407198,1741408456,1258,1.0119384233439939,4.078557570174428,0.824844023314174,0.7332413583194979
7655,1741410798,1741413596,2798,1.6672387470963717,4.375459748698967,0.9899251866058757,0.3469467089412017
7656,1741414398,1741417998,3600,0.14808026738882107,3.020631399313015,0.1,0.1
7657,1741417998,1741421598,3600,0.2572707127134853,3.1585533230924616,0.1,0.1
7658,1741421598,1741425198,3600,0.43684904445475636,3.1082400843184526,0.1,0.1
7659,1741425198,1741428793,3595,2.179769969581729,4.444026810177271,0.771550446775572,0.4347950292361258
7660,1741428798,1741430167,1369,1.0382308398536884,4.094339109831597,0.934258561787944,0.6250282673791193
7661,1741432398,1741433859,1461,1.1888150039516137,4.173930808971528,0.3010757516708209,0.8188207085151681
7662,1741435998,1741439598,3600,0.11974276857876763,3.165599223196007,0.1,0.1
7663,1741439598,1741442625,3027,1.8266501397605652,4.52040354364999,0.8614444722958841,0.13419073846525792
7664,1741443198,1741445548,2350,2.4534306203751255,4.339957608955806,0.4995964748275895,0.19413973534997042
7665,1741446798,1741447180,382,0.6815375010137568,3.359447509129008,0.3745760181840916,0.950476252625217
7666,1741450398,1741453998,3600,0.13998187039123647,3.0345096431525915,0.1,0.1
7667,1741453998,1741457196,3198,2.4963761898862193,4.652310425296861,0.6461975349255182,0.6158725864205681
7668,1741457598,1741458892,1294,1.4007951423212568,4.19402627819177,0.4993138624747234,0.7452528833711594
7669,1741461198,1741464798,3600,0.37160219296964103,3.1930095038207074,0.1,0.1
7670,1741464798,1741466130,1332,1.3383776230311306,4.0469605391353936,0.7776678475234576,0.41005050328102877
7671,1741468398,1741471998,3600,0.21620629252168577,3.101948665131414,0.1,0.1
7672,1741471998,1741475598,3600,0.45083719152653656,3.0238470788979686,0.1,0.1
7673,1741475598,1741479198,3600,0.10436749847478222,3.134779891264278,0.1,0.1
7674,1741479198,1741481220,2022,1.7419368081902076,4.6601157772551005,0.5866720633954651,0.3249209135005734
7675,1741482798,1741483227,429,0.7454401024423192,3.6682349355233477,0.7214179941162774,0.21211093980166434
7676,1741486398,1741487490,1092,1.4139378805354408,3.9206227004411205,0.9172328526066597,0.25850328808900924
7677,1741489998,1741492660,2662,2.1151469508274037,4.663994546681342,0.8984585120488864,0.8389491716091927
7678,1741493598,1741496596,2998,1.9780029024416113,4.582903197911788,0.10033228849900266,0.7616282819174014
7679,1741497198,1741497414,216,0.5314792353638905,3.4472965307324794,0.8042209696810628,0.7369231730806114
7680,1741500798,1741504398,3600,0.3641698664217735,3.1420283211467304,0.1,0.1
7681,1741504398,1741507998,3600,0.34861261339316396,3.0284029241864885,0.1,0.1
7682,1741507998,1741511598,3600,0.12960660911347463,3.1179575100393233,0.1,0.1
7683,1741511598,1741514784,3186,2.436953292488738,4.5938101834018,0.7594861464223439,0.6131850865908673
7684,1741515198,1741518001,2803,1.7382187758330332,4.637134361402253,0.6257680650373104,0.23678850924619446
7685,1741518798,1741522398,3600,0.12484991292622163,3.085197933522437,0.1,0.1
7686,1741522398,1741525998,3600,0.405078182940675,3.0750033116261513,0.1,0.1
7687,1741525998,1741529598,3600,0.48301009128700945,3.192659401599503,0.1,0.1
7688,1741529598,1741530210,612,1.1845148073543281,4.1442718031368155,0.20978727689587073,0.6016479961134413
7689,1741533198,1741536798,3600,0.2427168306254588,3.0006650341537537,0.1,0.1
7690,1741536798,1741539216,2418,2.383481600480378,4.559092472232863,0.406717989729212,0.6095803091161456
7691,1741540398,1741540934,536,0.8441315979243489,3.467940654216931,0.9177596928892694,0.47830056992918935
7692,1741543998,1741547491,3493,2.3530722146184373,4.698041026308025,0.4125635281954473,0.41464885340200097
7693,1741547598,1741551198,3600,0.23044690642412885,3.064418188681999,0.1,0.1
7694,1741551198,1741551781,583,0.5432526699129725,3.403291592268643,0.6673355257714244,0.6533107450667409
7695,1741554798,1741556998,2200,2.0123505652888056,4.4904138938860365,0.8831049127051305,0.19949195858293284
7696,1741558398,1741560957,2559,1.675978756348318,4.549827367320518,0.8838092649292578,0.4417605730717671
7697,1741561998,1741563667,1669,1.3758815310379002,4.156194886198491,0.5405924207262415,0.4234025845695668
7698,1741565598,1741568079,2481,2.159806444924014,4.421540817496518,0.6645016581320842,0.9766639487814134
7699,1741569198,1741569501,303,0.7629691612842642,3.6103680388812567,0.3544920185942366,0.330207402974054
7700,1741572798,1741576398,3600,0.25600594244544894,3.1435090627875244,0.1,0.1
7701,1741576398,1741579998,3600,0.36185023696220786,3.171956765913363,0.1,0.1
7702,1741579998,1741583598,3600,0.2435834487178804,3.0959488281207133,0.1,0.1
7703,1741583598,1741586540,2942,1.6347912931126831,4.370442983118511,0.3237301276412131,0.9044479415938371
7704,1741587198,1741588721,1523,1.2038952384473474,3.920014974653622,0.7724114153779048,0.3468534545984342
7705,1741590798,1741594398,3600,0.19401525017075782,3.1495229970560685,0.1,0.1
7706,1741594398,1741594593,195,0.6252317491008432,3.6267170529001302,0.16180987597692495,0.9206440983471199
7707,1741597998,1741599603,1605,1.3288551665034196,3.840188400078641,0.5677688434957311,0.3513063702349388
7708,1741601598,1741605198,3600,0.29384158390509985,3.082538458532373,0.1,0.1
7709,1741605198,1741607318,2120,1.620744990163379,4.41117477165827,0.256250001208097,0.8250248045596198
7710,1741608798,1741611476,2678,1.567580424538019,4.380401496534692,0.510990420447209,0.19328099474792482
7711,1741612398,1741615998,3600,0.3529682918389768,3.108684652389007,0.1,0.1
7712,1741615998,1741618332,2334,2.258868721966064,4.325925561052012,0.4876891370280829,0.7544573560393681
7713,1741619598,1741620245,647,1.3185433037724659,3.9069991158186044,0.45791152884193953,0.2945468291212307
7714,1741623198,1741626798,3600,0.2569996747731399,3.0062722635768777,0.1,0.1
7715,1741626798,1741630398,3600,0.10844541407715767,3.0847808475413463,0.1,0.1
7716,1741630398,1741633998,3600,0.29226755983549657,3.163237938431705,0.1,0.1
7717,1741633998,1741637057,3059,2.3823864235178216,4.621682948772592,0.5766069163634441,0.9662317619902309
7718,1741637598,1741637791,193,0.9569190243885959,3.343801183504132,0.5212702976740183,0.8929006155931088
7719,1741641198,1741644058,2860,1.8609932403770704,4.322986308384928,0.9391662854582792,0.24692443964819316
7720,1741644798,1741645883,1085,1.4323153476490675,4.027000556534379,0.2844188071078213,0.5005555259897948
7721,1741648398,1741651486,3088,1.9445806536415984,4.392854743784476,0.6708444984197683,0.7768411539390454
7722,1741651998,1741655598,3600,0.24974960604665136,3.0928980775087753,0.1,0.1
7723,1741655598,1741659198,3600,0.2332182224120436,3.1106440643475537,0.1,0.1
7724,1741659198,1741662798,3600,0.1832128198893962,3.0844447173036285,0.1,0.1
7725,1741662798,1741663830,1032,1.3678747804837519,3.8606049982958233,0.6878473947421005,0.1361663333371854
7726,1741666398,1741669998,3600,0.21286733365623145,3.001389208230693,0.1,0.1
7727,1741669998,1741673598,3600,0.2520102687236841,3.0236570979530817,0.1,0.1
7728,1741673598,1741677198,3600,0.19350862126915747,3.108969366562609,0.1,0.1
7729,1741677198,1741678692,1494,1.2580408111421366,3.8949174348069224,0.9012349307313309,0.5835017975924957
7730,1741680798,1741684398,3600,0.2848542904405066,3.030858104448827,0.1,0.1
7731,1741684398,1741685238,840,1.3134253743628792,4.016459636706611,0.30558228790080566,0.22366526485208515
7732,1741687998,1741688372,374,0.9418313175650056,3.6511033748494484,0.22420724761530114,0.71949892790636
7733,1741691598,1741695198,3600,0.2153522672193503,3.1188292655404526,0.1,0.1
7734,1741695198,1741695587,389,0.6399937754268239,3.53840109120992,0.30110681227959685,0.688938320555451
7735,1741698798,1741699982,1184,1.1692883004666859,4.164347960111095,0.9971859470515042,0.5646331505783259
7736,1741702398,1741703278,880,1.0808820888757897,4.156505362028044,0.5513624383819614,0.1210756931633497
7737,1741705998,1741709598,3600,0.42153273260650426,3.1340010504138474,0.1,0.1
7738,1741709598,1741711894,2296,1.5745453661121616,4.4255905870661065,0.839840742174073,0.9737280312227826
7739,1741713198,1741716798,3600,0.14877849758803322,3.140127780195799,0.1,0.1
7740,1741716798,1741718620,1822,2.296979613769744,4.587502275824804,0.7982770910476749,0.6619657994030677
7741,1741720398,1741723998,3600,0.11825818897178215,3.028024566539562,0.1,0.1
7742,1741723998,1741725178,1180,1.1009621327392014,4.104639423879492,0.9858304847206362,0.917861855705163
7743,1741727598,1741727965,367,0.5113991408611932,3.5651496659180477,0.9794972562163299,0.4652821811181036
7744,1741731198,1741731643,445,0.6723214007012275,3.6389666247957964,0.3846148522482875,0.8454500222659344
7745,1741734798,1741738398,3600,0.41733581624904714,3.052912599425876,0.1,0.1
7746,1741738398,1741741574,3176,2.206998234514809,4.3260198552669475,0.923835682094506,0.13556019594182891
7747,1741741998,1741745598,3600,0.22864718971592157,3.0292210581596675,0.1,0.1
7748,1741745598,1741748033,2435,1.5994610710558832,4.567477133404572,0.687456090165631,0.96179198520414
7749,1741749198,1741752556,3358,1.7156695069624592,4.690680216297545,0.24427557139698577,0.15263179340952057
7750,1741752798,1741753516,718,1.2436129212926468,4.1295647106226605,0.32581423967217976,0.2415939388091102
7751,1741756398,1741759998,3600,0.2915296442734593,3.1205045084457006,0.1,0.1
7752,1741759998,1741762430,2432,2.2229736392136554,4.505047659164569,0.8416643561418751,0.7823013479881584
7753,1741763598,1741767198,3600,0.38245686310588745,3.0267977260867847,0.1,0.1
7754,1741767198,1741770798,3600,0.21941045010427498,3.0594945156851825,0.1,0.1
7755,1741770798,1741774398,3600,0.29155915859365833,3.0491813877567164,0.1,0.1
7756,1741774398,1741774679,281,0.5939126219882614,3.6340351329222282,0.9300466462604556,0.3078183262516381
7757,1741777998,1741781598,3600,0.19817094223307785,3.115113063252212,0.1,0.1
7758,1741781598,1741785198,3600,0.18412800380859098,3.10500039213938,0.1,0.1
7759,1741785198,1741788798,3600,0.41293763567635844,3.1724969911625167,0.1,0.1
7760,1741788798,1741789674,876,1.451326735093013,3.969372963008508,0.58962248425475,0.2962829013130525
7761,1741792398,1741794079,1681,1.2050292295010134,4.1679230392188344,0.11889393236921202,0.20060471568323057
7762,1741795998,1741799272,3274,2.207807803312042,4.687445301969219,0.12662711768507048,0.44661877105350956
7763,1741799598,1741801856,2258,1.7782916850392705,4.40132171915743,0.7360984329253107,0.3267621005429038
7764,1741803198,1741806798,3600,0.39098069603795016,3.0342792554641047,0.1,0.1
7765,1741806798,1741810398,3600,0.17089990158815638,3.065570816433001,0.1,0.1
7766,1741810398,1741813998,3600,0.4114979496953266,3.052577652867614,0.1,0.1
7767,1741813998,1741817598,3600,0.3045566072206014,3.0882708203653233,0.1,0.1
7768,1741817598,1741817912,314,0.752849853136581,3.656150620043218,0.47389157849792063,0.7883412788648099
7769,1741821198,1741824798,3600,0.3462348196625771,3.135457815958035,0.1,0.1
7770,1741824798,1741828398,3600,0.14284727890175541,3.1696078514551154,0.1,0.1
7771,1741828398,1741831998,3600,0.1971210447466276,3.1632991246082356,0.1,0.1
7772,1741831998,1741835598,3600,0.39050247572745866,3.106410761898711,0.1,0.1
7773,1741835598,1741836845,1247,1.004941226712716,4.153307975494889,0.33161023582810256,0.5442706627740509
7774,1741839198,1741841489,2291,2.2664167913425883,4.5653327191063005,0.9886008285322386,0.33458399068838507
7775,1741842798,1741846398,3600,0.489494648300275,3.0846825313246247,0.1,0.1
7776,1741846398,1741849998,3600,0.2560524362887805,3.0391533888034923,0.1,0.1
7777,1741849998,1741853598,3600,0.2038434904891036,3.1615343662008604,0.1,0.1
7778,1741853598,1741857198,3600,0.4472928382051312,3.0256922503643837,0.1,0.1
7779,1741857198,1741860798,3600,0.4539188824515825,3.0935754899667076,0.1,0.1
7780,1741860798,1741862079,1281,1.3765897262572615,4.166600768938085,0.4696517822311759,0.1282512153552015
7781,1741864398,1741867998,3600,0.13872228116387797,3.1007668981402667,0.1,0.1
7782,1741867998,1741871598,3600,0.3024789243522113,3.168249092730624,0.1,0.1
7783,1741871598,1741874649,3051,2.3533342233051973,4.640855594829409,0.7864116852907593,0.8853436919591188
7784,1741875198,1741875540,342,0.7623214518393973,3.688899410442407,0.13261698341674819,0.9125731627223455
7785,1741878798,1741882398,3600,0.3126247197968033,3.1712715985905566,0.1,0.1
7786,1741882398,1741883764,1366,1.2528848822714045,4.0615681671210435,0.7332767272527035,0.45750366056092917
7787,1741885998,1741889598,3600,0.4102718904384307,3.145625620371904,0.1,0.1
7788,1741889598,1741893198,3600,0.2991935808745505,3.139697690430102,0.1,0.1
7789,1741893198,1741894912,1714,1.2853161018423642,3.9963112446893727,0.4119615367001055,0.9025262127020157
7790,1741896798,1741900398,3600,0.32098487848890156,3.074890259825417,0.1,0.1
7791,1741900398,1741903998,3600,0.4341722387803041,3.030888166809681,0.1,0.1
7792,1741903998,1741905150,1152,1.462875197888589,3.9900204355014726,0.7722251377798995,0.6290640403891236
7793,1741907598,1741908929,1331,1.1919486671428043,3.8291797686585975,0.17545728294298119,0.19363743775482872
7794,1741911198,1741914798,3600,0.35969714891473126,3.01148483018427,0.1,0.1
7795,1741914798,1741916347,1549,1.3090743405294913,4.011830671343407,0.9946887905675155,0.6307681543756949
7796,1741918398,1741921998,3600,0.20332738058836425,3.1872636244906056,0.1,0.1
7797,1741921998,1741923687,1689,1.2407049909575383,4.01579770184782,0.17709510488271707,0.7049055819515547
7798,1741925598,1741928366,2768,1.6667141550995275,4.666469047651614,0.9710862111703046,0.8440132258850389
7799,1741929198,1741930378,1180,1.4676938491374287,4.176711176355843,0.3545941660472961,0.8330411644124528
7800,1741932798,1741934431,1633,1.333228952293616,4.09175731784391,0.836906688265273,0.33575719989137576
7801,1741936398,1741939998,3600,0.2194520158826804,3.04230949229051,0.1,0.1
7802,1741939998,1741943598,3600,0.4538769462990173,3.0434302163153584,0.1,0.1
7803,1741943598,1741945636,2038,2.453934278651499,4.651744489233563,0.2656893858678961,0.4878983717214985
7804,1741947198,1741950798,3600,0.3399491871191136,3.08023771206867,0.1,0.1
7805,1741950798,1741954398,3600,0.47871785774601827,3.019090148890345,0.1,0.1
7806,1741954398,1741957998,3600,0.23413555955393506,3.165352683571759,0.1,0.1
7807,1741957998,1741961598,3600,0.10087807381941044,3.1477766710024992,0.1,0.1
7808,1741961598,1741965198,3600,0.20316611369477472,3.117669518248013,0.1,0.1
7809,1741965198,1741966833,1635,1.2384803376724278,4.188969138720617,0.6821802298894094,0.1868299081228993
7810,1741968798,1741972398,3600,0.47683369959922395,3.0720943250114714,0.1,0.1
7811,1741972398,1741974930,2532,2.0947436417354233,4.596268909096881,0.696403496303674,0.3826732117752688
7812,1741975998,1741979598,3600,0.1542997569180954,3.027488724089266,0.1,0.1
7813,1741979598,1741982304,2706,1.6820555335033034,4.382944644320062,0.3792730637394156,0.5639635886103339
7814,1741983198,1741986798,3600,0.43989219297546733,3.068717843368938,0.1,0.1
7815,1741986798,1741986964,166,0.9442827063425859,3.32387486868757,0.9659226893168842,0.4993164967161724
7816,1741990398,1741990874,476,0.5342397384634368,3.5615363857065505,0.2356842376982473,0.12684076297339456
7817,1741993998,1741995735,1737,1.2152156752136218,4.127824555824428,0.8138768361848276,0.5352545987585954
7818,1741997598,1742001161,3563,2.167787439003533,4.398099721817367,0.5230863944076473,0.6934949977447019
7819,1742001198,1742004376,3178,2.1088871428822875,4.656798130860816,0.33788118057845345,0.28929935397792883
7820,1742004798,1742008398,3600,0.35049754786465526,3.1163287085542315,0.1,0.1
7821,1742008398,1742011998,3600,0.3952226523878173,3.1703163365933977,0.1,0.1
7822,1742011998,1742014104,2106,1.51010435424629,4.487657006166732,0.5240087606755578,0.1476809654410891
7823,1742015598,1742019198,3600,0.39845630393672093,3.148788701373954,0.1,0.1
7824,1742019198,1742019362,164,0.8920683863291816,3.365337713759919,0.44949118586791115,0.1662347161273235
7825,1742022798,1742023943,1145,1.2371300387567392,3.8947138450973444,0.5724664024763668,0.4287041652954835
7826,1742026398,1742029998,3600,0.12781851948459858,3.016812744779108,0.1,0.1
7827,1742029998,1742033598,3600,0.2174188184363698,3.072089440378684,0.1,0.1
7828,1742033598,1742037198,3600,0.4747946520962112,3.1888812212965436,0.1,0.1
7829,1742037198,1742039351,2153,2.4956249879090127,4.539568507354716,0.5127438631630499,0.7648733769744007
7830,1742040798,1742042790,1992,2.2300711951755305,4.46325817288578,0.3285778571134528,0.7166024413148406
7831,1742044398,1742047998,3600,0.167611631018956,3.1925075672432017,0.1,0.1
7832,1742047998,1742051266,3268,1.5263745532338917,4.676075198848076,0.3309878720756839,0.623748232092026
7833,1742051598,1742053971,2373,1.9816395061774204,4.327822192007801,0.8868853647244478,0.8006373656089776
7834,1742055198,1742058755,3557,1.7637727318562104,4.426807980246423,0.9381466537593123,0.8509889872602997
7835,1742058798,1742061667,2869,2.454103454507316,4.404773669006434,0.17570344552338413,0.6774997926779144
7836,1742062398,1742064789,2391,2.3205855679649336,4.317118867057161,0.7412247911462098,0.6953777734736224
7837,1742065998,1742068446,2448,1.9643972487954617,4.48860784028759,0.579912082866102,0.9334368412299714
7838,1742069598,1742070643,1045,1.0661058426213685,4.018649252835139,0.4422506846455343,0.1572543028044679
7839,1742073198,1742076798,3600,0.3973090918272002,3.1907663538636744,0.1,0.1
7840,1742076798,1742078749,1951,1.5100986925975752,4.304778180473474,0.934499387693663,0.3111241813260801
7841,1742080398,1742082754,2356,2.1064220197672157,4.685191948164754,0.7421769167117354,0.20502786970262182
7842,1742083998,1742084300,302,0.9193353134298541,3.413027173191922,0.5751989178265848,0.3384312123893671
7843,1742087598,1742090668,3070,2.0861966936029672,4.4364518593849755,0.8725082597592857,0.9674342131435
7844,1742091198,1742094798,3600,0.2906337133601008,3.1327659651382764,0.1,0.1
7845,1742094798,1742095724,926,1.3890714973660003,3.8013646875477813,0.5135199859649929,0.7839269302942891
7846,1742098398,1742101998,3600,0.18964468667173606,3.105426105213649,0.1,0.1
7847,1742101998,1742105598,3600,0.2032022850765261,3.1687917683706575,0.1,0.1
7848,1742105598,1742108739,3141,2.0218107220492563,4.36500018049745,0.5042951043137229,0.914347613788092
7849,1742109198,1742112753,3555,2.361887707785841,4.389897930982371,0.6786643236518669,0.5869048452116968
7850,1742112798,1742116398,3600,0.3648018883673996,3.0154901278096227,0.1,0.1
7851,1742116398,1742117336,938,1.3927918960161114,4.004629858773098,0.6475850358836448,0.6942138975431469
7852,1742119998,1742123598,3600,0.45046070425097273,3.045222143803748,0.1,0.1
7853,1742123598,1742125171,1573,1.4593879003673984,4.152176626881388,0.7513404522931811,0.1868783029085171
7854,1742127198,1742129489,2291,2.0347371090199777,4.433495751880139,0.7676946988628078,0.49314267932345157
7855,1742130798,1742133002,2204,2.3100929228254143,4.548994818195229,0.4208770244501693,0.5161342516514288
7856,1742134398,1742137998,3600,0.31562334710110085,3.054922191023883,0.1,0.1
7857,1742137998,1742140508,2510,2.121602900916074,4.589338745724996,0.5091940891659326,0.6444859471966827
7858,1742141598,1742145198,3600,0.3520081162423181,3.1951439041279968,0.1,0.1
7859,1742145198,1742148798,3600,0.2625236202109512,3.076015370020343,0.1,0.1
7860,1742148798,1742149149,351,0.6534448910922452,3.345357601406277,0.19071889074174314,0.4664795141431469
7861,1742152398,1742154163,1765,1.3676859904380303,4.117377019438144,0.11198908718997355,0.41423061309509723
7862,1742155998,1742159598,3600,0.4638469360751317,3.160555513471336,0.1,0.1
7863,1742159598,1742162473,2875,2.075320672876393,4.409338581753685,0.9790623752317914,0.5016426350282148
7864,1742163198,1742165372,2174,2.205984001510431,4.363009969445878,0.7118824948463228,0.640255586902389
7865,1742166798,1742170398,3600,0.47030641378304827,3.039751630023957,0.1,0.1
7866,1742170398,1742171210,812,1.0595680557405496,3.9483270590421142,0.3859579652815601,0.25361501907888445
7867,1742173998,1742177598,3600,0.4048011829745233,3.149118932813241,0.1,0.1
7868,1742177598,1742181198,3600,0.24233283759942328,3.1739949216711394,0.1,0.1
7869,1742181198,1742181634,436,0.6072929735972308,3.696114063539208,0.5715138128728744,0.3635681990004077
7870,1742184798,1742188398,3600,0.4052192333437872,3.02108059925694,0.1,0.1
7871,1742188398,1742189984,1586,1.160284201568853,4.191510445895476,0.173273368640543,0.24270302850884623
7872,1742191998,1742194409,2411,1.9654758298819206,4.30419992032463,0.16315828606914645,0.3797875705347963
7873,1742195598,1742197680,2082,2.2758851798792183,4.557781014141284,0.6668533485874653,0.5832758214265911
7874,1742199198,1742202709,3511,1.5953754563881415,4.554792017207734,0.13743043468355726,0.23447314835637836
7875,1742202798,1742204179,1381,1.1642787917764594,4.137300722502381,0.21940404503994285,0.6825180224291639
7876,1742206398,1742208210,1812,1.9112508452029917,4.529019401618042,0.9509263499655295,0.7020748572073804
7877,1742209998,1742213598,3600,0.18108807545818287,3.025462065901929,0.1,0.1
7878,1742213598,1742217198,3600,0.37351897505007947,3.0858740212787916,0.1,0.1
7879,1742217198,1742220798,3600,0.2513764650657523,3.1598514074431603,0.1,0.1
7880,1742220798,1742223086,2288,1.7788304739404013,4.346887890392544,0.8364381826751435,0.1641943543193049
7881,1742224398,1742227998,3600,0.18758834967948756,3.1922048089707102,0.1,0.1
7882,1742227998,1742229784,1786,1.2471955780111996,4.145013944251901,0.41903686086067515,0.11395972333998713
7883,1742231598,1742234946,3348,1.6137379694017153,4.602736888752083,0.7315122277963878,0.8952391585303682
7884,1742235198,1742238798,3600,0.3304122906609681,3.0002043712087896,0.1,0.1
7885,1742238798,1742242398,3600,0.38404278591731456,3.063052295289177,0.1,0.1
7886,1742242398,1742245998,3600,0.46766289512142434,3.1054409100171005,0.1,0.1
7887,1742245998,1742249598,3600,0.36006031591993193,3.1770304949513637,0.1,0.1
7888,1742249598,1742252070,2472,1.6707964650917546,4.420890032312133,0.56548494985963,0.8219328322269602
7889,1742253198,1742256798,3600,0.22011809229773147,3.0408375995548567,0.1,0.1
7890,1742256798,1742259419,2621,2.4189842262678685,4.514505313679359,0.8258810167476329,0.6286091361767115
7891,1742260398,1742263998,3600,0.22058856569818852,3.0164373795998247,0.1,0.1
7892,1742263998,1742267598,3600,0.40039544667214644,3.1929745494573623,0.1,0.1
7893,1742267598,1742271198,3600,0.3837296647312345,3.11691099559644,0.1,0.1
7894,1742271198,1742272062,864,1.2111517909651472,4.10266418176537,0.45195534826979544,0.9447672069521234
7895,1742274798,1742277161,2363,2.399684081194571,4.465323535573073,0.563924726225657,0.3236422779517707
7896,1742278398,1742280485,2087,2.209715602025098,4.344386832613345,0.5880106845483262,0.4812623632786628
7897,1742281998,1742283467,1469,1.3919102546161854,3.9672866288862494,0.12019733246204023,0.532166977526842
7898,1742285598,1742286182,584,0.5616467538369889,3.4077275246077834,0.3179115362344014,0.6117579768585776
7899,1742289198,1742291287,2089,2.037182006360029,4.3225777310130535,0.9544766420943948,0.6988223598904376
7900,1742292798,1742294071,1273,1.268152078766154,4.083248946767139,0.6771215486576753,0.5609945781011942
7901,1742296398,1742299998,3600,0.3623507742516787,3.0741265124295296,0.1,0.1
7902,1742299998,1742301242,1244,1.0446144731778866,3.875962253857425,0.6282897460632579,0.6618281163401076
7903,1742303598,1742307198,3600,0.23166632405268409,3.1235866524975844,0.1,0.1
7904,1742307198,1742308056,858,1.2795190343931826,3.8488945851431327,0.8792356769249301,0.18962746419676269
7905,1742310798,1742314398,3600,0.1728860194273384,3.018532134412653,0.1,0.1
7906,1742314398,1742316490,2092,2.1449294382077113,4.466608811603597,0.5398578154907878,0.6457487094491481
7907,1742317998,1742321598,3600,0.29296387618596254,3.186713723363906,0.1,0.1
7908,1742321598,1742323986,2388,2.209420537593634,4.402119123735931,0.6223780113074631,0.35028674035839713
7909,1742325198,1742327852,2654,1.7786073900003192,4.62642249594906,0.3994404373916818,0.5409272118005445
7910,1742328798,1742331651,2853,1.8115778031393073,4.615214144091122,0.8926186965668885,0.9238716367379974
7911,1742332398,1742335998,3600,0.3410386170546094,3.0187993986184787,0.1,0.1
7912,1742335998,1742339105,3107,1.956666233274944,4.662504915082262,0.7002955141207055,0.14252159189384764
7913,1742339598,1742341808,2210,1.893396049864144,4.56304963782504,0.17043840994463488,0.8132219564538847
7914,1742343198,1742343580,382,0.5021740261976809,3.501271033171096,0.48290351653192265,0.302866619733111
7915,1742346798,1742350398,3600,0.26661603436086523,3.0960157394011016,0.1,0.1
7916,1742350398,1742353998,3600,0.25520320198487434,3.1891571594981545,0.1,0.1
7917,1742353998,1742354095,97,0.7354827481718311,3.5782766303629034,0.19300164910521445,0.882097050233331
7918,1742357598,1742361198,3600,0.27815074873374945,3.1151337637368264,0.1,0.1
7919,1742361198,1742363192,1994,2.104489814303836,4.3050779699088215,0.5957459062917455,0.8014420533851423
7920,1742364798,1742366113,1315,1.4615370654592246,4.149409276853522,0.7855200068611649,0.37810442052704696
7921,1742368398,1742371998,3600,0.38694485889334795,3.0260329574559295,0.1,0.1
7922,1742371998,1742372930,932,1.404894547447446,4.055221792983991,0.5916365572751422,0.9216061241871896
7923,1742375598,1742377648,2050,1.833788732609593,4.500189778130089,0.4796571056944847,0.2665521211237814
7924,1742379198,1742381236,2038,2.1500883641364696,4.668080063053226,0.9912798805761946,0.7026331554984866
7925,1742382798,1742386398,3600,0.2718789579572968,3.064173619266778,0.1,0.1
7926,1742386398,1742389998,3600,0.4460491209190586,3.1869944643108563,0.1,0.1
7927,1742389998,1742393598,3600,0.3161131911002044,3.173402572209816,0.1,0.1
7928,1742393598,1742394975,1377,1.480988254640319,3.841911923037613,0.6597621307077773,0.809610807059306
7929,1742397198,1742398839,1641,1.3060205144806294,3.9497663690760745,0.815801383152873,0.468176828365124
7930,1742400798,1742402647,1849,2.117543191935128,4.599753469179831,0.9600155471224431,0.3407081978929656
7931,1742404398,1742406729,2331,2.102817385518411,4.637730112630576,0.6728088058359646,0.14861228575123842
7932,1742407998,1742411598,3600,0.2302951765544935,3.084516304105757,0.1,0.1
7933,1742411598,1742413579,1981,1.7682907699809687,4.627275165772278,0.6960962100583324,0.6422784283280147
7934,1742415198,1742418798,3600,0.38611117884136625,3.0409530672053813,0.1,0.1
7935,1742418798,1742422398,3600,0.35149232734584923,3.0523820455500896,0.1,0.1
7936,1742422398,1742425530,3132,1.7374341931240638,4.362852178983541,0.9608419341912778,0.1380281263523754
7937,1742425998,1742429598,3600,0.3566242511335912,3.042312660291776,0.1,0.1
7938,1742429598,1742433198,3600,0.4333016890781495,3.0261756404516538,0.1,0.1
7939,1742433198,1742436798,3600,0.22236735284620457,3.1463029664171733,0.1,0.1
7940,1742436798,1742439248,2450,2.131465264826434,4.698797115377031,0.7663014131861826,0.428623049661382
7941,1742440398,1742443998,3600,0.4615478943294007,3.130120167525076,0.1,0.1
7942,1742443998,1742447598,3600,0.3030520007907145,3.128704071239169,0.1,0.1
7943,1742447598,1742451198,3600,0.2862667677627606,3.0371984917511443,0.1,0.1
7944,1742451198,1742451348,150,0.6869057626354316,3.6234329350590104,0.6818124981671344,0.6196152053773348
7945,1742454798,1742455886,1088,1.1958385885697036,4.119131100899648,0.2678296303470503,0.5113038468899767
7946,1742458398,1742460431,2033,2.082995685445426,4.5779603041854084,0.16109464987382063,0.43081125933529885
7947,1742461998,1742465598,3600,0.4483599562533498,3.039433796636994,0.1,0.1
7948,1742465598,1742469198,3600,0.2871408901143301,3.0594914700373805,0.1,0.1
7949,1742469198,1742472798,3600,0.30599804951736986,3.1455523083185897,0.1,0.1
7950,1742472798,1742475432,2634,2.1136894956899783,4.543128709821608,0.20813206104394155,0.7143911846686476
7951,1742476398,1742478998,2600,2.3589740705118327,4.4212425310190895,0.3495108363873202,0.9456333000280854
7952,1742479998,1742480605,607,1.1578066726495906,3.8416212629446695,0.4975127319001056,0.34426504192591567
7953,1742483598,1742484085,487,0.8458973336971822,3.308060899478674,0.8849578416362335,0.5871169521337443
7954,1742487198,1742489462,2264,2.3497665571779804,4.681025456402207,0.6599817038824433,0.6611352415434961
7955,1742490798,1742491929,1131,1.0885714186571867,4.125337295634653,0.7055891555096765,0.8803351838108436
7956,1742494398,1742497998,3600,0.331182886917047,3.0074607181602895,0.1,0.1
7957,1742497998,1742498894,896,1.3337842267165534,4.089894165425454,0.4787588164334907,0.9646203104351627
7958,1742501598,1742505198,3600,0.20223540624109237,3.1045353053884375,0.1,0.1
7959,1742505198,1742507828,2630,1.8535169634313342,4.653184936199393,0.6893031901885552,0.7175490154475213
7960,1742508798,1742510918,2120,2.3982946531653715,4.654375564576882,0.3922765512097608,0.7487635754992719
7961,1742512398,1742515998,3600,0.2734909968134561,3.0534881722790157,0.1,0.1
7962,1742515998,1742519598,3600,0.16182994416809288,3.072569303982591,0.1,0.1
7963,1742519598,1742522515,2917,2.0762125146970316,4.557112013603289,0.6762380617222593,0.5731126890039986
7964,1742523198,1742525030,1832,1.8442953859223457,4.589728522109934,0.21168449119312244,0.3301788584568094
7965,1742526798,1742530398,3600,0.19331588889225848,3.1421935239165095,0.1,0.1
7966,1742530398,1742533998,3600,0.4077205031248954,3.156547329625724,0.1,0.1
7967,1742533998,1742534434,436,0.9240320539077314,3.5357449661238083,0.1725728713157207,0.9940785021563416
7968,1742537598,1742538108,510,0.8720520917470418,3.357087902904771,0.5588954796089125,0.9412911789699595
7969,1742541198,1742544018,2820,1.6046137142282224,4.650737401717494,0.3896258569854981,0.1504865449893186
7970,1742544798,1742547611,2813,1.9392618745661734,4.351468125250007,0.9899113612500042,0.7304735635604427
7971,1742548398,1742550892,2494,2.068550183588777,4.4663355123336475,0.3879603600896413,0.9879394076347605
7972,1742551998,1742555483,3485,2.389414785305262,4.6171841296177725,0.22421777833422019,0.2547929177495178
7973,1742555598,1742557652,2054,2.2119651627718593,4.51934675837585,0.4069232226481012,0.9716625122222311
7974,1742559198,1742562798,3600,0.1883056314353624,3.049497064251156,0.1,0.1
7975,1742562798,1742566398,3600,0.3941118099670994,3.188277283953269,0.1,0.1
7976,1742566398,1742569998,3600,0.20950801255453755,3.18393625153067,0.1,0.1
7977,1742569998,1742571082,1084,1.3935085097074567,4.042740092152,0.20203264126937948,0.8185904753544458
7978,1742573598,1742576911,3313,2.43140251067394,4.374110480359253,0.35285797238124383,0.23773295488294546
7979,1742577198,1742578518,1320,1.025259156427848,3.9182537121699412,0.6436954403275522,0.7367233838110679
7980,1742580798,1742584398,3600,0.4591398408009465,3.1148394165910136,0.1,0.1
7981,1742584398,1742585971,1573,1.2704968889908703,3.975970591724521,0.811033472698802,0.7874262266989976
7982,1742587998,1742590463,2465,2.1697830687507116,4.550579446125145,0.40274481109439175,0.22068518669519438
7983,1742591598,1742592086,488,0.6457237490732592,3.567416990360729,0.7049278599813967,0.9196546522341165
7984,1742595198,1742598798,3600,0.32380589060635045,3.00216717430048,0.1,0.1
7985,1742598798,1742599700,902,1.2292905568697232,4.197682891117455,0.9950245439167436,0.5191975756964963
7986,1742602398,1742605523,3125,2.1593338078742863,4.5693406372500185,0.6303377954927746,0.7144531818110403
7987,1742605998,1742608799,2801,2.4507744970607916,4.343719679527117,0.3874107383486324,0.9764984393499618
7988,1742609598,1742610418,820,1.2588886284442498,4.05838423570003,0.9349289530263879,0.30425798944461335
7989,1742613198,1742614445,1247,1.099729079208353,4.04907782425217,0.3067847832417584,0.13396345174290766
7990,1742616798,1742620398,3600,0.4367563176007184,3.148980798343864,0.1,0.1
7991,1742620398,1742623428,3030,1.7965972823499088,4.464036250769511,0.9449042970660892,0.7334234963450712
7992,1742623998,1742627598,3600,0.3200715120732822,3.1710728450355434,0.1,0.1
7993,1742627598,1742628917,1319,1.29811194294303,3.8852352653203748,0.6633730933785834,0.6715640086702694
7994,1742631198,1742634798,3600,0.15475454252774845,3.1721003505712893,0.1,0.1
7995,1742634798,1742637554,2756,1.5469953845025826,4.356751296753939,0.34704589037152517,0.16887247446254422
7996,1742638398,1742639677,1279,1.350031089840444,3.8773548869766548,0.6996081882864175,0.4634231865558466
7997,1742641998,1742645598,3600,0.45607541506654203,3.191352072912448,0.1,0.1
7998,1742645598,1742646802,1204,1.0758013393629087,3.9580967653748824,0.3055898780605597,0.3917685159976664
7999,1742649198,1742652497,3299,2.2495234486603923,4.4878470826707115,0.3542053498511025,0.9349333424934442
8000,1742652798,1742654139,1341,1.2463793183255953,3.8284624241413017,0.1465763770871377,0.21709151259889853
8001,1742656398,1742659998,3600,0.4841538686693111,3.0898816147466177,0.1,0.1
8002,1742659998,1742663219,3221,2.183134799488262,4.627454943526005,0.1569604116467928,0.904527297641788
8003,1742663598,1742667198,3600,0.13615506269792566,3.05003405256404,0.1,0.1
8004,1742667198,1742668419,1221,1.416101556718257,4.186721071713771,0.5609909820067691,0.15096195901503243
8005,1742670798,1742674398,3600,0.42473806069835074,3.0623743516306177,0.1,0.1
8006,1742674398,1742677998,3600,0.2394362750261843,3.1628854371807846,0.1,0.1
8007,1742677998,1742679953,1955,2.4858642839397116,4.334450168549853,0.9848742022624332,0.4277078261289031
8008,1742681598,1742681784,186,0.8518117839656538,3.3115048340585838,0.36331350307605204,0.9371140184734881
8009,1742685198,1742688798,3600,0.2767473362538748,3.120206473534959,0.1,0.1
8010,1742688798,1742692398,3600,0.2715224890202498,3.1193048342660132,0.1,0.1
8011,1742692398,1742695998,3600,0.20697744495797932,3.0883706168783847,0.1,0.1
8012,1742695998,1742697173,1175,1.1398496941822815,4.155681536634939,0.8893066496635845,0.3996082191695026
8013,1742699598,1742703198,3600,0.2698693231680154,3.091456958315135,0.1,0.1
8014,1742703198,1742705753,2555,1.8979158193010992,4.6379588829190315,0.5068853240030657,0.5413457832211588
8015,1742706798,1742710398,3600,0.4041157865140371,3.064867926519607,0.1,0.1
8016,1742710398,1742710894,496,0.8670238389132641,3.646543120803685,0.46623900220776904,0.7960070869262402
8017,1742713998,1742714876,878,1.213580076377611,3.856811740856544,0.515047610418687,0.8144402712008516
8018,1742717598,1742718560,962,1.122732509118609,4.194756722406962,0.8300661249165422,0.9365901364961827
8019,1742721198,1742724798,3600,0.3538440902529151,3.139640265587115,0.1,0.1
8020,1742724798,1742727905,3107,1.8767722573049888,4.416819507001607,0.36064447772362196,0.86303211610711
8021,1742728398,1742731315,2917,1.5515538660791242,4.556246034354032,0.47205730662766976,0.2779226094937575
8022,1742731998,1742733885,1887,2.4734773482128705,4.454149393040787,0.5565391485899553,0.10730646196650245
8023,1742735598,1742739192,3594,1.5365764776092985,4.546085501966848,0.12604188539559769,0.9047569958028827
8024,1742739198,1742742765,3567,1.6294764585246355,4.4665634894728985,0.8658951672951931,0.8871297907015621
8025,1742742798,1742746398,3600,0.14271080611323522,3.0320412609825973,0.1,0.1
8026,1742746398,1742749714,3316,1.5675923242242042,4.308552972352614,0.9490774766476463,0.7527600298148164
8027,1742749998,1742753598,3600,0.3508042193532219,3.095219340755259,0.1,0.1
8028,1742753598,1742757198,3600,0.2818356332697708,3.033213173211624,0.1,0.1
8029,1742757198,1742758082,884,1.169643238948212,3.918380726942171,0.3403665261389811,0.5599691604925281
8030,1742760798,1742764398,3600,0.23691192770047637,3.1563224601629836,0.1,0.1
8031,1742764398,1742767006,2608,1.5782236051330076,4.400879677961958,0.5721230493664528,0.7866313775914644
8032,1742767998,1742771598,3600,0.10344019496882711,3.0833921913127402,0.1,0.1
8033,1742771598,1742775198,3600,0.20893439422191934,3.067818207215466,0.1,0.1
8034,1742775198,1742778798,3600,0.37612795074856953,3.070443364968988,0.1,0.1
8035,1742778798,1742782203,3405,1.695175917501866,4.498199491538156,0.536926476571521,0.6621804413788115
8036,1742782398,1742785998,3600,0.3645326523775708,3.18307043802037,0.1,0.1
8037,1742785998,1742786810,812,1.3349811812747328,3.8873869446744607,0.6288573726523528,0.6773205389134784
8038,1742789598,1742793043,3445,1.734010195925487,4.476496304944302,0.3303819057495181,0.37034278318844005
8039,1742793198,1742796019,2821,1.663932112140152,4.630342673718004,0.19979892011172362,0.43549437601469543
8040,1742796798,1742797566,768,1.320403848078465,4.110803492487298,0.9056449838572069,0.5354027314600862
8041,1742800398,1742803998,3600,0.42652326517042094,3.136710146101404,0.1,0.1
8042,1742803998,1742807598,3600,0.3416946552745418,3.0958256848276244,0.1,0.1
8043,1742807598,1742808707,1109,1.177534711648229,4.102196017597984,0.3293792881536465,0.39778539099564725
8044,1742811198,1742814798,3600,0.10072302690415116,3.1653481289615457,0.1,0.1
8045,1742814798,1742818007,3209,1.6387669886230705,4.642089571725023,0.39373410786754515,0.19669232639225287
8046,1742818398,1742821362,2964,1.9235164665149516,4.49085277333028,0.497597219339622,0.75503764199021
8047,1742821998,1742825372,3374,2.153794424182431,4.371908577517618,0.8862487868583392,0.22870205891795464
8048,1742825598,1742829198,3600,0.2944357628701175,3.1106955234163167,0.1,0.1
8049,1742829198,1742832798,3600,0.2805983066336032,3.056998468322076,0.1,0.1
8050,1742832798,1742836398,3600,0.1932507369522004,3.175097631865696,0.1,0.1
8051,1742836398,1742839998,3600,0.13050992833604488,3.098616878549192,0.1,0.1
8052,1742839998,1742843598,3600,0.10395349387785235,3.0803457007679205,0.1,0.1
8053,1742843598,1742844936,1338,1.0638930383319596,4.075880010578725,0.5679818442225617,0.9217612663675162
8054,1742847198,1742850798,3600,0.4678761726557309,3.1925507012372325,0.1,0.1
8055,1742850798,1742851095,297,0.67352079728623,3.448559104583366,0.30130611050991085,0.3805311098651293
8056,1742854398,1742857998,3600,0.204563950312844,3.0363218875385583,0.1,0.1
8057,1742857998,1742861598,3600,0.3091162710160009,3.1593088351466636,0.1,0.1
8058,1742861598,1742865198,3600,0.13243476596547615,3.1009561569525323,0.1,0.1
8059,1742865198,1742868577,3379,2.342425646102906,4.543926302422196,0.9905295606533621,0.5171354174282176
8060,1742868798,1742872398,3600,0.44810333064940355,3.0607727801837705,0.1,0.1
8061,1742872398,1742875544,3146,1.8477969383070851,4.5327294614676585,0.6246395183399777,0.7146950766677197
8062,1742875998,1742876606,608,1.400495492510467,4.135560881637603,0.4189343633840512,0.17246862051630718
8063,1742879598,1742881185,1587,1.449604091968343,3.962973447710481,0.7097436617971558,0.8525194037674407
8064,1742883198,1742886798,3600,0.3310094519835398,3.1846726379729917,0.1,0.1
8065,1742886798,1742890398,3600,0.32907028058384424,3.145663397841664,0.1,0.1
8066,1742890398,1742890779,381,0.770108139513162,3.684335523801738,0.4510923178580435,0.5784192193282686
8067,1742893998,1742897598,3600,0.47419930525801723,3.027812562227249,0.1,0.1
8068,1742897598,1742901198,3600,0.28619326953826785,3.1161325010986696,0.1,0.1
8069,1742901198,1742903362,2164,1.9573329393304069,4.317832119355569,0.8683126905155572,0.3229106426582818
8070,1742904798,1742908398,3600,0.15706153883886423,3.1310534775264225,0.1,0.1
8071,1742908398,1742909960,1562,1.0150860963266952,4.102995182317069,0.38666467007849603,0.8228442118556701
8072,1742911998,1742915598,3600,0.18288484532242133,3.1167096286427727,0.1,0.1
8073,1742915598,1742917067,1469,1.1860059360178492,3.9405880389686496,0.6024259560081907,0.7485113581156639
8074,1742919198,1742921549,2351,1.694610043877368,4.579135988475727,0.5334760464892095,0.4564203197024256
8075,1742922798,1742925864,3066,2.4622993019621595,4.432366216214751,0.6305194556959881,0.6224690311411123
8076,1742926398,1742927778,1380,1.3536226432679257,3.825420476801351,0.35906301366791527,0.24868995541142155
8077,1742929998,1742933598,3600,0.48902827908809565,3.117371150417678,0.1,0.1
8078,1742933598,1742937198,3600,0.10642903876288559,3.154209892755591,0.1,0.1
8079,1742937198,1742940422,3224,1.5739898646918982,4.340495208939867,0.1202810889271725,0.8766404576398666
8080,1742940798,1742942177,1379,1.26939429241974,4.191782024463729,0.24527024554267407,0.49361693928344685
8081,1742944398,1742947998,3600,0.33915465810929796,3.06638440488787,0.1,0.1
8082,1742947998,1742951504,3506,1.9333987157399548,4.568633107150033,0.10697408995112888,0.6913592463439713
8083,1742951598,1742955068,3470,1.8210832774779577,4.415545859336915,0.5907678401945845,0.5833560787243648
8084,1742955198,1742958798,3600,0.2583326572281056,3.026593221773075,0.1,0.1
8085,1742958798,1742961745,2947,2.2684355870508335,4.494337620157226,0.35186526537532004,0.9487890639638028
8086,1742962398,1742965998,3600,0.17842368236137185,3.012214082540157,0.1,0.1
8087,1742965998,1742969598,3600,0.4506130613361735,3.015249419413057,0.1,0.1
8088,1742969598,1742973198,3600,0.18460575650301525,3.0702864523457523,0.1,0.1
8089,1742973198,1742973531,333,0.730475472966398,3.323003422933675,0.44763146620518923,0.1264847282999367
8090,1742976798,1742980398,3600,0.4981721850376246,3.162857160077286,0.1,0.1
8091,1742980398,1742983315,2917,1.70352365257641,4.393386671196517,0.8682626264531565,0.9396541446314988
8092,1742983998,1742986284,2286,1.6911572155996604,4.699478836649332,0.336458428599654,0.505698144222322
8093,1742987598,1742991198,3600,0.15644330512471227,3.0336698653484424,0.1,0.1
8094,1742991198,1742992669,1471,1.1445163297448946,4.125432423937043,0.5344517069483502,0.20204699547316957
8095,1742994798,1742998398,3600,0.20485715482725284,3.172897003175377,0.1,0.1
8096,1742998398,1743001998,3600,0.3857384541835579,3.1259060725827275,0.1,0.1
8097,1743001998,1743005598,3600,0.36666826755676407,3.070043755657882,0.1,0.1
8098,1743005598,1743007315,1717,1.009168439764718,4.010631896739956,0.2118222098892898,0.15932396586297645
8099,1743009198,1743012034,2836,2.13769327791796,4.353922891194399,0.10475269235017805,0.6547170850383006
8100,1743012798,1743016398,3600,0.33227156224663656,3.0746893229993906,0.1,0.1
8101,1743016398,1743018256,1858,1.68756391363288,4.551158183929858,0.9771427993826108,0.44940750203507607
8102,1743019998,1743023598,3600,0.1326261826007,3.100964232325022,0.1,0.1
8103,1743023598,1743027198,3600,0.38774423233311706,3.0188525498590164,0.1,0.1
8104,1743027198,1743030391,3193,1.6776401787726631,4.466456982491224,0.8314879424019763,0.6148018565396706
8105,1743030798,1743034127,3329,2.3056180628296885,4.554984124088978,0.4073102657155738,0.5462723133934418
8106,1743034398,1743037676,3278,1.8889987018142693,4.6916009965609735,0.8627243448636353,0.5375114172612158
8107,1743037998,1743040433,2435,1.9584111794300065,4.437536202499798,0.5284380782669418,0.8296301463072843
8108,1743041598,1743044703,3105,2.226442919946583,4.5166207148328565,0.3103359836050354,0.27085708361340566
8109,1743045198,1743046907,1709,1.4685094243226584,4.059252699095061,0.39450686177077365,0.7105455521456479
8110,1743048798,1743052398,3600,0.23711748140123046,3.138965039276343,0.1,0.1
8111,1743052398,1743055998,3600,0.24836604061186796,3.132134381450476,0.1,0.1
8112,1743055998,1743059598,3600,0.3244009977176805,3.1916342082609743,0.1,0.1
8113,1743059598,1743060856,1258,1.2802220712612304,3.986469435987512,0.1987984901808595,0.5734172347448346
8114,1743063198,1743066798,3600,0.19949063590696256,3.156502735934088,0.1,0.1
8115,1743066798,1743067987,1189,1.420057901733839,3.9205155584538938,0.12878589907801039,0.899196657833281
8116,1743070398,1743073998,3600,0.35955387213442647,3.0453007305969573,0.1,0.1
8117,1743073998,1743075491,1493,1.0073194027159051,4.142491500280545,0.7237684196235818,0.2504126176144337
8118,1743077598,1743081166,3568,2.240742733465095,4.680518102670549,0.46127780689934716,0.512714422388249
8119,1743081198,1743084798,3600,0.3513995106987786,3.1831400646703867,0.1,0.1
8120,1743084798,1743088331,3533,1.7795697389340233,4.560385745611267,0.5209971722056518,0.7087613694426962
8121,1743088398,1743091998,3600,0.3368111082232764,3.14168214518033,0.1,0.1
8122,1743091998,1743093330,1332,1.0756846120713868,3.8995729501035123,0.8989144469764446,0.8375789920520913
8123,1743095598,1743099198,3600,0.2935179030537691,3.03602888081976,0.1,0.1
8124,1743099198,1743100161,963,1.431846616568799,3.9278801219410022,0.12306771741427733,0.563600244728339
8125,1743102798,1743106398,3600,0.36259517485640436,3.046774850851496,0.1,0.1
8126,1743106398,1743108329,1931,2.410178238281677,4.533032758167253,0.8373085080395484,0.7582297313202171
8127,1743109998,1743113598,3600,0.2558109555477648,3.149705959927584,0.1,0.1
8128,1743113598,1743117198,3600,0.36884625522928893,3.155067040315266,0.1,0.1
8129,1743117198,1743120798,3600,0.18970376257351892,3.0084897208913945,0.1,0.1
8130,1743120798,1743123894,3096,1.674127993679464,4.597337993808988,0.3014058870183852,0.41150583178577715
8131,1743124398,1743127998,3600,0.4226990835149629,3.158596917652723,0.1,0.1
8132,1743127998,1743131337,3339,1.9202811093818832,4.624740505467943,0.4499095513522001,0.3317497987165565
8133,1743131598,1743134039,2441,2.2058944778890397,4.3607398093634,0.3865951900385377,0.40062310896228304
8134,1743135198,1743138798,3600,0.2959454215657112,3.0095272179478116,0.1,0.1
8135,1743138798,1743142398,3600,0.14831631496160103,3.0427489069710236,0.1,0.1
8136,1743142398,1743143179,781,1.4182444367092022,4.132341608368727,0.8948235288261653,0.6626476203477343
8137,1743145998,1743149598,3600,0.16584066354466842,3.191805451138429,0.1,0.1
8138,1743149598,1743153198,3600,0.12317038246542206,3.081192995096735,0.1,0.1
8139,1743153198,1743155149,1951,1.9010477001078634,4.582711502693177,0.6082340175876678,0.8504058764054961
8140,1743156798,1743160398,3600,0.12727344625321077,3.0119196632270206,0.1,0.1
8141,1743160398,1743163998,3600,0.48150370423655264,3.1641683171191852,0.1,0.1
8142,1743163998,1743167430,3432,1.5583291606936465,4.671078837755729,0.4638036721088943,0.7846053485959582
8143,1743167598,1743171198,3600,0.24399450253701566,3.174529888615641,0.1,0.1
8144,1743171198,1743171671,473,0.7923600785809402,3.310487089387265,0.22281939164741038,0.3109379009058694
8145,1743174798,1743175112,314,0.5877199330927526,3.5150808516256844,0.6251134059215774,0.7391454042328495
8146,1743178398,1743181998,3600,0.29818184968085226,3.081445286555319,0.1,0.1
8147,1743181998,1743183248,1250,1.0431526487225975,4.050412945431902,0.44239615451354497,0.8644085561503181
8148,1743185598,1743188293,2695,2.3337409012429102,4.3534207161722,0.2782284849483335,0.5919390601033492
8149,1743189198,1743192798,3600,0.3268537902024442,3.1695345454441197,0.1,0.1
8150,1743192798,1743196398,3600,0.3338159879417909,3.1839707764142613,0.1,0.1
8151,1743196398,1743196792,394,0.6963494703320587,3.37563271686191,0.4324236357657515,0.3743447587366746
8152,1743199998,1743203598,3600,0.16686763445992803,3.079498057255537,0.1,0.1
8153,1743203598,1743207198,3600,0.319176004801373,3.1184560672328208,0.1,0.1
8154,1743207198,1743208873,1675,1.2236558290411461,3.8187491257171335,0.3708162302200255,0.13696653043629475
8155,1743210798,1743211887,1089,1.0612392591331958,4.080758803709225,0.1758061972509604,0.5719405382079233
8156,1743214398,1743217998,3600,0.2974214572658307,3.1616892549866984,0.1,0.1
8157,1743217998,1743218616,618,1.4585385710283412,4.093985984793642,0.3503059191931919,0.4445340660762642
8158,1743221598,1743222496,898,1.0307391718142673,3.8410350592206983,0.45550857887248997,0.9438763908836967
8159,1743225198,1743228330,3132,2.3374446662021304,4.647880723294692,0.16000176389146678,0.28220308356466184
8160,1743228798,1743232398,3600,0.43920011135861425,3.175761366124526,0.1,0.1
8161,1743232398,1743235998,3600,0.10234531140331651,3.0040290097458593,0.1,0.1
8162,1743235998,1743239598,3600,0.2256223027211989,3.1451339345097677,0.1,0.1
8163,1743239598,1743241211,1613,1.385971031164308,3.9566771164998036,0.27810906604676533,0.9987920001084357
8164,1743243198,1743246798,3600,0.41859443225801574,3.0877469535075055,0.1,0.1
8165,1743246798,1743249767,2969,1.8156393640333297,4.331174426640529,0.1015030853214064,0.6435351221666377
8166,1743250398,1743253998,3600,0.26265161056473474,3.039742361952011,0.1,0.1
8167,1743253998,1743254907,909,1.0863935843466546,4.152392954300503,0.8187549214788047,0.12157935381406104
8168,1743257598,1743258140,542,0.9447901061613148,3.4099862768843954,0.15156167429766249,0.17861211969705698
8169,1743261198,1743264798,3600,0.41745395477435,3.168604087360265,0.1,0.1
8170,1743264798,1743265012,214,0.7781410980487671,3.418036345625542,0.4747149824476544,0.13880767125961904
8171,1743268398,1743270481,2083,1.9466632795426766,4.564471319032344,0.7153463246651887,0.13800880304518146
8172,1743271998,1743275598,3600,0.4758132941560971,3.0884203292613264,0.1,0.1
8173,1743275598,1743275933,335,0.9525084612415662,3.613941539654589,0.627015836572086,0.5730789682338054
8174,1743279198,1743282798,3600,0.3257033884227766,3.1502370192473887,0.1,0.1
8175,1743282798,1743286398,3600,0.4191377384256071,3.129796403474821,0.1,0.1
8176,1743286398,1743289998,3600,0.11757293460463272,3.1946518488264126,0.1,0.1
8177,1743289998,1743293598,3600,0.24475811193534405,3.0446889742737615,0.1,0.1
8178,1743293598,1743297198,3600,0.32448371190113123,3.0757478899181785,0.1,0.1
8179,1743297198,1743300313,3115,2.41137191404727,4.575926437953117,0.8358212127739488,0.4008862835385396
8180,1743300798,1743303787,2989,2.1594257037262423,4.320443354832163,0.5868861738163645,0.6128546035870232
8181,1743304398,1743306692,2294,1.8400251425862786,4.666738631310808,0.1244370430162211,0.5397868626148963
8182,1743307998,1743311598,3600,0.20952636504620106,3.09782758000844,0.1,0.1
8183,1743311598,1743312815,1217,1.368566173050309,4.195857802624232,0.5101454053415309,0.2925164522885677
8184,1743315198,1743316839,1641,1.4201797481846787,3.8603312733484962,0.8055801958279393,0.6061804218553764
8185,1743318798,1743322398,3600,0.374629161792954,3.073737346097561,0.1,0.1
8186,1743322398,1743323784,1386,1.0384687736247902,3.873485834888422,0.7099956092317157,0.6788352919421837
8187,1743325998,1743329598,3600,0.215703765421715,3.1865399577277707,0.1,0.1
8188,1743329598,1743333198,3600,0.3342103653961672,3.074524128078257,0.1,0.1
8189,1743333198,1743336798,3600,0.30233533194819573,3.0063508687907827,0.1,0.1
8190,1743336798,1743338390,1592,1.0345072094165515,3.993833890215435,0.8469350648483802,0.8592759365896611
8191,1743340398,1743342159,1761,1.3741862592297127,3.984022930454417,0.40968503012206736,0.9767265500483977
8192,1743343998,1743347445,3447,1.662662211860427,4.497439971167433,0.8676858127677023,0.9535778230623776
8193,1743347598,1743348957,1359,1.479033076012529,4.063040939308299,0.38378222979314525,0.27051313475897304
8194,1743351198,1743354798,3600,0.19640485667017724,3.1216322916732895,0.1,0.1
8195,1743354798,1743355771,973,1.0795902218444495,3.9407248274311706,0.5282572687316825,0.3064775892287662
8196,1743358398,1743361998,3600,0.39654518514052073,3.1304059420169046,0.1,0.1
8197,1743361998,1743365598,3600,0.2006586891063399,3.137694642620133,0.1,0.1
8198,1743365598,1743366294,696,1.4606992187567611,4.053159957752017,0.9459628235462223,0.9131332473598197
8199,1743369198,1743372798,3600,0.21596267317138454,3.0562534600623277,0.1,0.1
8200,1743372798,1743376398,3600,0.24537184309543958,3.124282074950136,0.1,0.1
8201,1743376398,1743379998,3600,0.22108634057058138,3.0102089156477403,0.1,0.1
8202,1743379998,1743383598,3600,0.2865457794127793,3.173741653392685,0.1,0.1
8203,1743383598,1743385869,2271,2.459168894496381,4.685009524876972,0.8542221891949027,0.9131914166620863
8204,1743387198,1743388701,1503,1.4703336874312274,4.127177095125162,0.579227335767369,0.46284742124662903
8205,1743390798,1743394398,3600,0.3916067071574989,3.12672948198869,0.1,0.1
8206,1743394398,1743396772,2374,1.780042108585532,4.491113143507745,0.18736605728337316,0.13262423477113133
8207,1743397998,1743401598,3600,0.13026246285263254,3.111620580392926,0.1,0.1
8208,1743401598,1743405198,3600,0.2792027620270152,3.1425422080529075,0.1,0.1
8209,1743405198,1743408798,3600,0.29269696544042123,3.1762213642098187,0.1,0.1
8210,1743408798,1743409029,231,0.9130825171053878,3.687556076618851,0.9476935751658377,0.2706244893831616
8211,1743412398,1743415998,3600,0.2618506346423055,3.1889039754744215,0.1,0.1
8212,1743415998,1743416733,735,1.29219996627423,3.941662429832662,0.7688720925570506,0.16799706202540024
8213,1743419598,1743423198,3600,0.11876781248459123,3.0470516934326626,0.1,0.1
8214,1743423198,1743426342,3144,1.6133644070689996,4.603173215318418,0.23911467674923495,0.57488030570707
8215,1743426798,1743430398,3600,0.3215502032862717,3.111019555505999,0.1,0.1
8216,1743430398,1743430583,185,0.7941846029344333,3.5107354751818316,0.5005018463081795,0.8924174008169142
8217,1743433998,1743437598,3600,0.4703566416587398,3.1607167138383607,0.1,0.1
8218,1743437598,1743440086,2488,2.0337665323168874,4.551789239111281,0.44188240062153405,0.8911013144926055
8219,1743441198,1743444798,3600,0.4340666363738088,3.0881257444599584,0.1,0.1
8220,1743444798,1743447655,2857,1.9901804805929726,4.38398089604926,0.6030799299313362,0.9384740450467292
8221,1743448398,1743451998,3600,0.2805792728656922,3.121795442847342,0.1,0.1
8222,1743451998,1743455598,3600,0.3714354203136023,3.093990200433931,0.1,0.1
8223,1743455598,1743459198,3600,0.11474960435522395,3.1747137627053847,0.1,0.1
8224,1743459198,1743462175,2977,2.0727257022165135,4.642731061717061,0.8504080587676478,0.8885749263124881
8225,1743462798,1743466398,3600,0.3397210846491756,3.102887904815871,0.1,0.1
8226,1743466398,1743469998,3600,0.2540557845237879,3.083631198161994,0.1,0.1
8227,1743469998,1743472669,2671,2.4455230842962266,4.663139340584195,0.49208450581821794,0.377781649873453
8228,1743473598,1743477198,3600,0.2601339456771717,3.0362671202295,0.1,0.1
8229,1743477198,1743480552,3354,1.83027127736361,4.568898536294914,0.36921663343950206,0.8053593252285579
8230,1743480798,1743484398,3600,0.416946368597658,3.0043077178054363,0.1,0.1
8231,1743484398,1743487998,3600,0.16022363336157983,3.06628579549986,0.1,0.1
8232,1743487998,1743491598,3600,0.4264809089248467,3.1774078977462583,0.1,0.1
8233,1743491598,1743494992,3394,2.4326998527940877,4.6326448508379094,0.9277029006738595,0.7060006097437512
8234,1743495198,1743495698,500,0.888547383841189,3.65077815905249,0.9000962289222002,0.5029806302154587
8235,1743498798,1743500106,1308,1.484366664527887,3.9433545943638006,0.7103723422469185,0.7106349115882793
8236,1743502398,1743502623,225,0.7880673790372639,3.48320413684152,0.3138372612386886,0.14824103899747815
8237,1743505998,1743509349,3351,1.952321312435852,4.679008794598032,0.8194189134475159,0.7140278225275323
8238,1743509598,1743511565,1967,2.2895284767208057,4.609791972767208,0.19171740377225777,0.9215394565831075
8239,1743513198,1743516798,3600,0.1226693293773261,3.104552149964397,0.1,0.1
8240,1743516798,1743520217,3419,2.4909864036659317,4.613228917690923,0.9846545772132186,0.24258747280469728
8241,1743520398,1743521075,677,1.4707004247677413,3.8649646455213333,0.8450097492034117,0.993822650985317
8242,1743523998,1743524355,357,0.5326643800629253,3.570639786536617,0.5238640510518444,0.5324634041704142
8243,1743527598,1743531198,3600,0.3977717691049988,3.1578379222513964,0.1,0.1
8244,1743531198,1743532178,980,1.403640742900788,4.122645050323146,0.6248728468530937,0.32705738546423413
8245,1743534798,1743536210,1412,1.4200407128472883,3.8888031934404186,0.8262094840718541,0.23481827474590566
8246,1743538398,1743541452,3054,1.8654495764106063,4.362173859020599,0.18349118551471788,0.8542414892852397
8247,1743541998,1743545113,3115,2.1370244994344585,4.466077118721838,0.1085307303557597,0.5713068131474391
8248,1743545598,1743549198,3600,0.13235633725687374,3.073044186062475,0.1,0.1
8249,1743549198,1743552798,3600,0.20345908226129286,3.059787571350401,0.1,0.1
8250,1743552798,1743555900,3102,2.189731250875231,4.4204367904351285,0.21142736541830529,0.1535567944220665
8251,1743556398,1743559998,3600,0.48645912103698274,3.089419408046035,0.1,0.1
8252,1743559998,1743563598,3600,0.45210438167578226,3.198609631551509,0.1,0.1
8253,1743563598,1743566855,3257,2.376073409735862,4.482526399262414,0.19346555878642493,0.888740204610574
8254,1743567198,1743570798,3600,0.182492057408405,3.0213977204873976,0.1,0.1
8255,1743570798,1743571481,683,1.0821314968999893,3.872140257527711,0.7949987653597647,0.8036348079257846
8256,1743574398,1743575731,1333,1.2186879446213938,4.09037782878283,0.969917991131908,0.24571534962759267
8257,1743577998,1743581598,3600,0.4993281326713036,3.178445877317799,0.1,0.1
8258,1743581598,1743584793,3195,1.9792400900643647,4.382250599374035,0.7841074833350036,0.5369181340040836
8259,1743585198,1743588798,3600,0.45688928192292966,3.1127764600949686,0.1,0.1
8260,1743588798,1743592398,3600,0.2880657111667233,3.1987052079310625,0.1,0.1
8261,1743592398,1743595998,3600,0.14479433542224762,3.11015955609056,0.1,0.1
8262,1743595998,1743599573,3575,1.6025749172456054,4.605156811276516,0.4116082200077702,0.9175049485307247
8263,1743599598,1743602045,2447,2.3191337628850652,4.694163812521605,0.5892684970963364,0.42095149638075346
8264,1743603198,1743606798,3600,0.2245552278102057,3.1797772428251156,0.1,0.1
8265,1743606798,1743609540,2742,1.694775453081018,4.492822689600799,0.4804036521600753,0.5007322171644355
8266,1743610398,1743611376,978,1.1877399869942877,3.8618643291379056,0.7354210433790949,0.6427112440214847
8267,1743613998,1743616256,2258,1.8460284916664373,4.44387379992851,0.8643696833987728,0.8529979084824675
8268,1743617598,1743621198,3600,0.1633415293861344,3.012218257816123,0.1,0.1
8269,1743621198,1743624796,3598,2.3604635549203934,4.4308185344669475,0.6709134848615979,0.2888170138527969
8270,1743624798,1743628398,3600,0.14717030141110135,3.066248760842757,0.1,0.1
8271,1743628398,1743629066,668,1.0410984268263808,4.0430512843266015,0.1725829727469207,0.6809250709013738
8272,1743631998,1743633668,1670,1.3623327690648193,3.8584648748800348,0.31550094756741515,0.5301867068093543
8273,1743635598,1743639198,3600,0.12921848916024603,3.0478009120860325,0.1,0.1
8274,1743639198,1743642798,3600,0.2148635061450667,3.1079633824510404,0.1,0.1
8275,1743642798,1743645188,2390,2.054885552043251,4.420023183391343,0.16806990198289068,0.45171072560773073
8276,1743646398,1743649998,3600,0.1338541668748167,3.1708067726008435,0.1,0.1
8277,1743649998,1743653598,3600,0.25437693905175485,3.1715218555344573,0.1,0.1
8278,1743653598,1743657198,3600,0.16879307519698167,3.0561355451552754,0.1,0.1
8279,1743657198,1743660798,3600,0.4115539970974773,3.081006747301248,0.1,0.1
8280,1743660798,1743661916,1118,1.1036750671350104,4.010269928262342,0.9473279798339481,0.20350340640632103
8281,1743664398,1743667548,3150,2.2404833485070412,4.6040296495141195,0.47814723653211966,0.9699842458651106
8282,1743667998,1743668141,143,0.7992759986284905,3.4400751983987448,0.9748210632246185,0.9597667051632512
8283,1743671598,1743675198,3600,0.36428531340985104,3.1933502308780293,0.1,0.1
8284,1743675198,1743678798,3600,0.13964816733491198,3.0283404200243518,0.1,0.1
8285,1743678798,1743682398,3600,0.39401547487818767,3.085068561813945,0.1,0.1
8286,1743682398,1743685998,3600,0.448808711790298,3.0814215877048303,0.1,0.1
8287,1743685998,1743689598,3600,0.25217844422979996,3.014055816785313,0.1,0.1
8288,1743689598,1743693198,3600,0.110334970646529,3.131411341188982,0.1,0.1
8289,1743693198,1743694601,1403,1.0968964059995292,3.8442536907313785,0.7140203959241199,0.15193569285190248
8290,1743696798,1743700130,3332,1.962886477180437,4.663176028653507,0.9921600751082367,0.21069883362148872
8291,1743700398,1743703998,3600,0.20155897174524645,3.18007819622182,0.1,0.1
8292,1743703998,1743706321,2323,2.486398923897255,4.308217713743456,0.12611818311040937,0.961922629717354
8293,1743707598,1743711198,3600,0.2110804010305302,3.099386586856094,0.1,0.1
8294,1743711198,1743713319,2121,2.4991227699415566,4.65272039610622,0.75198469464043,0.8999568057037146
8295,1743714798,1743717110,2312,1.681668507002644,4.528893020194947,0.2275262674759892,0.9915124363174695
8296,1743718398,1743721998,3600,0.31470681104402726,3.0297983131180968,0.1,0.1
8297,1743721998,1743724925,2927,2.201710508536065,4.6328248850386045,0.45311166308937256,0.7653334915237412
8298,1743725598,1743727588,1990,1.6007087973809329,4.476595707844631,0.20446567798292392,0.7310949081596114
8299,1743729198,1743732798,3600,0.37267650465332514,3.090321817056526,0.1,0.1
8300,1743732798,1743736398,3600,0.10949504972362685,3.1629040232986263,0.1,0.1
8301,1743736398,1743739457,3059,1.8410537318305455,4.395619085515884,0.24677673739555575,0.7156487221154858
8302,1743739998,1743741604,1606,1.2195654635574158,4.195723469138234,0.6931531370136653,0.4888627725410323
8303,1743743598,1743747198,3600,0.27792501486548193,3.0556526014158303,0.1,0.1
8304,1743747198,1743750798,3600,0.44778771997539335,3.0332205782895283,0.1,0.1
8305,1743750798,1743751235,437,0.6534722116092808,3.3656295588530027,0.21777375335998517,0.3331039476061749
8306,1743754398,1743757998,3600,0.32671458083542354,3.059881707509093,0.1,0.1
8307,1743757998,1743759580,1582,1.080434169683575,4.011155534397075,0.3834232532550952,0.5911681906070417
8308,1743761598,1743762822,1224,1.4744720257723827,3.8069175129273147,0.14284854179420003,0.8925492859114909
8309,1743765198,1743768798,3600,0.13026139749460103,3.0069801439939328,0.1,0.1
8310,1743768798,1743772398,3600,0.20346784471723878,3.18481976899447,0.1,0.1
8311,1743772398,1743775998,3600,0.37796807310166836,3.0382141808489185,0.1,0.1
8312,1743775998,1743778807,2809,1.727159686517088,4.600428936322656,0.3358930806068289,0.1633745054924528
8313,1743779598,1743781535,1937,2.2049790199802706,4.466835503097141,0.32464546327009847,0.28192662495087983
8314,1743783198,1743786690,3492,2.0300701560410563,4.318080153177409,0.8572626478033448,0.639566929615006
8315,1743786798,1743790353,3555,1.798612962885862,4.342409673451289,0.708476078056245,0.17991478188490528
8316,1743790398,1743790750,352,0.6027192017415216,3.579504328949977,0.5665588319621697,0.6762188268239415
8317,1743793998,1743796962,2964,1.8238868824338963,4.576570919095355,0.9677247414310464,0.9300875787298217
8318,1743797598,1743801198,3600,0.48947923442517416,3.1457467106664416,0.1,0.1
8319,1743801198,1743804798,3600,0.19991455440271402,3.0786556409300805,0.1,0.1
8320,1743804798,1743807758,2960,2.331521353767628,4.462892988830867,0.4095903071014273,0.7547484674120593
8321,1743808398,1743811998,3600,0.36928253873010697,3.1905297888867366,0.1,0.1
8322,1743811998,1743815598,3600,0.31086449874251937,3.1613328164070675,0.1,0.1
8323,1743815598,1743818864,3266,2.28520178813723,4.616507912569342,0.5603893657749861,0.9423189029831811
8324,1743819198,1743820877,1679,1.0600864929485543,4.011113031347292,0.7787173814513564,0.7772846381908843
8325,1743822798,1743826398,3600,0.4509179711272472,3.159785268218393,0.1,0.1
8326,1743826398,1743829998,3600,0.1457622436084982,3.197793236721399,0.1,0.1
8327,1743829998,1743831278,1280,1.432946834465383,4.094303044202457,0.3598886903459696,0.7809671428885984
8328,1743833598,1743837198,3600,0.4948288719385324,3.0451476141090676,0.1,0.1
8329,1743837198,1743837405,207,0.5258375151777694,3.441357933025046,0.6151052629870891,0.8751177433449897
8330,1743840798,1743844398,3600,0.3069606946296999,3.087544420357154,0.1,0.1
8331,1743844398,1743847998,3600,0.20094269151792218,3.1792821142894243,0.1,0.1
8332,1743847998,1743851115,3117,2.3828937610173853,4.451635768619685,0.6717598622589857,0.7022177384449838
8333,1743851598,1743854000,2402,1.815071490078215,4.365992924394042,0.6483878032369839,0.7949682911432185
8334,1743855198,1743858798,3600,0.34375747422533715,3.1589911480709785,0.1,0.1
8335,1743858798,1743862398,3600,0.34872810067511245,3.0635918455828217,0.1,0.1
8336,1743862398,1743862721,323,0.5293032884957627,3.5074050193128925,0.8311135619162294,0.6423601729345713
8337,1743865998,1743869598,3600,0.20858381337125037,3.180324802637658,0.1,0.1
8338,1743869598,1743873198,3600,0.454136518179615,3.1685335365105862,0.1,0.1
8339,1743873198,1743875942,2744,1.6615968046596212,4.461834982928545,0.49492479114038157,0.2647369145885185
8340,1743876798,1743879949,3151,1.56460802214001,4.500567184317632,0.5688838892755617,0.9722980816688914
8341,1743880398,1743882172,1774,1.396244608729307,3.898439605247118,0.2710756517108752,0.10734796012593972
8342,1743883998,1743887598,3600,0.11874904135219917,3.176128767324521,0.1,0.1
8343,1743887598,1743888193,595,0.7495703167982922,3.4889164842643963,0.23873314852260263,0.1224585356418814
8344,1743891198,1743894798,3600,0.15686928284460955,3.1789271158800827,0.1,0.1
8345,1743894798,1743898398,3600,0.1995335106989602,3.0256135512110713,0.1,0.1
8346,1743898398,1743901998,3600,0.20255487291967553,3.1543657936278393,0.1,0.1
8347,1743901998,1743903736,1738,1.4676987970291637,4.0750619074709284,0.6704233306219338,0.35315687590641587
8348,1743905598,1743907077,1479,1.0959198897988696,4.119302903134572,0.6359821792669008,0.6133457233290083
8349,1743909198,1743911703,2505,2.416297688122084,4.381927723360269,0.9512633683973972,0.19931552312175166
8350,1743912798,1743916398,3600,0.10385101735769689,3.1142027504527956,0.1,0.1
8351,1743916398,1743918662,2264,1.954372221471551,4.451170483107405,0.19634473557962218,0.1675057054073557
8352,1743919998,1743922554,2556,1.8980192496816664,4.33459500795966,0.5427570520457391,0.11160786574326348
8353,1743923598,1743924073,475,0.611381251744145,3.3924291222240868,0.9844609284023118,0.3220822255282947
8354,1743927198,1743927313,115,0.9831295229788944,3.5699534088499747,0.365088282302208,0.44757582776635996
8355,1743930798,1743931389,591,0.6052276530033921,3.5960509395707074,0.49097614694192915,0.13384116705174573
8356,1743934398,1743936464,2066,2.0165108268592618,4.633811270306324,0.5995501128557942,0.6745380934726637
8357,1743937998,1743938994,996,1.1458996761043265,3.8514209984600196,0.8129910505687954,0.25256281196354696
8358,1743941598,1743945198,3600,0.23428522660773546,3.1249165210861105,0.1,0.1
8359,1743945198,1743948798,3600,0.37911925794896484,3.0174108766081367,0.1,0.1
8360,1743948798,1743952398,3600,0.43953363304252435,3.05933124836504,0.1,0.1
8361,1743952398,1743954041,1643,1.2831007780717834,4.082047605402296,0.2284960506223326,0.7988723798579987
8362,1743955998,1743959130,3132,2.4699427807033905,4.564120754702483,0.19828420551783055,0.9043737280217081
8363,1743959598,1743963198,3600,0.1829737645203315,3.137901127183425,0.1,0.1
8364,1743963198,1743963362,164,0.6678261036048596,3.384587386246939,0.2721384201263628,0.5564199573176096
8365,1743966798,1743970398,3600,0.48914309651960075,3.1116149830812523,0.1,0.1
8366,1743970398,1743973998,3600,0.15735146252313248,3.1411558499711036,0.1,0.1
8367,1743973998,1743977598,3600,0.4434738469939522,3.097188567290636,0.1,0.1
8368,1743977598,1743979661,2063,2.3706666765716053,4.581422243240459,0.21283291290516843,0.241374888956277
8369,1743981198,1743984798,3600,0.356772652277343,3.1171171522428853,0.1,0.1
8370,1743984798,1743988398,3600,0.17872082054503552,3.079037566067643,0.1,0.1
8371,1743988398,1743991998,3600,0.232058339888144,3.129224938474791,0.1,0.1
8372,1743991998,1743995598,3600,0.16644732675757937,3.101180581168676,0.1,0.1
8373,1743995598,1743998857,3259,2.439233161757806,4.463003936960304,0.8997474525076915,0.7813269551674825
8374,1743999198,1744000839,1641,1.0650244262810862,4.022153789592088,0.9159155733888344,0.42619001535498113
8375,1744002798,1744005132,2334,2.4997545416213525,4.626285766100372,0.37949230777233034,0.2626651339529879
8376,1744006398,1744008570,2172,2.136771081037569,4.489973604144918,0.3468277243518215,0.19663045042569
8377,1744009998,1744011390,1392,1.0618344487587974,4.143923747604199,0.21769183960386188,0.8027839330440789
8378,1744013598,1744017198,3600,0.19442895566900953,3.1894313706691815,0.1,0.1
8379,1744017198,1744020257,3059,2.097184867975463,4.493872736288455,0.16012429145465373,0.11889445741082649
8380,1744020798,1744024398,3600,0.22296495827502147,3.165842221861391,0.1,0.1
8381,1744024398,1744027998,3600,0.3625014867208738,3.0295743540645286,0.1,0.1
8382,1744027998,1744031598,3600,0.24412292771411784,3.074610123029645,0.1,0.1
8383,1744031598,1744035198,3600,0.4590457152377526,3.0850794314596683,0.1,0.1
8384,1744035198,1744038798,3600,0.44283814259855325,3.1787782530362736,0.1,0.1
8385,1744038798,1744042398,3600,0.40914300717863405,3.035779110871426,0.1,0.1
8386,1744042398,1744043506,1108,1.107033894155734,4.051358588589928,0.8463214774447936,0.7154706487970969
8387,1744045998,1744049598,3600,0.15425668862401587,3.130945361671657,0.1,0.1
8388,1744049598,1744053198,3600,0.2837098011279844,3.067417902304305,0.1,0.1
8389,1744053198,1744056798,3600,0.2694740338886551,3.1980748779928416,0.1,0.1
8390,1744056798,1744060398,3600,0.20179549820538156,3.0098396228704263,0.1,0.1
8391,1744060398,1744063998,3600,0.10694436111105157,3.004760039814885,0.1,0.1
8392,1744063998,1744067366,3368,1.5496618352814941,4.489386403545593,0.7473299502023983,0.5685634316786405
8393,1744067598,1744071198,3600,0.3077861562859602,3.076915762942724,0.1,0.1
8394,1744071198,1744074798,3600,0.31794908517655873,3.1106884000349555,0.1,0.1
8395,1744074798,1744077339,2541,2.0689946494546034,4.343799346647647,0.24427042898570955,0.7635677023234613
8396,1744078398,1744080954,2556,1.8441969940133718,4.5289168941909175,0.9238846043714246,0.29208024497890295
8397,1744081998,1744084031,2033,2.4574895158134753,4.612512335130374,0.6563739485887229,0.49311426060238417
8398,1744085598,1744087928,2330,1.9432888580484708,4.600390752670082,0.8207665279218034,0.7807124779290593
8399,1744089198,1744090000,802,1.3041922517856004,4.195940312616397,0.27814028664759394,0.5563567774533433
8400,1744092798,1744096398,3600,0.10586112430054846,3.089529116886179,0.1,0.1
8401,1744096398,1744099998,3600,0.33989673781011054,3.1159566024214227,0.1,0.1
8402,1744099998,1744103564,3566,2.4241045259482483,4.585885809569324,0.11454496593697337,0.8395958730220009
8403,1744103598,1744107198,3600,0.11487594245021288,3.1597977344067134,0.1,0.1
8404,1744107198,1744107547,349,0.8689065428869696,3.3239896701958744,0.16514551981115924,0.7450744202681437
8405,1744110798,1744114398,3600,0.2534139853210835,3.0537582949005064,0.1,0.1
8406,1744114398,1744117998,3600,0.29798170933699175,3.1498139710219606,0.1,0.1
8407,1744117998,1744120435,2437,1.8580327134401406,4.333061134217052,0.40954665556700376,0.8264572345898904
8408,1744121598,1744125198,3600,0.4320132853183709,3.0424908175175736,0.1,0.1
8409,1744125198,1744128346,3148,1.9614571205179265,4.428299768256325,0.18264827355068608,0.811011749583634
8410,1744128798,1744132398,3600,0.472534529821519,3.0926790209141206,0.1,0.1
8411,1744132398,1744135998,3600,0.42786710291121444,3.15992501929498,0.1,0.1
8412,1744135998,1744139598,3600,0.3172905300583474,3.145296234765337,0.1,0.1
8413,1744139598,1744143198,3600,0.12872650321043713,3.1391941388412703,0.1,0.1
8414,1744143198,1744146183,2985,1.6218185386544544,4.327374631927878,0.546480096665324,0.1332726616410442
8415,1744146798,1744148024,1226,1.206031119797518,4.078043289218247,0.8960850112322863,0.6832803388495513
8416,1744150398,1744153998,3600,0.1811837681702028,3.090657152681965,0.1,0.1
8417,1744153998,1744155436,1438,1.451292230417555,3.90431665473591,0.3956980513689704,0.775315588999622
8418,1744157598,1744159921,2323,2.4473044518840243,4.56216828726912,0.563866848703356,0.3975068908744225
8419,1744161198,1744164798,3600,0.3722516836196348,3.0076074338859695,0.1,0.1
8420,1744164798,1744168398,3600,0.32551657993130384,3.164420325663886,0.1,0.1
8421,1744168398,1744171998,3600,0.4902243544374594,3.1777338707891776,0.1,0.1
8422,1744171998,1744175598,3600,0.11532432801225312,3.1290160985809203,0.1,0.1
8423,1744175598,1744177443,1845,1.62306375037525,4.4799335922159536,0.30147846564813463,0.6395047650554556
8424,1744179198,1744180255,1057,1.105290723344673,3.945520457018849,0.3379264928822969,0.137267948130463
8425,1744182798,1744186398,3600,0.43974541163187386,3.003708961850019,0.1,0.1
8426,1744186398,1744188059,1661,1.273113902634853,4.027918032556546,0.5135925628982931,0.9892273889544477
8427,1744189998,1744193598,3600,0.3189952484125571,3.19022421774034,0.1,0.1
8428,1744193598,1744197198,3600,0.22580950893615037,3.1094653704547373,0.1,0.1
8429,1744197198,1744200798,3600,0.32172222702814945,3.1759250181381433,0.1,0.1
8430,1744200798,1744204398,3600,0.46332542498005413,3.0436193035622483,0.1,0.1
8431,1744204398,1744207998,3600,0.14758600223621215,3.112716856152647,0.1,0.1
8432,1744207998,1744211598,3600,0.2623567192626493,3.018452071185713,0.1,0.1
8433,1744211598,1744215198,3600,0.32420314751960533,3.043872190709759,0.1,0.1
8434,1744215198,1744218798,3600,0.23335011299761607,3.167642711611588,0.1,0.1
8435,1744218798,1744222398,3600,0.14406616912360506,3.160169034626961,0.1,0.1
8436,1744222398,1744225998,3600,0.1983862218365185,3.1222079261684392,0.1,0.1
8437,1744225998,1744226103,105,0.7186643596015134,3.3148900419782863,0.9806995614750784,0.9867200636655419
8438,1744229598,1744233198,3600,0.23046604680341046,3.127577884460935,0.1,0.1
8439,1744233198,1744236798,3600,0.31646886579829026,3.0262221549552564,0.1,0.1
8440,1744236798,1744238145,1347,1.4521487137007765,4.198228093877364,0.38761089608853394,0.27305611900415905
8441,1744240398,1744243998,3600,0.4427596399758368,3.0463255086347862,0.1,0.1
8442,1744243998,1744247598,3600,0.10128849543298549,3.1571068660416204,0.1,0.1
8443,1744247598,1744248210,612,1.185474217687142,3.8776970815779817,0.5897239143078249,0.6733283715145922
8444,1744251198,1744254412,3214,1.9500637702484842,4.680844189227108,0.5053026917663836,0.7805836271455365
8445,1744254798,1744256783,1985,2.308975927517205,4.563981190082804,0.36279739393107613,0.8370722875439173
8446,1744258398,1744261998,3600,0.4608797701170625,3.0638717516944887,0.1,0.1
8447,1744261998,1744264904,2906,2.210739882275259,4.433588120326713,0.7145918396289378,0.4793976666647629
8448,1744265598,1744268559,2961,1.9974374289411867,4.548715150789792,0.2418951063103002,0.12720197110063705
8449,1744269198,1744272798,3600,0.10366849262877414,3.1399595124931423,0.1,0.1
8450,1744272798,1744276398,3600,0.11346992763660363,3.090371053503266,0.1,0.1
8451,1744276398,1744279998,3600,0.2698751122788907,3.1294898964649485,0.1,0.1
8452,1744279998,1744283598,3600,0.19709130319222956,3.1049813981513212,0.1,0.1
8453,1744283598,1744287198,3600,0.35309607053966297,3.077194688111441,0.1,0.1
8454,1744287198,1744288750,1552,1.4210071064391334,3.923714319811602,0.6629582159334291,0.9313696432976818
8455,1744290798,1744294398,3600,0.23822140653342527,3.1160186792734725,0.1,0.1
8456,1744294398,1744295680,1282,1.1359978629484102,4.145484325793942,0.3589160675912705,0.8412773194926367
8457,1744297998,1744301598,3600,0.28186339439505315,3.0521663298026347,0.1,0.1
8458,1744301598,1744305198,3600,0.3729981554467162,3.1310538352246944,0.1,0.1
8459,1744305198,1744308268,3070,1.8895239793548892,4.388415018874593,0.24049863767686538,0.7819545779328603
8460,1744308798,1744312398,3600,0.12063382622171775,3.0810761855946414,0.1,0.1
8461,1744312398,1744315987,3589,1.5279416679930478,4.564298380433265,0.6611768344421256,0.33298628041219647
8462,1744315998,1744319598,3600,0.24849278552728588,3.181117863484553,0.1,0.1
8463,1744319598,1744322635,3037,2.146572692247302,4.494239207441794,0.1968857245448961,0.44599046073002613
8464,1744323198,1744326064,2866,1.8450839048268435,4.457833154234218,0.36577171357564653,0.8407861471036264
8465,1744326798,1744330398,3600,0.23564461221787725,3.0555591682333394,0.1,0.1
8466,1744330398,1744333819,3421,2.017704270556583,4.364905154179,0.7548452031805188,0.18133850554525166
8467,1744333998,1744336022,2024,1.953335542319913,4.513285547803921,0.17407771894234136,0.7016541081066148
8468,1744337598,1744341198,3600,0.13122589116206332,3.1446890321879777,0.1,0.1
8469,1744341198,1744341370,172,0.6942353035342155,3.626196259911347,0.28707458822699705,0.8594832473196158
8470,1744344798,1744346448,1650,1.4322382883872995,3.8813518701770193,0.35735794724027703,0.5843150920983025
8471,1744348398,1744350289,1891,1.7513497662864228,4.541095869087922,0.6400091835062991,0.10868852418590985
8472,1744351998,1744355598,3600,0.47768750931713466,3.1292249171267557,0.1,0.1
8473,1744355598,1744359198,3600,0.13289925181511153,3.108571400184067,0.1,0.1
8474,1744359198,1744362798,3600,0.3867021646489939,3.0325078228334257,0.1,0.1
8475,1744362798,1744363659,861,1.4066384798225222,4.005392123928153,0.589997580188516,0.3247153813176554
8476,1744366398,1744367874,1476,1.3632755058189243,4.062766734000456,0.5171887592943112,0.6205233720071978
8477,1744369998,1744373598,3600,0.24156899876022178,3.0977532459887565,0.1,0.1
8478,1744373598,1744377198,3600,0.45485638594295197,3.109385256498367,0.1,0.1
8479,1744377198,1744380798,3600,0.28666211249749685,3.0496048639860485,0.1,0.1
8480,1744380798,1744383032,2234,1.7774493633897543,4.3699793422343065,0.24451714891159237,0.8992861065129636
8481,1744384398,1744387998,3600,0.35183241953482736,3.1251361315917086,0.1,0.1
8482,1744387998,1744391598,3600,0.25752027518175324,3.069764892760791,0.1,0.1
8483,1744391598,1744393727,2129,2.0335553055499433,4.575547228639861,0.3222770261473349,0.6227472704200738
8484,1744395198,1744398798,3600,0.3812038065988228,3.0418149889552164,0.1,0.1
8485,1744398798,1744402398,3600,0.29968585563796624,3.1398156302922295,0.1,0.1
8486,1744402398,1744405969,3571,1.7021597100008985,4.662611879635176,0.6979434299656935,0.2806170880822304
8487,1744405998,1744409598,3600,0.4683231217471566,3.0590910656694748,0.1,0.1
8488,1744409598,1744413198,3600,0.10220982650379025,3.0745900363555156,0.1,0.1
8489,1744413198,1744416798,3600,0.2573453379770785,3.1016405426612246,0.1,0.1
8490,1744416798,1744420398,3600,0.3224447265308408,3.193417125110187,0.1,0.1
8491,1744420398,1744423998,3600,0.12500976148421203,3.051567756062142,0.1,0.1
8492,1744423998,1744424072,74,0.71987011088819,3.6789958302797716,0.14643259350670124,0.9184095791027305
8493,1744427598,1744431198,3600,0.4153855675643141,3.0760131303613187,0.1,0.1
8494,1744431198,1744434798,3600,0.16124701800355745,3.1850248586116554,0.1,0.1
8495,1744434798,1744438336,3538,1.820106597295029,4.396578349024167,0.603628618787899,0.38187595971395605
8496,1744438398,1744440070,1672,1.4055172436852006,4.190271262883069,0.9192649795250353,0.5782230260550619
8497,1744441998,1744445598,3600,0.36161068929664,3.0515158207767823,0.1,0.1
8498,1744445598,1744446070,472,0.6850460699662129,3.3549870659551844,0.502505241818783,0.4106287800743609
8499,1744449198,1744452798,3600,0.47933251284118983,3.0181063596669255,0.1,0.1
8500,1744452798,1744454856,2058,1.94180023759059,4.538352011790395,0.3248888107606609,0.7293737191820658
8501,1744456398,1744458347,1949,2.370152482336511,4.5665640181619525,0.9353812869659767,0.24497371234605317
8502,1744459998,1744460358,360,0.5400572582866576,3.4281627674338706,0.48927836133191005,0.8163444188799972
8503,1744463598,1744466062,2464,1.7029278633506881,4.409138218771599,0.6367211267469655,0.909920149159432
8504,1744467198,1744467424,226,0.9585388658500211,3.5954307841883355,0.5979186179988095,0.18477077117959528
8505,1744470798,1744473038,2240,1.5222464505739568,4.670553188172457,0.9576805885258592,0.2153005592419378
8506,1744474398,1744476740,2342,1.9727836086283217,4.583102133584804,0.6863760759798457,0.7270239125602098
8507,1744477998,1744481030,3032,1.8176942388872577,4.694516254448188,0.21989692363892754,0.38960169691029756
8508,1744481598,1744484457,2859,2.379035438234145,4.396538167080566,0.40913380156603674,0.4643814820102876
8509,1744485198,1744488016,2818,2.4106440217102554,4.455282080285872,0.448073249714379,0.18741405118144883
8510,1744488798,1744491355,2557,2.3912441461454295,4.613538492141401,0.7506500132759408,0.7018088665582575
8511,1744492398,1744495998,3600,0.32122480215312904,3.0594006517485086,0.1,0.1
8512,1744495998,1744496621,623,1.1849805010903258,4.060038919874797,0.633842072372009,0.16158253869549907
8513,1744499598,1744503198,3600,0.3847145092365215,3.162415070772383,0.1,0.1
8514,1744503198,1744503576,378,0.8751275683324649,3.3232588729448267,0.9903618932044125,0.9669179861223711
8515,1744506798,1744508035,1237,1.3534168178370538,3.824410506538428,0.17403585605129368,0.38200706003533214
8516,1744510398,1744512274,1876,1.6202004138656103,4.564719987931814,0.599606996124651,0.802249192387854
8517,1744513998,1744515967,1969,1.9834501765360273,4.302371842753239,0.32577380628900876,0.3416427714834247
8518,1744517598,1744520830,3232,2.1076557621143968,4.367147831260935,0.9931595125728183,0.7077679178316048
8519,1744521198,1744524798,3600,0.13474469808057182,3.033480941045506,0.1,0.1
8520,1744524798,1744528398,3600,0.3329511876366551,3.1803978153756547,0.1,0.1
8521,1744528398,1744531998,3600,0.19665915742667828,3.032379919218148,0.1,0.1
8522,1744531998,1744535598,3600,0.43951283424077636,3.110687616109689,0.1,0.1
8523,1744535598,1744539198,3600,0.47458410230213666,3.1516217868520147,0.1,0.1
8524,1744539198,1744541457,2259,2.274948695765787,4.4844090352358,0.41085731851313845,0.66066818129138
8525,1744542798,1744546379,3581,2.2358871265312708,4.6951875177062385,0.23980054211212948,0.6193030863321195
8526,1744546398,1744548750,2352,1.6375292543990914,4.429715619058608,0.2713271323576003,0.24504756939876104
8527,1744549998,1744552379,2381,2.400496150062245,4.564193718609637,0.3294169237060884,0.17187874252039176
8528,1744553598,1744557198,3600,0.12969493409500849,3.135131374585839,0.1,0.1
8529,1744557198,1744560798,3600,0.4497505248901593,3.195357480445578,0.1,0.1
8530,1744560798,1744562166,1368,1.0278422306260442,4.028162573142986,0.46503694956732133,0.33842557894965064
8531,1744564398,1744567998,3600,0.15849929279630912,3.0711280246140835,0.1,0.1
8532,1744567998,1744571598,3600,0.3294993972195145,3.0333955069110643,0.1,0.1
8533,1744571598,1744575198,3600,0.26641453089788625,3.0974043542440484,0.1,0.1
8534,1744575198,1744578798,3600,0.3502236431649931,3.1156469380760097,0.1,0.1
8535,1744578798,1744582398,3600,0.13079979929676264,3.104602249147275,0.1,0.1
8536,1744582398,1744584828,2430,1.73673439273049,4.40494766165748,0.7827387857797742,0.20405895772794302
8537,1744585998,1744588710,2712,2.422839280120135,4.359912080553636,0.3406358027712245,0.6498821151991895
8538,1744589598,1744593198,3600,0.35702758456076567,3.0956846968293346,0.1,0.1
8539,1744593198,1744596798,3600,0.2176723728066513,3.0294945195410365,0.1,0.1
8540,1744596798,1744599243,2445,1.637962330021777,4.60967876613264,0.7535475365348316,0.7021404882160641
8541,1744600398,1744602740,2342,1.8535033719074285,4.50231314039499,0.18146050121026297,0.10470296506566872
8542,1744603998,1744604984,986,1.4268976390561083,4.121727390979825,0.5311067964312567,0.6908878229552404
8543,1744607598,1744608561,963,1.480481523279832,3.9354862411293032,0.8130683245788937,0.39503811911880693
8544,1744611198,1744612779,1581,1.007663560806942,4.0608608852276395,0.40168067761440995,0.8678980227024241
8545,1744614798,1744615319,521,0.6701044096836046,3.3787746802578438,0.5539358843808034,0.24530253447286254
8546,1744618398,1744621998,3600,0.4656246320437073,3.1937268731742376,0.1,0.1
8547,1744621998,1744624005,2007,2.348440192871064,4.634224204604158,0.9459553281835649,0.5410285345623908
8548,1744625598,1744629198,3600,0.36965957305996733,3.006954825434213,0.1,0.1
8549,1744629198,1744632444,3246,2.100245905686693,4.564487063213107,0.6583719440554743,0.1540984288461325
8550,1744632798,1744633466,668,1.159568728410481,4.157802674848792,0.7534125802205026,0.3964878698583647
8551,1744636398,1744637104,706,1.3471736341877927,4.071245959796923,0.29252667529146237,0.9916778157201543
8552,1744639998,1744642234,2236,1.5382524208402346,4.456964641650464,0.5296230808200842,0.21290759714673513
8553,1744643598,1744645819,2221,2.2314573978651633,4.335374721755429,0.8978087098240604,0.7828897682237107
8554,1744647198,1744648190,992,1.3731669914851792,4.135078793770141,0.3239434162798011,0.6919011641888002
8555,1744650798,1744652742,1944,2.0492740495729436,4.456676215843827,0.6414609906733841,0.7830456543588072
8556,1744654398,1744657960,3562,1.9058507783543588,4.3419126672610995,0.60640302332334,0.8300677974134671
8557,1744657998,1744661598,3600,0.38839149014739893,3.13484155631484,0.1,0.1
8558,1744661598,1744661743,145,0.6137485650070413,3.547467526791041,0.7894211923396269,0.18309609582383557
8559,1744665198,1744668168,2970,2.0478791584414098,4.629537696461249,0.48447855073915136,0.15964621576051063
8560,1744668798,1744672398,3600,0.39951127265970743,3.1646428802857693,0.1,0.1
8561,1744672398,1744673980,1582,1.3317500757761596,3.8791223070242125,0.640187173204306,0.47889930476572695
8562,1744675998,1744679598,3600,0.34278776862503657,3.1786175009877677,0.1,0.1
8563,1744679598,1744681415,1817,1.8057121877951658,4.644961668463314,0.8761135428334581,0.380413964590957
8564,1744683198,1744686798,3600,0.26430285038385537,3.131921421285087,0.1,0.1
8565,1744686798,1744687580,782,1.2207025363544897,3.8638954030144697,0.33016647085904105,0.7633710512525397
8566,1744690398,1744693998,3600,0.41342835468097117,3.083720883043738,0.1,0.1
8567,1744693998,1744694897,899,1.4249456671339567,4.04501554856071,0.2248160238614026,0.38273641544668346
8568,1744697598,1744701198,3600,0.19769269798511846,3.061295714203974,0.1,0.1
8569,1744701198,1744704798,3600,0.13988116020779087,3.1726255874691494,0.1,0.1
8570,1744704798,1744708398,3600,0.39262674213475823,3.0881646427706246,0.1,0.1
8571,1744708398,1744711998,3600,0.11402112904369784,3.031067746605706,0.1,0.1
8572,1744711998,1744713996,1998,1.6749241747582397,4.312956519610614,0.22691628585252827,0.5364182312917763
8573,1744715598,1744719198,3600,0.26072461798271324,3.035994042785791,0.1,0.1
8574,1744719198,1744720188,990,1.2470267792975718,4.18639689232399,0.2883090691522283,0.694141522002346
8575,1744722798,1744726140,3342,2.145736250169342,4.3073212524051545,0.14971336738337976,0.5569998392148456
8576,1744726398,1744729998,3600,0.14069463579798935,3.021176133919843,0.1,0.1
8577,1744729998,1744733598,3600,0.17443995276995664,3.1387394877670287,0.1,0.1
8578,1744733598,1744737198,3600,0.3786123337095658,3.1096304407410047,0.1,0.1
8579,1744737198,1744740798,3600,0.3065248868460999,3.052300355675653,0.1,0.1
8580,1744740798,1744741755,957,1.424883876981907,4.021289053041673,0.2727935818867282,0.20822863429054758
8581,1744744398,1744747572,3174,1.5809040141173385,4.336141600514045,0.5520951749000587,0.441010293680938
8582,1744747998,1744751598,3600,0.3663582265912604,3.0042552789975963,0.1,0.1
8583,1744751598,1744754767,3169,1.561618329059872,4.478216632205111,0.31184599907190397,0.4344194467097624
8584,1744755198,1744758798,3600,0.39460540133745325,3.1818725939719714,0.1,0.1
8585,1744758798,1744760489,1691,1.1338837780949602,3.9275712014426745,0.6259996039289561,0.7386323814727664
8586,1744762398,1744765998,3600,0.2085654276325311,3.197366517509508,0.1,0.1
8587,1744765998,1744767104,1106,1.1783207621906666,3.974702112851849,0.6954781756911088,0.5364829920449956
8588,1744769598,1744769704,106,0.6005127295677719,3.6636024652728048,0.892958379633543,0.7256605247704058
8589,1744773198,1744775911,2713,2.162229505453148,4.636636775983944,0.724669543585688,0.16558946491019957
8590,1744776798,1744779674,2876,1.8319634189454814,4.470103256283363,0.4751376665528835,0.6312482507165338
8591,1744780398,1744783998,3600,0.4267653359894974,3.185934901485817,0.1,0.1
8592,1744783998,1744787598,3600,0.3895109371423502,3.0678793954912056,0.1,0.1
8593,1744787598,1744791165,3567,1.558910251708662,4.615564669250421,0.37745574487647915,0.8262803576704977
8594,1744791198,1744794798,3600,0.4863918051650873,3.0137353953809245,0.1,0.1
8595,1744794798,1744795965,1167,1.1000261387842611,3.809932860809465,0.730799832282464,0.35682349025843796
8596,1744798398,1744801477,3079,1.527075879015507,4.601454835828219,0.7766377320771626,0.8567435790454216
8597,1744801998,1744803652,1654,1.2003728190435243,3.916744108540962,0.9691402431268558,0.14870068678244364
8598,1744805598,1744809198,3600,0.16372917290138267,3.0712580692084517,0.1,0.1
8599,1744809198,1744812326,3128,2.3037722238592826,4.582971846023152,0.6767750283786429,0.5927397021330136
8600,1744812798,1744813487,689,1.3859082658921063,4.015327589013034,0.17408928022213047,0.9987392764641355
8601,1744816398,1744819998,3600,0.3003422073372579,3.115194576504661,0.1,0.1
8602,1744819998,1744823598,3600,0.11950122857735238,3.1687942850905797,0.1,0.1
8603,1744823598,1744826273,2675,1.5927194097187112,4.548566665037524,0.6564305054297225,0.1301158249794569
8604,1744827198,1744830798,3600,0.3003880825284625,3.0413873893953283,0.1,0.1
8605,1744830798,1744834398,3600,0.4518325274277625,3.088420209868125,0.1,0.1
8606,1744834398,1744837998,3600,0.10051642501480736,3.1187819506815475,0.1,0.1
8607,1744837998,1744841598,3600,0.376259229847524,3.0985674828099574,0.1,0.1
8608,1744841598,1744845198,3600,0.3086866560204875,3.0007100264336057,0.1,0.1
8609,1744845198,1744848798,3600,0.1694609518652923,3.0442183365673343,0.1,0.1
8610,1744848798,1744852048,3250,1.7331955575051037,4.416982592314804,0.3569103744971066,0.5282071041395854
8611,1744852398,1744855187,2789,2.4423259776370045,4.69313146681419,0.49621354014027486,0.5889676416537685
8612,1744855998,1744859598,3600,0.24334703894996632,3.1812936453121554,0.1,0.1
8613,1744859598,1744861488,1890,2.1429978088467343,4.4506195433628,0.10514670076948918,0.6778346797679008
8614,1744863198,1744866121,2923,2.2255375366945938,4.30084005158471,0.10054975589867936,0.37918664804795044
8615,1744866798,1744870398,3600,0.25896676115648015,3.0190335519763343,0.1,0.1
8616,1744870398,1744873998,3600,0.3408897046113012,3.1103963636088334,0.1,0.1
8617,1744873998,1744877598,3600,0.14963742349513823,3.0960885501001596,0.1,0.1
8618,1744877598,1744881198,3600,0.29312823819083955,3.1726304138469676,0.1,0.1
8619,1744881198,1744884620,3422,2.1703092267361987,4.572488495525494,0.5477113310900203,0.5308027205665959
8620,1744884798,1744888398,3600,0.21984003408044597,3.1275031347000057,0.1,0.1
8621,1744888398,1744891068,2670,2.044904687883591,4.57849716453898,0.23998872029102086,0.7755264951347145
8622,1744891998,1744892811,813,1.4812656612702055,4.090709583296884,0.7659724098230327,0.41142323958841465
8623,1744895598,1744899198,3600,0.48037250628026573,3.058296235124861,0.1,0.1
8624,1744899198,1744902030,2832,2.042701983721725,4.303595478951249,0.38828050494758826,0.7654803513461286
8625,1744902798,1744904702,1904,1.6158698556970328,4.346904067429907,0.3229616903136421,0.7575807822565584
8626,1744906398,1744909407,3009,2.229094404102808,4.38199507755285,0.10318200895705656,0.7320840805310321
8627,1744909998,1744911690,1692,1.4422480739084962,4.1634194575839585,0.9348456952086109,0.4558419865220882
8628,1744913598,1744917198,3600,0.12386193425754564,3.052753274128035,0.1,0.1
8629,1744917198,1744920234,3036,1.8540008039783535,4.328070056543404,0.8109223459947881,0.5784051835500075
8630,1744920798,1744924398,3600,0.12202524318762716,3.1415806933576813,0.1,0.1
8631,1744924398,1744925725,1327,1.266287492037097,3.806689318891358,0.7307762622021884,0.9732824822802258
8632,1744927998,1744930947,2949,1.593515059548932,4.556993798808397,0.5890061486838891,0.24595774374040952
8633,1744931598,1744935198,3600,0.19577402984525705,3.1099262078036918,0.1,0.1
8634,1744935198,1744938798,3600,0.13034918722060207,3.109410017981296,0.1,0.1
8635,1744938798,1744942398,3600,0.3785459989202524,3.056220958055718,0.1,0.1
8636,1744942398,1744943251,853,1.2111879272324453,4.144218633153703,0.9430266501359668,0.2672339606611523
8637,1744945998,1744949598,3600,0.2606443782913888,3.1723716183638397,0.1,0.1
8638,1744949598,1744953198,3600,0.3513187512777757,3.012503138310688,0.1,0.1
8639,1744953198,1744956798,3600,0.3398752342895136,3.111777475231794,0.1,0.1
8640,1744956798,1744959774,2976,2.207541002127868,4.335975617430714,0.24766450643253818,0.8839098936546257
8641,1744960398,1744963998,3600,0.1442236097834404,3.0040422972780005,0.1,0.1
8642,1744963998,1744966776,2778,2.4248245841003553,4.569693955848817,0.7714365291298603,0.6569258307589582
8643,1744967598,1744968009,411,0.6396130009108141,3.6962119420550668,0.2891310587753275,0.5323393883233658
8644,1744971198,1744974798,3600,0.2329744379767653,3.1911055849421626,0.1,0.1
8645,1744974798,1744978262,3464,2.493673720962583,4.478069941162807,0.4754312162511378,0.5288626486400098
8646,1744978398,1744981998,3600,0.10873516284544715,3.063267579212749,0.1,0.1
8647,1744981998,1744985598,3600,0.46260366854877477,3.0461693379696637,0.1,0.1
8648,1744985598,1744988381,2783,2.137477191403461,4.579270100556378,0.5567740673550433,0.27794555425611966
8649,1744989198,1744992798,3600,0.4683135085303064,3.07357645004064,0.1,0.1
8650,1744992798,1744993140,342,0.6842658921938229,3.436091817403074,0.25758458764238756,0.8932432545801701
8651,1744996398,1744999998,3600,0.2767317261256039,3.0333423952456093,0.1,0.1
8652,1744999998,1745000247,249,0.7551740174519458,3.3042390329933866,0.6301515473130257,0.3745842134960202
8653,1745003598,1745007198,3600,0.4205982512164508,3.0982838918024083,0.1,0.1
8654,1745007198,1745010798,3600,0.49932698266831055,3.1452306388448505,0.1,0.1
8655,1745010798,1745013853,3055,2.2337491587778784,4.541970265783164,0.671679860378727,0.722792687560821
8656,1745014398,1745017938,3540,2.0553999519730457,4.6846500190705065,0.42397569836825855,0.5357458887902402
8657,1745017998,1745019084,1086,1.0492075310491633,4.146192566271593,0.9775286080735544,0.5233758572251739
8658,1745021598,1745022643,1045,1.4137839189913857,4.158170367966523,0.2904782296535696,0.25212381074093815
8659,1745025198,1745028684,3486,1.6872339829165592,4.32083372855292,0.5500413727894128,0.3604599493553846
8660,1745028798,1745032398,3600,0.12947575606609402,3.0753448597373447,0.1,0.1
8661,1745032398,1745033601,1203,1.0493404764717746,4.1210891672368835,0.7525747449856349,0.9108436197221382
8662,1745035998,1745037765,1767,1.1982617952591208,3.8306324895129387,0.22601859572980404,0.9393312020086464
8663,1745039598,1745041406,1808,1.579103231831679,4.371288131774678,0.8306695352543396,0.7545267063772019
8664,1745043198,1745044923,1725,1.4498297794796342,3.9220907550968325,0.48829340673659527,0.4533252903152123
8665,1745046798,1745050263,3465,1.8598274110609725,4.4475422716817885,0.9457967849326987,0.7871852698853268
8666,1745050398,1745053998,3600,0.12047805743817724,3.1659387651320916,0.1,0.1
8667,1745053998,1745055309,1311,1.1663363352584624,3.9819249265502945,0.20762234815674566,0.8533218010739263
8668,1745057598,1745060292,2694,2.200727558604853,4.4411128179331625,0.9907119964783746,0.5591510674373752
8669,1745061198,1745064798,3600,0.44390815335905354,3.1626423384564575,0.1,0.1
8670,1745064798,1745067247,2449,2.4232247268598908,4.412111493314738,0.896899762719105,0.9253124900117985
8671,1745068398,1745071998,3600,0.4104970271210927,3.0486295670914143,0.1,0.1
8672,1745071998,1745075598,3600,0.1467706743827805,3.140453558123661,0.1,0.1
8673,1745075598,1745079198,3600,0.37959224745466313,3.1790459350139253,0.1,0.1
8674,1745079198,1745082196,2998,1.5687789786895148,4.376578998068607,0.7985835848050404,0.5743632664615275
8675,1745082798,1745086398,3600,0.1585587068933157,3.169216939449778,0.1,0.1
8676,1745086398,1745089998,3600,0.2237384881458122,3.1968428004486307,0.1,0.1
8677,1745089998,1745091362,1364,1.15802740751231,3.804733456077403,0.7743086152052807,0.7005731908483408
8678,1745093598,1745097198,3600,0.16416049683501868,3.063554346587968,0.1,0.1
8679,1745097198,1745100798,3600,0.42823901434771605,3.1610441276765133,0.1,0.1
8680,1745100798,1745104236,3438,1.8986902314335556,4.3879049566986605,0.8026025693181893,0.4364907207792048
8681,1745104398,1745106455,2057,1.9123081165797315,4.671408800014039,0.7469840373714011,0.32937568249351223
8682,1745107998,1745109857,1859,1.9690185062439065,4.616695762443467,0.216049935515143,0.43053525892218203
8683,1745111598,1745114996,3398,1.709315368097105,4.661331770413141,0.975286885960218,0.33222756732616393
8684,1745115198,1745118798,3600,0.4140266694082181,3.0334158665443844,0.1,0.1
8685,1745118798,1745120886,2088,2.0340528353312513,4.309552133246737,0.8083322705582936,0.6186759983839512
8686,1745122398,1745125199,2801,1.6941655968975828,4.316256158939671,0.10804247599078862,0.8932872739321087
8687,1745125998,1745127027,1029,1.4816452712624963,4.107567597249919,0.554317982941072,0.5916239828220382
8688,1745129598,1745133027,3429,2.3300359352637816,4.32920048730417,0.7847946796855031,0.12172682841988204
8689,1745133198,1745135080,1882,1.607680271694555,4.339126014534006,0.5781526164809948,0.6607792614784239
8690,1745136798,1745140398,3600,0.24050808014085356,3.0904856431813554,0.1,0.1
8691,1745140398,1745143998,3600,0.20746753782138194,3.0520062879032057,0.1,0.1
8692,1745143998,1745147598,3600,0.47144948442932977,3.0580840741590616,0.1,0.1
8693,1745147598,1745151198,3600,0.4507417583260531,3.143801622808237,0.1,0.1
8694,1745151198,1745152996,1798,1.3450655197498507,3.911037346103468,0.9209444387337369,0.42613502068568143
8695,1745154798,1745157313,2515,1.517335497860969,4.566424713565731,0.7100291771903499,0.7276524274564168
8696,1745158398,1745161998,3600,0.13868017117776993,3.118984297093948,0.1,0.1
8697,1745161998,1745165598,3600,0.24902651373586174,3.1190290664500835,0.1,0.1
8698,1745165598,1745168251,2653,1.8595919799495224,4.3457473960823325,0.6337741223311584,0.27922298094947673
8699,1745169198,1745171086,1888,2.0024622695051306,4.373003886166257,0.6434537099107122,0.1306118010934264
8700,1745172798,1745175022,2224,2.1602113170530255,4.402131606880658,0.3090856510882982,0.7391091554766335
8701,1745176398,1745179998,3600,0.1243788596361632,3.040850073604127,0.1,0.1
8702,1745179998,1745183598,3600,0.11984092626984354,3.1139068295550856,0.1,0.1
8703,1745183598,1745187198,3600,0.403526957729175,3.178255138979987,0.1,0.1
8704,1745187198,1745189470,2272,2.343699077185706,4.649049953585871,0.749885776125786,0.5681017569936537
8705,1745190798,1745192428,1630,1.0186870041223324,3.86488987207987,0.8930314006242452,0.15448230300845925
8706,1745194398,1745197561,3163,1.5264457842852024,4.624045439411888,0.7352617204763737,0.656792384736528
8707,1745197998,1745201284,3286,2.2919594538637815,4.512131149330379,0.4096934647709063,0.9996245386106113
8708,1745201598,1745203916,2318,1.6425993999047517,4.680514543193665,0.16921247471419043,0.8785466334479666
8709,1745205198,1745208798,3600,0.46791893082162195,3.037555622832029,0.1,0.1
8710,1745208798,1745212398,3600,0.17775211488909037,3.0747475024768356,0.1,0.1
8711,1745212398,1745214585,2187,1.7197171690316706,4.562427561827302,0.9647527024695605,0.4813405737877565
8712,1745215998,1745219598,3600,0.3215571479816738,3.0371322967571173,0.1,0.1
8713,1745219598,1745223198,3600,0.23763018213036766,3.1630997620507584,0.1,0.1
8714,1745223198,1745225885,2687,1.5096553551075087,4.4602186059570625,0.7756556588100268,0.3782771210936644
8715,1745226798,1745227198,400,0.59952648542584,3.554857958950242,0.7652214615363471,0.49371363781997146
8716,1745230398,1745233998,3600,0.2176610601748954,3.160657262460572,0.1,0.1
8717,1745233998,1745237598,3600,0.3322645801682358,3.162488409358174,0.1,0.1
8718,1745237598,1745240334,2736,2.428017032022712,4.69155216197453,0.47219624375443325,0.8790602511481809
8719,1745241198,1745244798,3600,0.451143866091255,3.1056843952501,0.1,0.1
8720,1745244798,1745246515,1717,1.4596661228152485,3.944897325815992,0.6757718028095719,0.27495199257283676
8721,1745248398,1745251998,3600,0.17472559056666326,3.152959711855947,0.1,0.1
8722,1745251998,1745253430,1432,1.1794319924250523,3.8722822072328515,0.7864632277560591,0.6439322202435902
8723,1745255598,1745259198,3600,0.4800747345466174,3.073710919580925,0.1,0.1
8724,1745259198,1745260254,1056,1.0691770504510023,4.185910667330573,0.2000420243760318,0.481083062690824
8725,1745262798,1745266398,3600,0.3251562408925626,3.1826844454449694,0.1,0.1
8726,1745266398,1745269998,3600,0.4246775942278572,3.1367271837058532,0.1,0.1
8727,1745269998,1745271789,1791,1.0465261699723833,4.117256962708465,0.8562714286379305,0.8790471052834686
8728,1745273598,1745277198,3600,0.15563207475423071,3.18356457817809,0.1,0.1
8729,1745277198,1745277312,114,0.8763874750833095,3.305523660410057,0.31920849575083965,0.791789649121562
8730,1745280798,1745284398,3600,0.17346665752307283,3.1681138053283977,0.1,0.1
8731,1745284398,1745285843,1445,1.2752148673875479,3.8713574747871635,0.8594736130606184,0.6701658832883512
8732,1745287998,1745291598,3600,0.15003028685394448,3.1363775789284487,0.1,0.1
8733,1745291598,1745295198,3600,0.3089464621197618,3.1340250497834363,0.1,0.1
8734,1745295198,1745298798,3600,0.4352949822422404,3.099665830772176,0.1,0.1
8735,1745298798,1745300602,1804,2.139424656607938,4.34023200144447,0.8065589358417109,0.6238979438109443
8736,1745302398,1745303671,1273,1.107416428154347,3.8504593356764762,0.5026863780615021,0.5075411715220772
8737,1745305998,1745309598,3600,0.3036935945588111,3.03147721049152,0.1,0.1
8738,1745309598,1745309756,158,0.9648157417710235,3.3356687347512284,0.8325767851858121,0.49228692351073244
8739,1745313198,1745313546,348,0.5039593246880592,3.5275750240953854,0.2822107964455898,0.34075267011022237
8740,1745316798,1745320398,3600,0.4035288712453,3.035071268357281,0.1,0.1
8741,1745320398,1745321123,725,1.0565168926851616,4.061529670312922,0.7154724797714782,0.7504650517172249
8742,1745323998,1745327598,3600,0.44897150980412903,3.0826063005269266,0.1,0.1
8743,1745327598,1745329003,1405,1.459119415713823,4.077599058064099,0.2061411157082477,0.6471773950127873
8744,1745331198,1745334798,3600,0.21285735053527455,3.167578111417595,0.1,0.1
8745,1745334798,1745336661,1863,1.645495958836726,4.393339521105854,0.11299658022428423,0.4187641402490885
8746,1745338398,1745340600,2202,1.6891946814969148,4.619968637795072,0.3124005045895507,0.1407810103226755
8747,1745341998,1745345598,3600,0.2263564327109458,3.125058770062927,0.1,0.1
8748,1745345598,1745346739,1141,1.1022556251825013,3.9662652893103623,0.49306928871382527,0.7323889443959946
8749,1745349198,1745351765,2567,1.8516895479730513,4.433815332503314,0.21670808759252663,0.11516918112362026
8750,1745352798,1745356398,3600,0.237321584289833,3.144975783281181,0.1,0.1
8751,1745356398,1745359998,3600,0.1890967454338166,3.029448363830874,0.1,0.1
8752,1745359998,1745363598,3600,0.29271305829297356,3.076176769666248,0.1,0.1
8753,1745363598,1745365063,1465,1.0234438754887454,4.068030836461298,0.7714649613237325,0.1184462683893424
8754,1745367198,1745370798,3600,0.31050780213421436,3.1053684333822003,0.1,0.1
8755,1745370798,1745371717,919,1.3782823877319077,4.14570488305284,0.5024725094347124,0.7736092503641481
8756,1745374398,1745375444,1046,1.0328749805879711,3.878298171136876,0.6569778824290743,0.5834204683097749
8757,1745377998,1745379723,1725,1.0903528639616127,4.097319256591734,0.9779431718302224,0.6084308320792939
8758,1745381598,1745385042,3444,2.214016360871203,4.351391920188773,0.6647770908665325,0.7544200197704244
8759,1745385198,1745388798,3600,0.11330862022944306,3.0606253789527664,0.1,0.1
8760,1745388798,1745392398,3600,0.4504336705090106,3.0962193948643004,0.1,0.1
