id,start_time,end_time,duration,power,voltage,priority_t,priority_e
1,1713890574,1713891051,477,2.6876872271204535,5.047489423898999,0.3664360843996757,0.8844842114135419
2,1713889014,1713889375,361,2.854155679521659,5.041883584922431,0.5278631805785527,0.9325202031549821
3,1713914634,1713914986,352,2.6688393698717157,5.381881741131078,0.27347806703824673,0.8825080307585875
4,1713913254,1713913622,368,2.841059149448379,5.204030718710442,0.6421835591677508,0.382895097953976
5,1713981294,1713981552,258,2.533113325178579,5.3478215009677275,0.8144762593701675,0.4225189804520749
6,1713965814,1713966316,502,2.9854333103157686,5.133078316668494,0.7176239109898742,0.3684190084730622
7,1714091694,1714091911,217,2.756361661847943,5.433941657482605,0.6773335838496877,0.688223316116766
8,1714092354,1714092871,517,2.774592525660634,5.16595071897467,0.8189270922913874,0.8452114933654293
9,1714075374,1714075623,249,2.629696882674876,5.431968143468217,0.2851490912878297,0.19754149882145697
10,1714061574,1714061869,295,2.744136879769085,5.151779432307149,0.23666223533703667,0.9328882361373126
11,1714155714,1714156279,565,2.717506135128702,5.327716683792496,0.10895365368707988,0.2175256505066326
12,1714161594,1714161858,264,2.6886515988433377,5.450836436817137,0.9495168557017036,0.5024649946078229
13,1714238214,1714238697,483,2.889022152766606,5.179020412731782,0.558763954395444,0.23238214360639634
14,1714244154,1714244527,373,2.749647851064123,5.364078294866928,0.5090474790290168,0.9275833908396767
15,1714232994,1714233192,198,2.680820823172487,5.235667960351736,0.13707646413214772,0.34527223509015437
16,1714224174,1714224692,518,2.8027941134181087,5.389741655534533,0.22991528021229116,0.49635134435267647
17,1714328694,1714329147,453,3.048536013772324,5.420176639276751,0.3921336731946473,0.6263298992315137
18,1714320534,1714320830,296,2.8209244879249598,5.483999534801692,0.11042957588799428,0.1397243521713974
19,1714318794,1714318978,184,2.8025130318539437,5.159274797401342,0.8187919822812091,0.8884593635903143
20,1714352094,1714352404,310,3.0576268285251986,5.114394024103801,0.5428793160465082,0.7590356859454676
21,1714418634,1714419108,474,2.969434136055618,5.356019145793369,0.7539745077700888,0.24467490116171892
22,1714505754,1714506256,502,2.992209495716316,5.092647719309315,0.5653560803018665,0.6328343168967734
23,1714593054,1714593513,459,3.0526918972227777,5.150109052134605,0.7430680566757216,0.6086241493637818
24,1714571454,1714571763,309,2.919037955673185,5.1339762451169015,0.5954394466638196,0.875200531675715
25,1714591074,1714591461,387,2.4887086703836516,5.192801348960129,0.40615336687268633,0.10897589076791159
26,1714609674,1714609989,315,2.844743173330335,5.238593378561965,0.1591561155889324,0.9016685397617655
27,1714660314,1714660575,261,3.114139222713394,5.420530450608242,0.7682308772650819,0.6768588382128073
28,1714689594,1714689983,389,3.122193641322309,5.0703122238633656,0.47985660266886454,0.8184385469268329
29,1714685814,1714686157,343,2.8368436450651,5.331348554066602,0.20638574254820144,0.22687674224431487
30,1714766694,1714766974,280,2.671301522251514,5.383204237322229,0.7469238730398968,0.14674817002607912
31,1714755714,1714756161,447,2.8794313487678007,5.04207335610421,0.7342379050829682,0.33609585398289227
32,1714767354,1714767614,260,2.8274734042317538,5.062592992922176,0.3085600786381574,0.6044669117563378
33,1714755954,1714756439,485,2.5939450388080227,5.185429280267717,0.36510093474069005,0.7591358112701505
34,1714847574,1714847789,215,2.5674675388636614,5.155528602582684,0.8676642833177355,0.7098282028323952
35,1714835994,1714836252,258,2.8051918104536346,5.363723338994437,0.53095735525942,0.9831272155367767
36,1714933674,1714933869,195,2.8904984925812474,5.2471048763881365,0.1297676239315487,0.1918279355675243
37,1714948614,1714949152,538,2.6700980145982363,5.160002790723494,0.47336973180614983,0.29415677763050185
38,1714918974,1714919160,186,3.1027885812561964,5.03272074484993,0.8940680043578869,0.3585160013900891
39,1715008194,1715008367,173,2.870932214605961,5.35319393038008,0.4496127513436958,0.23410766486846146
40,1715017254,1715017449,195,2.7677116741224164,5.217781508545786,0.5120450688797258,0.17994093594060795
41,1715037774,1715037997,223,2.883027726958052,5.2024963721545925,0.9327520619411673,0.9232937342704134
42,1715012574,1715013033,459,2.7811621330879923,5.483911064023103,0.4631726443932107,0.8600321186164649
43,1715124714,1715124988,274,2.7862954694554585,5.360194504743423,0.2334193456062148,0.1354672487358048
44,1715122194,1715122463,269,2.787434386005523,5.48342775192673,0.7322496648313231,0.49545243507546954
45,1715100654,1715101027,373,2.7649516605838165,5.1385936289160865,0.2759281303386959,0.9560002094256568
46,1715122974,1715123539,565,2.767552471683761,5.221724618639039,0.5575919072306592,0.7477051879098562
47,1715218194,1715218787,593,2.4877324300529304,5.495994334747345,0.29165666174440186,0.8385218952335758
48,1715195454,1715195965,511,2.688462031948637,5.487560467954222,0.1656506249824986,0.460482331516587
49,1715205834,1715206235,401,2.6489301333724087,5.074092758811123,0.8016210152174249,0.2646267422882026
50,1715277774,1715277930,156,2.579903832698058,5.264797562291468,0.2768263050162938,0.5270911378552248
51,1715280474,1715280795,321,2.919570617199684,5.272496158067895,0.6671373247736171,0.2488240614729443
52,1715288574,1715289002,428,2.8454648650913663,5.167835343811043,0.14507818301212252,0.9470944090142183
53,1715285034,1715285207,173,2.8263300347328117,5.336132370329985,0.7987145803623794,0.6610934894273052
54,1715368014,1715368423,409,2.7681368151956804,5.273321178867302,0.4215202810990003,0.2309957658842272
55,1715446374,1715446960,586,3.0958743227890295,5.04350593132143,0.26021643850226456,0.22085598525456923
56,1715442474,1715443029,555,2.6234041440243736,5.314484045458495,0.671375227874611,0.7568070689200112
57,1715530374,1715530551,177,2.7730569848029853,5.09654800474808,0.7639765561686364,0.6922285324915073
58,1715541954,1715542459,505,2.6843009044043775,5.0218311697365,0.6222341734350306,0.1046477106297772
59,1715611134,1715611585,451,2.9419415189011713,5.381625320877993,0.46783096722365813,0.7058567913206704
60,1715641914,1715642157,243,2.7488211790343002,5.477249400208764,0.3574460718606671,0.3957002459882034
61,1715624934,1715625297,363,2.79880392730481,5.153545694216059,0.3464662408927463,0.34440771567451234
62,1715708694,1715709095,401,2.665723657250715,5.052317473189032,0.5127768625358335,0.3303852360196603
63,1715734014,1715734443,429,2.7997697893473017,5.42548901616379,0.10539171716149374,0.37559785001000456
64,1715737494,1715737633,139,2.699900509893663,5.084925948402893,0.8453486666345353,0.46002959109590713
65,1715719734,1715719945,211,3.075451552347571,5.021308839041389,0.6487980562214427,0.6231857338589029
66,1715791314,1715791872,558,2.807060178804948,5.369525809028698,0.7124585708228599,0.32734657433709036
67,1715816214,1715816765,551,2.846985827127114,5.0485763077916985,0.9224088532013237,0.22635311530725727
68,1715780514,1715781073,559,2.751991369365894,5.227434625355059,0.5077483357465219,0.3342778635866811
69,1715891754,1715892056,302,2.7321126259894895,5.3838219400039335,0.4721702746837776,0.7674267251465103
70,1715898714,1715899312,598,2.9226853326014246,5.047313722336415,0.9192362292296902,0.4089605737261641
71,1715960934,1715961175,241,3.0172145529786567,5.163680505522451,0.5851173742335483,0.4784366752334619
72,1715997354,1715997832,478,2.9614258417755863,5.312811939241632,0.4573370403077186,0.6081884307249262
73,1715961534,1715961757,223,2.6892195227373157,5.178882805815823,0.24410097683318374,0.9520147091841334
74,1715956914,1715957203,289,2.601602937262245,5.349337411664729,0.44722658568501494,0.2430470576935576
75,1716084234,1716084561,327,3.059963937971259,5.125699348263061,0.4347551161947901,0.33984661445810094
76,1716060054,1716060546,492,3.0251047506915625,5.399711471246855,0.7800929817676617,0.7790208440752675
77,1716053394,1716053752,358,2.933900237212149,5.153949379780729,0.990436304710798,0.5394783596423555
78,1716156714,1716157221,507,2.9263172376982736,5.481117221946602,0.13710692992168516,0.2678218093427944
79,1716156474,1716156785,311,3.0275907580260872,5.343554819990581,0.2590127384737552,0.868771816141005
80,1716146634,1716147020,386,2.87437596428057,5.012054044808699,0.2542585805266322,0.15285893920897647
81,1716158334,1716158500,166,3.1508705299024125,5.308906312415357,0.6977135009136303,0.20669480829432013
82,1716232014,1716232518,504,2.8351851729060193,5.145950126346209,0.17478656539302362,0.22556004784330597
83,1716246894,1716247391,497,2.871597123661155,5.413099356506846,0.9738337446468147,0.32199457036244294
84,1716248394,1716248569,175,2.9699038490553735,5.444052222766212,0.4017256329698604,0.6720826920937633
85,1716322914,1716323405,491,2.5979151469890778,5.428709878905783,0.2146419319131309,0.9941220763077309
86,1716325014,1716325404,390,2.703379516413742,5.449753082022811,0.6972535083753506,0.9758536700352222
87,1716328734,1716329251,517,2.6561157441401484,5.02635271884444,0.8516525988334462,0.26180283191444986
88,1716417714,1716418281,567,2.7702117448196657,5.205785456752753,0.6452204693114366,0.18809056712820088
89,1716388734,1716388982,248,2.5537299357794585,5.3758523037698,0.9863258854491913,0.46157188608201516
90,1716396534,1716397084,550,2.7743922316362997,5.003185899990313,0.237811179702308,0.9044405136389534
91,1716414474,1716414685,211,2.54827971309439,5.190367699007203,0.32292974499866156,0.17921831827736626
92,1716475254,1716475651,397,2.927469379406956,5.057080301176233,0.673486349004071,0.9259570900641251
93,1716470994,1716471142,148,2.822449821008923,5.1955016409405355,0.4671361383393986,0.7569319855597885
94,1716602334,1716602883,549,2.996883876798822,5.16758259566295,0.10539021858532219,0.2589608925257051
95,1716568494,1716569066,572,2.7715692590986007,5.35373122704763,0.7925666222422078,0.43374402244841415
96,1716593934,1716594070,136,2.6787408076575283,5.372410961685128,0.42916569398110715,0.6946893753152312
97,1716665754,1716666115,361,2.8727531539543953,5.038230070427092,0.6206600881063336,0.6416761683915926
98,1716759894,1716760180,286,2.60600295983881,5.3433114788985865,0.934424735658397,0.48069300102055257
99,1716769914,1716770142,228,2.726339990498684,5.417713692458307,0.18546067830339036,0.4228632251392066
100,1716730614,1716731054,440,2.7072036789734013,5.434737642839098,0.8117679993638086,0.15968269346190073
101,1716757674,1716758080,406,2.659772698273196,5.442668875621035,0.807105881567598,0.9534008850523595
102,1716848634,1716849094,460,2.6869882790060404,5.215497322979846,0.6938261780821038,0.8648565317279392
103,1716818694,1716819119,425,2.8688399975983176,5.2295617801927765,0.2802985715888231,0.6741418332853505
104,1716936474,1716936621,147,2.885220272211707,5.087835767638601,0.11521303290812557,0.8503942547028492
105,1716938754,1716939049,295,2.972993335185157,5.054988641350061,0.6219631843481325,0.24754990208371724
106,1716928434,1716928782,348,2.7898472055410473,5.116982883749753,0.5680957644394836,0.9889850079321412
107,1716907434,1716907753,319,2.870821547561118,5.379124421391841,0.3686827869324061,0.9547443386870802
108,1717018074,1717018514,440,3.09830550646642,5.005784126901738,0.5802061126796942,0.9617337460021611
109,1717032654,1717032827,173,3.0389865712396613,5.01741126719063,0.34808050809395263,0.9931445044420372
110,1717015014,1717015138,124,2.8734995258060874,5.003540415913774,0.20896918856599897,0.49129845437705544
111,1717081494,1717082060,566,2.8173165576914228,5.4123233263404655,0.17300431418100876,0.21774655668943466
112,1717076754,1717077173,419,2.798273117094503,5.0902539985361885,0.6289481424815309,0.3892358515853305
113,1717177674,1717178117,443,2.9620785077918725,5.352202914740955,0.9426217495819855,0.6421303346375726
114,1717204674,1717204808,134,2.804960472170386,5.468289285297165,0.3544530001193189,0.18254979923053227
115,1717186734,1717187238,504,2.758335961184478,5.201111390225195,0.3011676544558319,0.5808598896884108
116,1717256154,1717256404,250,2.5483542406488273,5.313666639687012,0.6505244716584662,0.7971745772298008
117,1717369074,1717369584,510,2.6534872011341943,5.378780904156973,0.32540707825577103,0.3669451459271591
118,1717349994,1717350358,364,2.7163639018482644,5.397364016583993,0.423772910295905,0.1052477605362453
119,1717464594,1717464824,230,2.685856953337805,5.200069507045918,0.6075457468129108,0.9851176346118163
120,1717532874,1717533018,144,2.8170666055258873,5.141009604498296,0.8703886282461718,0.4941579041635008
121,1717513734,1717514025,291,2.7405018090837396,5.168007804355984,0.26434367205561515,0.756067323355652
122,1717523814,1717524391,577,2.7952101377858907,5.047407922802654,0.9200629021748521,0.5614694616676518
123,1717528854,1717529398,544,2.751484675768128,5.096412044847908,0.3570239940655303,0.6725671460489152
124,1717611354,1717611779,425,3.0051510447575986,5.043852588826985,0.4515752521659384,0.28656121134291457
125,1717602534,1717602701,167,2.862805070142009,5.140267893301843,0.4408342936967229,0.5101523301916868
126,1717617654,1717618193,539,2.7128541172054788,5.362461387847039,0.1719558428068037,0.10420174236466469
127,1717607994,1717608586,592,2.8684198081900862,5.2390699932831115,0.891662600935151,0.63509955077868
128,1717696734,1717697135,401,2.6761649800099594,5.0860341692253614,0.7118250784016092,0.6914428973323332
129,1717777734,1717777983,249,2.99164827287932,5.056256824409679,0.9271928431030123,0.9647794569135268
130,1717896114,1717896478,364,2.935112396096144,5.113070887518974,0.27225188732656147,0.36544017881210844
131,1717939434,1717940029,595,2.745431141877717,5.4652223650089145,0.6857624104546314,0.5812637985006829
132,1717939074,1717939544,470,3.154580199172049,5.043243088375568,0.8422099288308332,0.659375778869246
133,1717960314,1717960801,487,2.753094756194561,5.021658079928018,0.8585611729807859,0.9978456294470986
134,1718038254,1718038656,402,2.8072591440621735,5.4317593602041985,0.412120661438249,0.6481570901199847
135,1718026734,1718026954,220,2.85271661949082,5.4744464647791,0.2260696326635718,0.37742659503741105
136,1718041554,1718041736,182,2.8332360864735238,5.152755001692492,0.5021311132025882,0.337782515073225
137,1718148354,1718148935,581,2.946364796463548,5.235271220990018,0.9541636279619318,0.6880360773426265
138,1718133354,1718133915,561,2.6512443008050077,5.021042200886027,0.5351451411099519,0.583298861471615
139,1718116074,1718116284,210,2.6608945400841257,5.016004073108714,0.15812314975372432,0.1718534733368976
140,1718158014,1718158198,184,2.8147009228971047,5.398623769081965,0.7837343251635652,0.9657693489689175
141,1718202714,1718203293,579,2.8109531242248225,5.347399758737446,0.543436275182773,0.8480338055379383
142,1718329434,1718329575,141,2.5644670595698136,5.211509683249186,0.9371512123906532,0.8590440428274388
143,1718286654,1718286973,319,3.0620509345710603,5.410953944765893,0.13365649755176517,0.6594816551366158
144,1718294154,1718294451,297,2.490550230308514,5.481297179208369,0.2830162286990971,0.5880869111423622
145,1718380734,1718381072,338,2.887703511273152,5.200803223503856,0.7937242237414627,0.3464073592112895
146,1718415054,1718415643,589,2.5816639689717995,5.166095389764209,0.9719861841495762,0.8468692638485554
147,1718395794,1718396262,468,2.689691527238795,5.328578712197616,0.18716332421771556,0.7646876643429905
148,1718461794,1718462206,412,2.9840732251948503,5.071043927528011,0.104013165286759,0.6705390966734764
149,1718461074,1718461196,122,2.9060914255231807,5.0243010979621365,0.9824287154309504,0.6583693805542429
150,1718465754,1718466303,549,2.9723195094075106,5.3145190828597055,0.4686792317833538,0.18603773015585517
151,1718473314,1718473869,555,2.9264227601212713,5.047573309942234,0.9771100214491856,0.28105163443353376
152,1718585694,1718586218,524,2.6221015370584797,5.338919447966674,0.8927315507587811,0.7610965060966233
153,1718566614,1718567145,531,2.8550575663479973,5.328951925006669,0.6318708375847752,0.8776996454777639
154,1718566254,1718566560,306,3.0010078140741614,5.326525218813358,0.6935128445742234,0.2773639918615377
155,1718653554,1718654032,478,2.7832311303504094,5.011970332627552,0.6287578739430609,0.691280989984668
156,1718675214,1718675611,397,2.8584846120909093,5.000665963515506,0.6036203679127808,0.1648020336586924
157,1718747814,1718748393,579,3.1423265228438138,5.01812599233789,0.1818242338765608,0.3477052600087236
158,1718848794,1718849367,573,2.9454079490305363,5.38130224032645,0.9229015606698303,0.6106332922898093
159,1718816574,1718817161,587,2.986381141808691,5.490963599684328,0.5143340481505803,0.8803286151921967
160,1718849394,1718849753,359,3.1532797502755545,5.0826571219472605,0.10867084324177806,0.9712297076168168
161,1718933634,1718933941,307,3.082356602491324,5.200023906514433,0.169700546818716,0.3406299394291684
162,1718889234,1718889647,413,2.6078938399686136,5.119088201563526,0.5252458350762335,0.7988171672898435
163,1718900874,1718901114,240,2.937031062906947,5.136694259589654,0.5581959821691801,0.3086736115453532
164,1718918274,1718918560,286,2.8412782060761335,5.456145715237281,0.7650413458222477,0.3228173179542331
165,1719005514,1719005680,166,2.720946291053087,5.116932835079389,0.649855397278496,0.43337491554192886
166,1719018474,1719018767,293,2.7410687587328546,5.241746241000068,0.6127666206643,0.9091496534368493
167,1718999394,1718999700,306,2.960001932425091,5.393047959138344,0.8027929928076452,0.2969534659737445
168,1719085314,1719085891,577,2.907563654298512,5.477445409333278,0.2730495368071743,0.16653372749026665
169,1719082794,1719082953,159,2.9945153785401635,5.389083560866445,0.9784049752747525,0.6150212843012188
170,1719074754,1719075123,369,3.0476494338752618,5.209112651244695,0.7931803572373942,0.44633725937325686
171,1719169374,1719169513,139,2.990728870502753,5.276584388043228,0.3579060446759278,0.5039138275164213
172,1719246894,1719247345,451,2.916576082732887,5.089029872934739,0.7908332737035886,0.15872387156860832
173,1719264954,1719265437,483,2.8973849848843396,5.21130540838004,0.16437285232871826,0.8290170007535601
174,1719357954,1719358165,211,2.94045414867194,5.076723595018419,0.3911940260383464,0.3854103674389464
175,1719336234,1719336516,282,2.9653551521773465,5.397243603383856,0.12122678910168737,0.5877701552153725
176,1719413574,1719414091,517,2.6738353967887876,5.025305906046833,0.637975096822799,0.17118867517139463
177,1719418134,1719418694,560,3.132962142576605,5.054649404650213,0.639514714990706,0.7432114893346085
178,1719408054,1719408552,498,2.6871028785256805,5.3535882676067015,0.1847219535837613,0.5370981791975208
179,1719437394,1719437579,185,2.7736237822860352,5.182675534147652,0.785343000918536,0.5029673430073672
180,1719495294,1719495464,170,2.7289446260209163,5.347991225583132,0.8651388400427856,0.3020479478821787
181,1719529134,1719529671,537,3.066247461743638,5.298589732581881,0.46034770913502265,0.9055265366809431
182,1719608514,1719608995,481,2.8469356734855427,5.177713400547164,0.10672847339016708,0.7761583215520707
183,1719626994,1719627453,459,2.9073199672576315,5.341105626577382,0.6643988895756829,0.4067199818560512
184,1719605274,1719605546,272,2.8663609420295293,5.11714589341764,0.8562681608294792,0.9515414158348374
185,1719708954,1719709122,168,2.625137701684262,5.385296386911203,0.2111721853599204,0.40652254914490127
186,1719754794,1719755381,587,3.020947504802698,5.021192720267213,0.8330858997171855,0.7622108252902762
187,1719764514,1719764943,429,2.841336109739899,5.482199123500983,0.7261556145779762,0.7174235751310616
188,1719756834,1719757388,554,2.678057802529018,5.105076078273437,0.43874275502288707,0.9285630769361951
189,1719760614,1719761036,422,2.8413775845782716,5.3158702877467805,0.8000692790944678,0.594704619915831
190,1719856314,1719856547,233,2.7105593775742056,5.142230403480722,0.931686656584658,0.8909369904564547
191,1719873834,1719874329,495,2.7192193454020948,5.141759151106271,0.7611512710575302,0.7961155769028591
192,1719865554,1719865985,431,2.762522979991943,5.190134943897453,0.5906163310410572,0.3315812960384491
193,1719959394,1719959877,483,2.8491158921799498,5.222953456696175,0.42686699895101243,0.21451559790123992
194,1719971274,1719971426,152,3.0827466418350844,5.2126279982671155,0.5913321107035528,0.8997897787136595
195,1719937914,1719938136,222,2.8466285016484383,5.155371511300196,0.3661808109641511,0.27577323530746045
196,1719970854,1719971281,427,2.5229718307993614,5.046549524852182,0.9236744384544925,0.2713849692530485
197,1720040394,1720040619,225,2.8257352096332156,5.284595269933295,0.2277352182419699,0.6281721666829627
198,1720012434,1720013034,600,2.9479653655314277,5.380576322189501,0.798833669636054,0.947873011250758
199,1720046994,1720047410,416,3.074961403048024,5.049065495249672,0.945526966465341,0.7070345811109885
200,1720018614,1720018929,315,2.8434825633857947,5.330443940112281,0.8819953742777366,0.724430330175891
201,1720128234,1720128692,458,2.771952702708613,5.175203932788623,0.888101936021151,0.7791770986199924
202,1720143354,1720143557,203,2.8821430485109514,5.043947878384544,0.2267373471717535,0.6036789548639087
203,1720199094,1720199215,121,2.671498093398576,5.111173419715095,0.7275346088410938,0.5607892000215401
204,1720306434,1720306730,296,2.744496364746448,5.265839374603093,0.6436381099650998,0.8848019459438061
205,1720316754,1720317205,451,2.9916069136536643,5.017889971128384,0.3833699023534959,0.9988214799802722
206,1720296714,1720296976,262,2.8859389066236365,5.032780677135215,0.32058562168496957,0.37509366378841835
207,1720296894,1720297196,302,2.595533967466811,5.347241299752744,0.13247385294059408,0.42056874779906006
208,1720395774,1720396369,595,2.669971178822229,5.284421267392597,0.23272471649897317,0.9189611670888711
209,1720463394,1720463742,348,2.8350867888671134,5.043629048423742,0.9048563768462304,0.7216007292864077
210,1720532154,1720532604,450,2.953109549066088,5.457056087937075,0.3324230928805345,0.4809884884933069
211,1720627194,1720627624,430,2.9934553294856214,5.169359829608294,0.4155878403389178,0.42423589163128206
212,1720624614,1720624897,283,2.643583648544108,5.485676970091833,0.6096457888674724,0.5855879944390073
213,1720718394,1720718843,449,2.824815355859278,5.189345069952588,0.4571814173433001,0.5839432449045521
214,1720729794,1720730048,254,2.838578717995762,5.173467572616047,0.15291632244479803,0.4389341027674398
215,1720750014,1720750243,229,2.7979044186223274,5.1915565420548235,0.8268824061358581,0.9221732043714314
216,1720821774,1720822041,267,3.0012928651040234,5.095498531733334,0.13567325703497052,0.6708712100916155
217,1720824354,1720824754,400,2.766446521999774,5.0070798866177695,0.5580741588647922,0.7068795550357104
218,1720793514,1720793964,450,2.8034827803188596,5.228029528010371,0.4905748169138682,0.8357416188186731
219,1720913394,1720913546,152,2.7679455747428174,5.35860051282397,0.8839793721393855,0.36500860715018635
220,1720879074,1720879649,575,3.0300055213249553,5.149504839386157,0.6123070576827744,0.6512456709700954
221,1720981014,1720981570,556,2.6924822210496138,5.302521618724234,0.6245402374197951,0.48637959230297667
222,1721061834,1721062432,598,2.920094066586605,5.021925247356378,0.37331392570808253,0.4006642464335153
223,1721170074,1721170408,334,2.935183884123535,5.043184982972344,0.9367814124751938,0.9177213251573823
224,1721144454,1721144906,452,2.8464711470653077,5.103484393283288,0.9586871126604459,0.26852414663342483
225,1721142174,1721142403,229,3.0932092633574126,5.104586891310135,0.39935683792608023,0.9809683457862678
226,1721246994,1721247372,378,2.6448223184049815,5.415743015586441,0.39592650344964886,0.8291408172042569
227,1721238414,1721238638,224,3.123256547888754,5.112543754162165,0.5511431229015301,0.6293916519248824
228,1721233314,1721233863,549,2.853581255593119,5.416416988655429,0.9760332668612565,0.1278537422732333
229,1721326974,1721327186,212,3.0630708932049644,5.2974673710523765,0.6405361677286496,0.9717435547242883
230,1721311614,1721312083,469,2.7566636086436325,5.082562552983223,0.9286534750241514,0.19957397529619875
231,1721347314,1721347876,562,2.8734097720056395,5.350082195579448,0.978042538822663,0.8844021303208731
232,1721437674,1721438257,583,2.7999771198661625,5.350359684996666,0.7289807349886963,0.5470464969416873
233,1721417154,1721417746,592,2.7239535443784586,5.073759408371719,0.5802806238155783,0.20404801408934187
234,1721425374,1721425522,148,2.7929789545938877,5.044271531823083,0.9423335220691778,0.4462661961694443
235,1721438814,1721439398,584,2.94486673626014,5.04920231328676,0.3998714669454069,0.3564357195908521
236,1721495094,1721495581,487,3.012558612764111,5.437515228404759,0.5420289837011077,0.7116418767334508
237,1721499234,1721499399,165,2.710672729401727,5.302599092849068,0.30525710146178475,0.6489848697412952
238,1721612274,1721612584,310,2.7622238377638153,5.4782608473476415,0.8571894820551493,0.7134979984997053
239,1721682894,1721683336,442,2.8453996852924033,5.455285533696921,0.2919476784454629,0.15046112482118223
240,1721698194,1721698755,561,2.5652955836123894,5.178639161081766,0.47414500271022597,0.1642715829464571
241,1721742894,1721743052,158,2.8247904127979777,5.097732618968366,0.6359028663069326,0.6212773246809231
242,1721744934,1721745106,172,2.909941331614281,5.375634483803607,0.8520037245141783,0.35416152396262135
243,1721761074,1721761315,241,2.839462303919661,5.160475463354079,0.3017662935838538,0.5140280667609025
244,1721830734,1721831310,576,2.6862217779071944,5.2806151702342445,0.5763213426309747,0.5404236675440883
245,1721829594,1721830009,415,2.73204207815158,5.09650004608319,0.6195398116830043,0.7557733839672873
246,1721920734,1721921250,516,2.9966060865685127,5.301284244210705,0.9682139288087411,0.9525881385814151
247,1722035754,1722036039,285,2.8552845742451036,5.44688950745728,0.8346210663869746,0.40710300018616674
248,1722027114,1722027266,152,3.0489451629750697,5.300827678775989,0.3607046397874576,0.8347207570636953
249,1722033414,1722033956,542,2.67491292314644,5.271176945163946,0.40962134155365326,0.3202166886277223
250,1722013614,1722013813,199,2.958967065951718,5.2570280462812145,0.44441660137490824,0.5279584585549848
251,1722098274,1722098846,572,3.09732883263767,5.487358066047452,0.297768311735659,0.902204656166712
252,1722101814,1722102312,498,3.126293095092104,5.030828459861228,0.8766386504172851,0.8384860195951299
253,1722114474,1722115058,584,2.8850511307072826,5.116463206074813,0.7253687126085664,0.34314319855687847
254,1722111594,1722111995,401,2.6654121429405517,5.18875335685568,0.8501514375306967,0.7006576570490355
255,1722173334,1722173930,596,2.787091134348096,5.436106326207327,0.5858376812110822,0.3370159686493671
256,1722215754,1722215918,164,2.6866766075102433,5.01853829448616,0.4834790402844972,0.45572252905016675
257,1722175854,1722176053,199,2.7710322677405363,5.277586208336532,0.801617409523178,0.14505758789319265
258,1722213054,1722213388,334,2.6251522748345946,5.321885927091262,0.236806580008491,0.98591230725702
259,1722289074,1722289469,395,2.680021232415349,5.4660400824772335,0.9233650131507949,0.8978440503585872
260,1722276834,1722277278,444,2.698356699468125,5.420534605987514,0.36459921591046485,0.718727088491522
261,1722267714,1722268294,580,2.8035400471160883,5.498740138797187,0.9848388133998499,0.6962678986954809
262,1722348714,1722349191,477,2.956176488234596,5.120928517804447,0.46194207240587404,0.18468277644220843
263,1722351234,1722351711,477,2.7923338021563717,5.106453315163512,0.38785075765934196,0.17757588351540837
264,1722361194,1722361531,337,2.6924996303136854,5.162157761227878,0.6387307111652525,0.8527793005220067
265,1722443454,1722444003,549,2.955982890886245,5.471318998509176,0.25360421925114385,0.2619052841159837
266,1722455874,1722456093,219,3.036742528007318,5.07319274668351,0.832588672397776,0.9860153500935875
267,1722522414,1722522761,347,2.72084686833197,5.291502851657061,0.1350891535608418,0.7097619476160852
268,1722542814,1722542939,125,2.702314165008408,5.002411535991978,0.5367259944891603,0.45199006862503843
269,1722531054,1722531293,239,2.8639924171648317,5.294974750604592,0.483606548122577,0.7392689954491105
270,1722613674,1722614198,524,2.7782250616053936,5.454167595307451,0.63965595148646,0.11246386116683256
271,1722618834,1722619402,568,2.9813676908473,5.397001334059712,0.43367677849612196,0.318866164682049
272,1722619914,1722620111,197,2.7286538042168313,5.358227842199176,0.6814219062843627,0.7468888638724366
273,1722629994,1722630218,224,2.5690550024487915,5.071736653887528,0.5276943677453066,0.8014898088783149
274,1722710094,1722710598,504,2.7938911708872114,5.217816654722891,0.9028497547974503,0.20913424503120706
275,1722717294,1722717777,483,2.8242406918013967,5.368812408346073,0.3007360724507768,0.5698919490235225
276,1722720414,1722720878,464,2.6820065406872287,5.337272429165955,0.9255317141194486,0.8403179365421801
277,1722701394,1722701562,168,3.1299999613375453,5.369614622203218,0.5081501233010337,0.8915905887053753
278,1722786954,1722787515,561,2.893276214697276,5.002431547074474,0.33091371105762535,0.9247128697435445
279,1722780474,1722781001,527,3.05141241562779,5.066612647609945,0.5455173710534035,0.29667090747801816
280,1722884094,1722884267,173,3.0149655332526115,5.188846513179638,0.334692477441192,0.1641788798165862
281,1722881814,1722882208,394,2.715444578967412,5.405525710693966,0.8090757254066231,0.4494782687458513
282,1722953694,1722954225,531,2.8513281744090424,5.063211982408284,0.7533534364202076,0.5890736141435889
283,1722953934,1722954434,500,3.020491952257818,5.19758100949497,0.4346986016339096,0.9623321426591144
284,1722959994,1722960594,600,2.9071627928154955,5.429423009299256,0.349881062109623,0.7177487174148626
285,1722980874,1722981070,196,2.7303298943589356,5.092018619435088,0.6119630090804139,0.40095195608703693
286,1723063854,1723064403,549,2.9155168183983107,5.383203957521256,0.2931727359420466,0.6949421304574034
287,1723067034,1723067554,520,2.745292038391288,5.385553042183604,0.8440543432404797,0.485575314415717
288,1723147194,1723147502,308,2.6890060144680104,5.0923639668852445,0.6752077788407682,0.826561928012854
289,1723148754,1723149014,260,2.6616030570986013,5.001302803464116,0.13467947778339634,0.14223469373999756
290,1723247814,1723247990,176,2.701076502037468,5.095085274051873,0.3008625336588362,0.9911509177795166
291,1723213674,1723214096,422,2.7990674198018892,5.283018812526899,0.8243040975806736,0.26893564424105076
292,1723299654,1723300086,432,2.728176743769251,5.031496716582457,0.7642725318783512,0.6405630827930595
293,1723303494,1723303630,136,2.942638014714302,5.103444455461209,0.9612986412917196,0.41658583307415264
294,1723325154,1723325409,255,2.7038036071680476,5.235805424829343,0.5797689171628235,0.6090073179933482
295,1723314354,1723314874,520,3.078468529735502,5.436543085295108,0.13630246504359794,0.5281862243946581
296,1723382034,1723382192,158,2.768185182575329,5.256008848897755,0.6394488992172599,0.6642633374660434
297,1723404954,1723405385,431,2.831074734729442,5.251706229652913,0.6391983309203803,0.6704728717201723
298,1723486914,1723487085,171,2.609248044945898,5.052181078693285,0.13105788891950304,0.6441015055842303
299,1723513614,1723514016,402,2.486168062793373,5.208753191371256,0.7552901803502525,0.4609795006378119
300,1723475214,1723475483,269,3.0364727847838773,5.277240091101659,0.23627539004413348,0.41163870241210476
301,1723578774,1723579145,371,2.929064792314653,5.290837227498434,0.5445237378873273,0.23469821243189204
302,1723646094,1723646497,403,2.8158603122517825,5.325574736969078,0.8357017548642467,0.6981865417130109
303,1723687134,1723687270,136,2.7792776027224773,5.405372229255036,0.18957582557293381,0.4322544683827365
304,1723760154,1723760632,478,2.891098298782259,5.023152335358702,0.8069475107146392,0.25065204064323476
305,1723760334,1723760913,579,2.733316636653361,5.280257939934806,0.8249186051066142,0.9391899982684908
306,1723854294,1723854891,597,2.6352879699361873,5.380888598501761,0.6380516010528996,0.26046428378190656
307,1723830234,1723830525,291,2.7583027191968412,5.078482472494571,0.28779749451112335,0.2941526041827381
308,1723857354,1723857896,542,2.8402895874185896,5.022393300415232,0.3101351913309775,0.7814004421673643
309,1723943694,1723944225,531,2.9973132977711447,5.051672304151664,0.3846226954309079,0.9375872260241855
310,1723905834,1723906290,456,2.8249632600535266,5.193717422622611,0.8380452085755972,0.22539994235057156
311,1723903494,1723903749,255,2.7417717221363396,5.307521401163939,0.6704753061931109,0.5169766708542558
312,1724030634,1724030796,162,3.0048722357465785,5.253024733173614,0.7183140257252281,0.6186231442332587
313,1723990794,1723991191,397,2.8704503019646097,5.063740041259686,0.6884801589955244,0.5021520445493131
314,1724099214,1724099386,172,2.5894381463119376,5.369695173324245,0.325103724950618,0.9468677942211681
315,1724104554,1724104997,443,2.7841419443785,5.1279680319744925,0.9658053196735092,0.4571502984179332
316,1724107194,1724107420,226,2.602447246551987,5.385911192065225,0.641427509489116,0.9687395732266179
317,1724166354,1724166858,504,2.8861133066279345,5.481959895672124,0.6199351794791951,0.4719279040210733
318,1724188614,1724188943,329,2.6635227171055753,5.294453235965011,0.5532079602089909,0.8860105739672922
319,1724187594,1724187971,377,2.9360657026484502,5.476658446793341,0.8169813795320484,0.10463344357497834
320,1724285874,1724286224,350,2.6651871146553687,5.448490582307965,0.65436362431715,0.9213200208319045
321,1724374254,1724374795,541,2.785146060996777,5.122826593918214,0.7324779122743108,0.8403426171944657
322,1724360814,1724361362,548,2.739773534394097,5.398677577177706,0.4760029179229852,0.5162412815874418
323,1724420214,1724420489,275,2.487068894800829,5.32478773321857,0.892292267141454,0.9428365072174176
324,1724543034,1724543623,589,2.9008587719678665,5.068767018094894,0.11021289907692497,0.8986798802411727
325,1724628294,1724628741,447,2.917932528059803,5.201189275877967,0.8194370542666674,0.5779932732720953
326,1724633934,1724634231,297,3.0420080077514764,5.384330365551876,0.6388994929929166,0.32428281996904085
327,1724596434,1724596566,132,2.6006123596046797,5.004707389636853,0.5289761859384355,0.5144415431541078
328,1724701674,1724702269,595,2.9312460656971076,5.302032599931547,0.7333771053180514,0.8474157813564213
329,1724704674,1724704852,178,2.801647778533923,5.3540382019657,0.16022206601048045,0.8321791901817487
330,1724709234,1724709705,471,2.786437160999224,5.226116467994646,0.9166589427909754,0.70736680636275
331,1724712954,1724713105,151,2.8225302181874583,5.142242799249835,0.5578807524519956,0.49448924804683136
332,1724786934,1724787231,297,2.566134547217817,5.216240679879563,0.6864098721827759,0.8560241614665097
333,1724858994,1724859370,376,3.029245868295485,5.1381403371677274,0.6932386078347144,0.7080248987421854
334,1724882334,1724882779,445,3.0679681625383735,5.14838029570366,0.5217386441082215,0.6060359008821675
335,1724858994,1724859582,588,3.050693656253609,5.44305073201675,0.9602736365133824,0.18802329302418694
336,1724865894,1724866199,305,2.7071012250382283,5.45742483226557,0.5005545030143764,0.7997728453148846
337,1724975814,1724976169,355,2.673127927885902,5.171077904625286,0.5062453535523623,0.4827713267097795
338,1724955594,1724955912,318,2.939133755901595,5.385527042203512,0.5181584117390509,0.4637724793281677
339,1725032574,1725033131,557,2.635517863673372,5.243819231515392,0.47085116168538554,0.8242131025741687
340,1725039954,1725040160,206,2.599292205124462,5.316363105210604,0.12225406854804255,0.6401804046198032
341,1725128754,1725129067,313,2.837356178379081,5.304795513802784,0.9210209944224294,0.14287211351642676
342,1725125634,1725125917,283,2.6306665231775717,5.217478491324786,0.9175681705028023,0.5372493838118283
343,1725229074,1725229417,343,2.8071377530019554,5.4813902980025295,0.28725011211780105,0.6523764883271976
344,1725222714,1725222920,206,2.9746247719252645,5.287510199342433,0.8642218859714678,0.4281945946725342
345,1725310254,1725310582,328,2.936288576115071,5.296298464451273,0.2452444605036656,0.5199210558010664
346,1725397014,1725397569,555,2.9723361735803846,5.385671745594954,0.38486623232098116,0.9616608274747754
347,1725388614,1725389194,580,2.797251906656143,5.200214584070718,0.5566709505357601,0.1691847900446532
348,1725375834,1725376143,309,2.5338603514151776,5.487395978219765,0.4347891556842345,0.8914199883130353
349,1725401814,1725402253,439,2.8022109041015457,5.1032358839680665,0.2561243353645899,0.39053087559676136
350,1725472074,1725472427,353,2.8977811256495225,5.221865698153759,0.29055244056880036,0.2138357641788977
351,1725481974,1725482159,185,2.7690928317398726,5.171312743857463,0.440878263423769,0.38950775531963777
352,1725474354,1725474517,163,2.7798041274267016,5.43719699401274,0.31802511260379257,0.6753870385366226
353,1725488874,1725489302,428,2.685668386093116,5.0623124552424255,0.26824520824667397,0.49312073349805696
354,1725567414,1725567887,473,2.931491012122087,5.1226475996616765,0.34867563629460196,0.7438636234471848
355,1725578394,1725578583,189,2.6329004228087443,5.417786289171284,0.622912319230086,0.2432971824365769
356,1725574554,1725575110,556,3.1368553230165577,5.283002329160682,0.5240441436039577,0.5308214412903646
357,1725548874,1725549100,226,2.9166843993234575,5.307701618337761,0.47903355337675513,0.2151407839211833
358,1725656574,1725656974,400,2.480158428832434,5.149130213903014,0.49043962435244914,0.2225345794643147
359,1725659514,1725659954,440,2.6886335427753867,5.282172490072922,0.2775185234328873,0.9696720073779078
360,1725658974,1725659506,532,2.7790694930392594,5.188325128813564,0.5266128016835364,0.5019365279283863
361,1725629214,1725629337,123,2.8349514252083146,5.025626536390941,0.41951254634802726,0.7507677985044501
362,1725737754,1725737874,120,2.480048381063248,5.494656421078186,0.8034913166518723,0.6083887350278172
363,1725755214,1725755473,259,2.795409115151195,5.352907493782327,0.6299671354375689,0.37142874437230367
364,1725742734,1725743178,444,2.823021245428379,5.267809045943766,0.3852434929506229,0.9580118762430864
365,1725845634,1725845896,262,2.917027599507217,5.200649702540466,0.4363246161868125,0.5109092508842735
366,1725817674,1725817860,186,2.8154597190491257,5.238090839159092,0.9969975404827094,0.7101117868058416
367,1725818394,1725818656,262,2.838300990080192,5.12656775118035,0.8431279414030746,0.4519978733775678
368,1725921894,1725922060,166,2.869407668156618,5.267938496672985,0.42899564973862003,0.14465322216538196
369,1725924474,1725924603,129,2.850571564388906,5.035567515140183,0.3157901366500684,0.20762991625076413
370,1725892254,1725892577,323,2.7913552019054624,5.307292852888922,0.2405123673067186,0.9758524745776168
371,1725921954,1725922461,507,2.5713933265546824,5.470951755408935,0.24501343852869883,0.8895515082538603
372,1725974754,1725975280,526,2.548415509700332,5.139643454879237,0.6855393860536729,0.14990231169794094
373,1726014774,1726015110,336,2.701473925379331,5.094764491327092,0.6629752299025435,0.32772965048805314
374,1726019694,1726020273,579,2.880184207101991,5.178697680999002,0.30997629519225356,0.8660513327433473
375,1726101354,1726101663,309,2.9560459112213366,5.4672366438664,0.27748555608763814,0.7333239787026687
376,1726103034,1726103315,281,2.625665166597249,5.449378005783673,0.13103254987443005,0.47085030394760985
377,1726160034,1726160200,166,2.9277166023660217,5.168681818371205,0.539871207215131,0.1078600543489282
378,1726175514,1726176046,532,2.578728672106751,5.324031906853518,0.49230059438742835,0.5130264634559119
379,1726258614,1726259056,442,2.5510008236019264,5.345296198034937,0.3359109608844077,0.9378030108350267
380,1726343694,1726344131,437,3.072491902749396,5.409711007429121,0.21821424892471403,0.7879827730487857
381,1726331694,1726332219,525,2.9327197460787384,5.099846845335553,0.8887672390489907,0.47239960090790944
382,1726414974,1726415320,346,2.7575402366038633,5.118874768384843,0.6793711111595906,0.12093344539989652
383,1726445814,1726446069,255,2.521265799649823,5.106467002098084,0.4598693084281764,0.22975510508836444
384,1726511694,1726512090,396,2.9435109810131066,5.319139251473985,0.402030191495221,0.7579976513794711
385,1726614294,1726614692,398,2.929912766231721,5.394940581718961,0.709814088290211,0.3606407305183581
386,1726594374,1726594601,227,2.9670861222216405,5.096296418191796,0.8374494411377671,0.3234222128601209
387,1726594674,1726595145,471,2.6490047181744223,5.38053323206188,0.21239269126819849,0.26458084828834627
388,1726613034,1726613572,538,2.8040310255661947,5.414170081227822,0.8119045843584077,0.8112034849328781
389,1726682154,1726682581,427,2.6488601411256516,5.276516705633556,0.5622018875670399,0.5479663104889361
390,1726769754,1726770133,379,2.5936417860563186,5.407079833024558,0.5874619629888509,0.3415087329598959
391,1726780194,1726780609,415,2.602610142633911,5.116736455848681,0.3267039177335712,0.85923484295356
392,1726758114,1726758641,527,2.5260030552099004,5.18496966994618,0.5145146002960826,0.8056786544382304
393,1726786554,1726786931,377,2.5929714647274964,5.276661134091919,0.2826447636483903,0.9028678066328031
394,1726844754,1726845004,250,2.9293868782694172,5.1437907732368915,0.6269778708519563,0.45680422411159904
395,1726878714,1726879241,527,2.9177500675789942,5.10937668563349,0.6656385649009616,0.43692185140239237
396,1726845534,1726845758,224,2.7930300942312387,5.367981326218179,0.8731822990452911,0.6584057293911787
397,1726843734,1726844080,346,2.858229879743403,5.149886845394063,0.2646524204020861,0.1403984342520351
398,1726946514,1726946763,249,2.5690840508372554,5.403630147984927,0.6374399904236386,0.22702890320039673
399,1726943334,1726943486,152,3.1033367673126326,5.0881281409725165,0.7174546785587099,0.6153822367601666
400,1727011854,1727012037,183,2.524521997030095,5.031392744672282,0.3508642494523194,0.6970023706912517
401,1727021094,1727021281,187,2.597795712010501,5.169552583257728,0.12298693948660672,0.4829929993702642
402,1727137314,1727137623,309,3.1289553964231422,5.330123418604396,0.6802247138467965,0.9873463136107316
403,1727129814,1727130055,241,2.6038347987261563,5.495797579746976,0.3464887898667412,0.4047377562661968
404,1727124114,1727124392,278,3.053143548716981,5.007477775643781,0.7148385519312324,0.7495834278357308
405,1727143554,1727143969,415,2.769172671567799,5.205644612910583,0.19146140110677118,0.7269653865560615
406,1727201634,1727201824,190,2.6653448553219463,5.374534167168143,0.9866909612837581,0.4411933126378029
407,1727191254,1727191690,436,2.831007612470019,5.313370715725357,0.552139136671611,0.4534466161694788
408,1727214714,1727215182,468,3.0298742833238483,5.452250318155575,0.22960929651539852,0.4845560764057152
409,1727308254,1727308816,562,2.8663431306737523,5.23557440050418,0.7317523060880822,0.6910527809638608
410,1727280114,1727280692,578,2.847617481867534,5.18593266437055,0.5115941345218634,0.7431687142537422
411,1727381994,1727382430,436,2.935893219722207,5.020789497830098,0.7859817731106657,0.7960202001068092
412,1727377134,1727377531,397,2.770306538937353,5.40006271183952,0.4523680452854172,0.2231815413954336
413,1727448474,1727448967,493,2.712820670838757,5.152393314844161,0.4792768508179983,0.5068291590915929
414,1727529594,1727530130,536,2.5598581309342623,5.375979437921141,0.8062897233399253,0.5302805298414738
415,1727568114,1727568287,173,2.6116523318098146,5.4451661662764925,0.6787975570971363,0.8275573189024402
416,1727637834,1727638307,473,2.6918371530592244,5.268013315735892,0.592852308321826,0.16261285567291764
417,1727659134,1727659424,290,2.6296083261360064,5.092452783428686,0.5577923657189648,0.3845157871027145
418,1727661954,1727662300,346,2.570335944737656,5.484100016729607,0.7672629291622123,0.6169791643769288
419,1727616534,1727617067,533,2.935549726670808,5.031069429918666,0.9101759934349879,0.6345234291963381
420,1727739354,1727739732,378,3.0646845836748113,5.0814050042554735,0.9963011338424732,0.46091906428518814
421,1727712234,1727712802,568,2.833878962061076,5.49555005471235,0.5533280991577245,0.24834791629434075
422,1727728014,1727728326,312,2.9648588550169657,5.062655058792421,0.7536231562119048,0.6421736010935192
423,1727744274,1727744575,301,3.0443116728223067,5.11834574826521,0.7156796845816804,0.5952371563189659
424,1727792154,1727792452,298,2.682141070674789,5.110158347511074,0.20249113958974313,0.17448906470638925
425,1727813094,1727813264,170,2.805226766538793,5.257967960926127,0.17978661166677096,0.7435118963163115
426,1727881974,1727882248,274,2.762955929374366,5.432480106662922,0.39054083809178974,0.8629553555539625
427,1728005274,1728005434,160,2.6931796811737616,5.304675087472282,0.7575748041061511,0.9730718274240872
428,1727968854,1727969436,582,2.707701750512115,5.182795367440396,0.50588562135682,0.810977056435952
429,1728055674,1728056134,460,2.9238958357219715,5.095188866198745,0.4886679225866152,0.6310713126764506
430,1728068994,1728069576,582,2.8727367550063376,5.008124256727604,0.6866638184210117,0.5561347546291894
431,1728056754,1728056898,144,2.7250233843288365,5.047359500280532,0.7097056118393269,0.16419251516251532
432,1728078714,1728078891,177,2.896827686488597,5.171634341646954,0.17389859550632017,0.10132223430567713
433,1728137454,1728138021,567,2.75608359451502,5.26823517710678,0.39653476971236956,0.7732272061810121
434,1728144834,1728145072,238,2.8880576992381144,5.148616659328756,0.288635432303203,0.8294107577784288
435,1728258594,1728259160,566,2.6815377317483824,5.004665833454103,0.7249884473112226,0.5055487886227532
436,1728225474,1728225636,162,3.1192579298435903,5.37740085379222,0.11254238513449204,0.28655533310871695
437,1728323814,1728324027,213,2.8232739778243867,5.1519600928789435,0.9995378144953126,0.9259101859128058
438,1728348714,1728349221,507,2.7380597893624508,5.4958137384947285,0.379307400810604,0.9928629987949907
439,1728344814,1728345253,439,2.993809816311633,5.169604270654926,0.8758642522107398,0.15022228987096004
440,1728439194,1728439525,331,2.948984571897276,5.459025989948936,0.3575194448560963,0.7304453511874934
441,1728525354,1728525516,162,2.6499607382951282,5.4270238366202985,0.12602697965490794,0.7657389519113417
442,1728497634,1728497846,212,2.79811077890919,5.35007096378311,0.23679161832137877,0.5199608504633081
443,1728515814,1728516386,572,2.688138890546973,5.297265317952479,0.2491540228168777,0.6387902500874376
444,1728567714,1728568080,366,2.6788062419103613,5.3686360431640985,0.9213882837193483,0.24747561598619758
445,1728572574,1728573172,598,2.7356359208241754,5.358802409383722,0.38794738588136823,0.4432372032702282
446,1728569874,1728570117,243,3.170550127531296,5.0782152177504685,0.8194317743494693,0.7444892214487606
447,1728692814,1728693411,597,2.8366978947551624,5.059902939155426,0.472016592564812,0.4640792932640382
448,1728775674,1728776209,535,2.5907283938198997,5.273640807421073,0.6258522793392042,0.19681591199888776
449,1728749574,1728750079,505,2.7429536394531313,5.351373013844194,0.51787426428076,0.5543175838922976
450,1728845574,1728846019,445,2.853761582338733,5.002812902690972,0.6421108597099336,0.19034296441488888
451,1728844674,1728844974,300,2.747098662852755,5.110425505665927,0.17557565862512126,0.8052878693209541
452,1728922854,1728923450,596,2.893329952341903,5.0149533748833255,0.7389460291526198,0.3968903687975497
453,1728919554,1728919861,307,3.0859745834873635,5.361085343976005,0.4747934570015474,0.9854987792950903
454,1728928374,1728928836,462,2.6742576412360752,5.007242860754047,0.18914172681844676,0.7504071128223115
455,1728929454,1728929856,402,3.0482177646954787,5.328008392594939,0.6588632051936006,0.31074044746735796
456,1729018494,1729018816,322,3.018173884872877,5.290870988940625,0.5476997466348223,0.5406801062309005
457,1729021194,1729021493,299,2.9438238192265342,5.324160989562632,0.42592329037697785,0.7727438862414476
458,1729115814,1729116071,257,3.085292708689833,5.111808125859942,0.824751350500672,0.7049537723041598
459,1729178934,1729179281,347,2.79875450362404,5.178853550585879,0.23993030686554292,0.9322634372897285
460,1729192914,1729193088,174,2.5771503766205903,5.17088137436305,0.6673205264943362,0.9425593967633452
461,1729179114,1729179649,535,2.737593811954991,5.041102449263487,0.8281930936555439,0.6365437019176524
462,1729296234,1729296481,247,2.7199363091134936,5.056378143265713,0.40371973118309656,0.9658128092006314
463,1729344474,1729344648,174,2.546274026213677,5.436364946688265,0.7457241672813592,0.8645578552032558
464,1729460214,1729460347,133,2.9513512990164075,5.292647809264079,0.39598145050659905,0.1191206427578611
465,1729523874,1729524189,315,2.7193819587591825,5.197752230883727,0.3754812506594366,0.7152999737206895
466,1729516854,1729517037,183,2.882770188024411,5.4989057751059605,0.16891519212119022,0.3023925890423433
467,1729632534,1729632905,371,2.5486072500320534,5.416844898330431,0.8518340614603835,0.9206393394981185
468,1729728354,1729728791,437,2.904493634243038,5.014670227991274,0.9286899049998996,0.5402948218161229
469,1729730574,1729730931,357,2.8648049919259484,5.483968867986284,0.2716624336711627,0.11727078358901621
470,1729802814,1729803082,268,2.6649179939079874,5.190236514883806,0.7525121481304186,0.9570119624046658
471,1729873674,1729873814,140,2.9629964849535195,5.364638634537342,0.35706930102455203,0.9217266564765538
472,1729950894,1729951408,514,3.024153099746603,5.046451578005783,0.522499137489557,0.36472871607612833
473,1730051874,1730052301,427,2.846137347627507,5.184455018741031,0.8280003394954107,0.9685611916702129
474,1730074794,1730075302,508,2.928795323299023,5.132090972990886,0.16685235003116355,0.14216398791773888
475,1730062674,1730062962,288,2.662713355136188,5.184603591016628,0.8289582251108194,0.4329609943495436
476,1730134374,1730134768,394,2.802849575218347,5.013458465493063,0.3263034883543598,0.8566494935815425
477,1730155314,1730155810,496,3.0673878874276896,5.216849372582614,0.4610480196882729,0.5746605987492834
478,1730166954,1730167329,375,2.813743545330661,5.0850992139445745,0.4753486964164567,0.9678619620427471
479,1730212314,1730212578,264,2.855064902978499,5.225691239982674,0.6656234090198532,0.6197140171879697
480,1730213514,1730213836,322,2.728672692097713,5.3210310579765405,0.2199856328476204,0.2734807938997049
481,1730246094,1730246485,391,2.978607571789603,5.30372987143258,0.8883878888374538,0.5916721840081497
482,1730338074,1730338319,245,3.0325271675985688,5.168727818480417,0.24134553393052333,0.2859832253799518
483,1730308614,1730309049,435,2.5461987112823117,5.001223805311349,0.5149285629527192,0.6512626239646552
484,1730340654,1730340955,301,2.9938392805704637,5.343022192756,0.8534999820779511,0.8684183941090735
485,1730300874,1730301171,297,3.0136244934741008,5.132149542007116,0.7968880845804097,0.31100084172121367
486,1730387814,1730388187,373,2.8624496217851156,5.384858948693998,0.5754491189022113,0.3554072972875021
487,1730395794,1730396144,350,2.645734532407692,5.170046436035984,0.6329901215260979,0.5033033260234524
488,1730397294,1730397638,344,2.743766299594077,5.400578112412791,0.4086483686002267,0.17733101060675238
489,1730497554,1730497791,237,2.863578124068327,5.3293344937886005,0.14036318359777364,0.15252789759196805
490,1730481774,1730481963,189,2.891371445584747,5.060889877254191,0.5250265335059572,0.5092393259173911
491,1730568054,1730568212,158,2.659190421249801,5.155129747445792,0.48704259155535556,0.35685252634409514
492,1730683914,1730684458,544,3.029535824304267,5.335569805477369,0.9597640278188455,0.30079922120541736
493,1730663454,1730663629,175,2.8230206660948722,5.351063432557722,0.15699000041950809,0.15465405981921404
494,1730675814,1730676135,321,2.857555080316633,5.367977280906909,0.5350089475855724,0.5112993796210997
495,1730683914,1730684293,379,2.770907619931233,5.25845692035894,0.9601123438638731,0.9528554384106509
496,1730737974,1730738188,214,2.8688152477460065,5.251260577643802,0.9340961861955629,0.23605097627759197
497,1730728074,1730728401,327,3.0995619720854863,5.203990893591648,0.6651962680768948,0.46102061126754856
498,1730735454,1730735677,223,3.0711876512728673,5.235158417761884,0.442173852534396,0.3357234153381291
499,1730737254,1730737406,152,2.7556389252526947,5.487665447930549,0.220104187719117,0.566371583451244
500,1730819634,1730820119,485,2.549644677820964,5.0589284797237495,0.9364666697201899,0.16782200419009546
501,1730844594,1730844899,305,3.0830617110051373,5.351074124249097,0.4220282433508523,0.6240004429054508
502,1730821494,1730821873,379,3.0744390252062894,5.359468474507365,0.22762331539399408,0.344707257523274
503,1730903574,1730904162,588,2.8252435023137688,5.266144942567572,0.31945693845679385,0.8592821846129712
504,1730921514,1730921754,240,2.693425418265273,5.227866492533913,0.20204831540912271,0.4387289534496629
505,1730932374,1730932874,500,2.7626430180396264,5.130200395678393,0.7121729229730008,0.11335284703368693
506,1730924934,1730925170,236,2.775105188520311,5.083403879668477,0.9343197385247681,0.5727303137785874
507,1731026334,1731026515,181,3.1384130478459173,5.045924984875813,0.15953372654330056,0.49045892479086617
508,1731023994,1731024533,539,2.653742599823767,5.297382832962791,0.34044759066589897,0.5437329793162767
509,1731107814,1731108211,397,2.8137350059115604,5.038955625859589,0.7001834835656371,0.13505802560030694
510,1731204534,1731204664,130,2.4918073206609743,5.247829176123815,0.6798484855188389,0.10069631379458219
511,1731183834,1731184380,546,2.886871592103356,5.08849013971273,0.1752257235889128,0.8653517649966299
512,1731183534,1731183912,378,2.7346060098020444,5.4000705178667205,0.12079209964839616,0.6642937986084861
513,1731161394,1731161850,456,2.795666294425922,5.129399441874263,0.6595684066144472,0.9820526488809861
514,1731275574,1731276161,587,2.7047877195217325,5.059845018011816,0.2625929828300474,0.7403104371494588
515,1731289734,1731290125,391,2.4987252479669566,5.176188214947025,0.6690141778826326,0.23858187879756793
516,1731253314,1731253600,286,3.03675329765432,5.367989435259333,0.3378753127443572,0.19647412265408642
517,1731270774,1731270902,128,2.832407239550541,5.45796281051197,0.25403575995165223,0.6094692621308834
518,1731343134,1731343595,461,2.531179398062442,5.0230325107056,0.8420953560063797,0.8841180721428881
519,1731421734,1731422220,486,2.960197530301932,5.423951398880699,0.9926248657071086,0.6410964318398934
520,1731418794,1731418985,191,3.060068337518349,5.070352647907259,0.978910962977258,0.4989915423050316
521,1731443694,1731444077,383,2.8622618769879797,5.477587081179802,0.5899485122782295,0.3681872701454302
522,1731544014,1731544186,172,2.6112347586473343,5.049688247957287,0.9801212097877463,0.10068119178937635
523,1731549234,1731549572,338,2.7147962389793934,5.388009938165544,0.4634327190175882,0.940391171257402
524,1731533874,1731534102,228,3.149068528523971,5.1107011896698795,0.2136266134549911,0.8797347567674891
525,1731615834,1731616357,523,2.860855216377253,5.470205481722238,0.9735729718278422,0.41410389688415916
526,1731605154,1731605294,140,2.906278340271601,5.424669950691728,0.7434997303919754,0.6661514271029186
527,1731696474,1731696916,442,2.9931242427472693,5.199472698216154,0.2793923933270986,0.5376598410043488
528,1731693894,1731694258,364,2.8833916507502533,5.351462079490684,0.34895321395212775,0.47591246226118133
529,1731785214,1731785639,425,2.873213557000501,5.076163261046878,0.7437432341757998,0.14451850261116797
530,1731808854,1731809090,236,2.983827078816652,5.401762977831659,0.9312794360304758,0.756725338198719
531,1731803334,1731803592,258,2.950683237690391,5.442182505615263,0.646985237001162,0.20034354570125867
532,1731872394,1731872965,571,2.5942710057265446,5.120063840184464,0.3698474593184211,0.621423657784058
533,1731954534,1731955062,528,2.728927581955151,5.13433332530976,0.4075291193215619,0.5645592193867767
534,1732051794,1732052259,465,2.9861250760275992,5.031711721779871,0.10730768482410524,0.42153715595657837
535,1732049994,1732050157,163,3.005464400147791,5.15672211203087,0.7337692499009011,0.9985195879384505
536,1732123014,1732123585,571,3.1471052768335483,5.353241615322215,0.9451438708361328,0.7085807818024153
537,1732215174,1732215507,333,2.8510479251953913,5.328843672622382,0.8383381419522998,0.5838041313250386
538,1732216554,1732216706,152,2.730907329317502,5.363475819686311,0.301225259945709,0.5214212999819793
539,1732215954,1732216383,429,2.6557879745856323,5.484624611341326,0.14388456925263746,0.6227566542567656
540,1732217454,1732218047,593,2.5020077664857814,5.395223316332271,0.9239909658634963,0.2208539868479736
541,1732326174,1732326364,190,3.000656463045559,5.394155503401531,0.880069370020368,0.3733864610598956
542,1732286694,1732286971,277,2.7668714702104076,5.238892590571815,0.9206618801014719,0.3457385996652658
543,1732327794,1732328257,463,2.703886382538586,5.081265060143664,0.3701962417611675,0.9041282010640967
544,1732386714,1732386897,183,2.8878652857764795,5.023230838811465,0.23196050883784797,0.7382345426785396
545,1732484934,1732485098,164,2.7402596589903974,5.123184790581922,0.4120448175837582,0.5454270295757323
546,1732576134,1732576607,473,2.674002604205536,5.430736165082903,0.25732161469278186,0.7238940795142681
547,1732574454,1732574685,231,2.828761564174188,5.129033187271315,0.9480828954075847,0.20279159869750782
548,1732547814,1732548298,484,2.813981001482236,5.128164424143457,0.9068522241841985,0.881296305506945
549,1732632774,1732633373,599,3.036902101465979,5.0298300356138546,0.9330802418792878,0.6959732344967686
550,1732639134,1732639345,211,2.9969594285728793,5.3509562914276145,0.34873096583286656,0.5857000602229336
551,1732630434,1732630916,482,2.901636682762665,5.331926249272445,0.2802150081788209,0.8447329101755552
552,1732628454,1732628933,479,2.7451538638759403,5.166238636622774,0.5464479478111021,0.48541271727412727
553,1732741794,1732742273,479,2.9187799033224797,5.194604414437508,0.7203429229252754,0.623280235104162
554,1732829934,1732830113,179,2.676885185219202,5.038033757922376,0.3920722859288456,0.25400829506865874
555,1732802694,1732803128,434,2.94130300466347,5.215860203030831,0.5548200567504071,0.43409978230134616
556,1732930554,1732930831,277,2.6924208639552556,5.1244027799933605,0.35228207766417685,0.9997074947574339
557,1732908714,1732909184,470,2.7789894098182026,5.134751048371227,0.262774395694383,0.817279559901406
558,1732910154,1732910442,288,2.8208279791751685,5.349871101552263,0.8860432740949342,0.27537450812185116
559,1732931634,1732932180,546,2.7825486133057393,5.449243051375419,0.2790106445594964,0.11001821956790026
560,1732990014,1732990281,267,3.128785111715588,5.1263203705049385,0.37222187912634874,0.1631145881474933
561,1733012934,1733013349,415,2.934375597583022,5.451326445717095,0.47926730012819496,0.13935880552705301
562,1732982274,1732982703,429,2.714808380454095,5.297550169463236,0.2620547772495466,0.9418377096236151
563,1733015094,1733015552,458,3.0971121632146597,5.498404473412319,0.9342616501530187,0.4802406358562127
564,1733072514,1733073104,590,2.839561329952867,5.324704136265859,0.6332141331411836,0.24813720826745475
565,1733074494,1733075033,539,2.766384544586372,5.178410491442105,0.7739538428056791,0.37964742427188625
566,1733103414,1733103866,452,2.9417554795792094,5.190454515382986,0.7406849189136144,0.7630225072479293
567,1733099994,1733100459,465,2.846601268289145,5.482807757760622,0.81390626457346,0.2708642177268844
568,1733164854,1733165406,552,2.842588857996535,5.459484266892562,0.6498801318570414,0.5829460879088245
569,1733169294,1733169750,456,3.1170916597272598,5.138350560975147,0.10487380484147023,0.35008139467636945
570,1733174994,1733175558,564,3.1035615151053078,5.151890415265349,0.1328351292360085,0.7787724764387347
571,1733154654,1733154937,283,3.003485180389467,5.293764513693183,0.42904519633618776,0.16529217283603417
572,1733249814,1733250237,423,2.590313429967686,5.321486455046983,0.3365766971957096,0.7149855216105994
573,1733243814,1733244074,260,2.7021811072026156,5.243095570773279,0.7066617806915925,0.1812303358553661
574,1733333694,1733334270,576,2.725743007623744,5.145073914221882,0.40883448869312156,0.10129279609599001
575,1733336454,1733337043,589,3.0788257291731247,5.219718529712626,0.35646682827664744,0.7700908682311125
576,1733358414,1733358937,523,2.7602472227550794,5.030935270860998,0.795425122729407,0.9638609247068808
577,1733448474,1733448903,429,2.7479753243479075,5.464783307778626,0.10588284449298022,0.3110817742929829
578,1733491074,1733491538,464,2.500046682446955,5.076006243477146,0.10664086996392803,0.5442626270551046
579,1733490774,1733491017,243,2.9617067075336534,5.479406037099,0.13255862669735907,0.13505286571425662
580,1733503734,1733504238,504,2.9372144410524093,5.396267744683925,0.35925821205930897,0.9345938641225533
581,1733512914,1733513389,475,3.0353933081063356,5.089477115538967,0.8948143488872121,0.9651083975732566
582,1733610054,1733610547,493,2.690282561826062,5.083602623625234,0.8252277396339598,0.7294400103740991
583,1733669874,1733670195,321,2.9777047609255227,5.200017625954984,0.3008812840107914,0.4540009364043879
584,1733671434,1733671825,391,2.6096779197089504,5.403352964578224,0.2419207648500281,0.14517933184470005
585,1733702514,1733702985,471,2.7303137227406387,5.115395936399545,0.44924434826889004,0.846651784453171
586,1733688534,1733688684,150,3.108366860232191,5.025249486967713,0.6198206827334771,0.5662436360679016
587,1733760834,1733761201,367,2.834435671047065,5.1893722818741175,0.7137806627326,0.8600048682681277
588,1733791794,1733791951,157,2.8184772506938316,5.337413510096552,0.1286757926641765,0.36459862694418466
589,1733874594,1733875072,478,2.9900970916806617,5.0097000464367545,0.9857053399189137,0.20000588960017862
590,1733836434,1733836949,515,2.9697033519275386,5.323957751807203,0.8510329367779947,0.10099339670054502
591,1733864574,1733864856,282,2.778027085836986,5.053692701763901,0.3838394636190062,0.863144551556555
592,1733851374,1733851858,484,2.847527532140185,5.099412303066829,0.5217051579395517,0.5572865228682313
593,1733950014,1733950449,435,2.7132792708309004,5.36678880948226,0.2639086045207316,0.3147742106841087
594,1733935314,1733935528,214,2.6812969303318615,5.058089070366433,0.7014876726195168,0.9230138411359291
595,1734025614,1734025831,217,2.674887225916686,5.1462056843439345,0.8188542100709042,0.2328384501061566
596,1734030834,1734031211,377,2.5155891441850686,5.30456352500194,0.7775156209200158,0.8863591846758718
597,1734108834,1734109326,492,2.6652576788710487,5.274651130130504,0.23346097064654078,0.7874462808928884
598,1734196374,1734196671,297,2.895269406628088,5.1587844212101155,0.26609642381657544,0.10209169451381567
599,1734202194,1734202484,290,2.9279340438672925,5.1864062108675935,0.8563773031242815,0.9366567323201824
600,1734192294,1734192863,569,3.0839895632053236,5.259008570067316,0.3513455353186953,0.26098167502716596
601,1734299994,1734300225,231,2.6991612256361437,5.454476570621508,0.6586255464334574,0.1609445206768612
602,1734305274,1734305425,151,2.707786026430284,5.130497548495663,0.8567226810842012,0.3960942306367482
603,1734280674,1734281037,363,2.498624687220998,5.3355073904778365,0.5179023612704863,0.2909596139163799
604,1734290814,1734291133,319,2.946850085121848,5.305840173391588,0.47654875256692986,0.12482861445151605
605,1734391434,1734391585,151,2.9891100848684413,5.348608857922484,0.756780317322527,0.5882191542410247
606,1734380274,1734380634,360,2.95048272328916,5.428994500971318,0.5066920142916079,0.7440185633803327
607,1734392454,1734392668,214,2.9869731317357573,5.368308129812137,0.1470146215281276,0.250454841571593
608,1734393534,1734393713,179,3.175598049091451,5.424814099374898,0.73739108166104,0.5949229481066174
609,1734471534,1734472096,562,2.7140052279850497,5.132802282288141,0.8610661354429288,0.7855519400073626
610,1734472374,1734472762,388,2.775523074975579,5.0885764421509165,0.48334229190357647,0.2872744880843334
611,1734474174,1734474486,312,2.527948452662053,5.247071390169153,0.7769193335452351,0.13253245901443036
612,1734446214,1734446744,530,2.9372790099470625,5.12349603238481,0.16658471987914436,0.3069699778200844
613,1734539334,1734539506,172,2.95161933209583,5.109336080120847,0.8825103460353654,0.45046978709815955
614,1734634074,1734634416,342,2.7826869270142494,5.3279015964982195,0.8910354190368973,0.3623563782035777
615,1734656454,1734656604,150,3.148168525902417,5.398574957740156,0.9433062483743534,0.19105720960519912
616,1734714834,1734715088,254,2.678594625391248,5.374990135778405,0.9298563766515799,0.8147448503364799
617,1734740754,1734741146,392,2.926719742974395,5.446259466567704,0.9401218486073909,0.8857092522541752
618,1734743934,1734744306,372,2.764634822393467,5.18493258449052,0.18147547040283568,0.35466722956166485
619,1734790074,1734790640,566,2.7350280560925104,5.274382944118267,0.7039539144611145,0.6377164469576869
620,1734832014,1734832204,190,3.0722337590892828,5.341578515115061,0.7811202381101275,0.5699100785636138
621,1734789954,1734790476,522,2.692426951420741,5.084614947278499,0.3586816601455879,0.8823058707117251
622,1734910254,1734910550,296,3.084650666320674,5.348252823508465,0.5395227791384394,0.5812084420607573
623,1734913134,1734913540,406,2.8248961973186395,5.059669918986,0.3651755094762652,0.7224952779721259
624,1734873354,1734873702,348,2.996245689814977,5.150513089340416,0.9089280561009534,0.9570695109321194
625,1734883494,1734883699,205,3.0474999296527727,5.470600647334647,0.40814306324525085,0.9564895839294881
626,1734995934,1734996443,509,2.7239371654234206,5.3256408486365165,0.8527781645567233,0.4105524666079212
627,1735001754,1735002233,479,3.1640238106179455,5.335455264234075,0.5806972001815575,0.2584830959646397
628,1734966114,1734966282,168,2.731929281375712,5.481768963466037,0.6081721673079841,0.8622459432390231
629,1734994074,1734994229,155,2.6635029366718186,5.003998534579273,0.6195770438436166,0.903729285398807
630,1735087734,1735088258,524,2.626602770808616,5.188915907894084,0.4322252889636261,0.6156277132316621
631,1735053714,1735054055,341,2.646017574544158,5.339337411191082,0.317043113875475,0.16308555284791607
632,1735084734,1735084914,180,2.5457035845346647,5.1674530614125365,0.3955276353184989,0.9778471723669306
633,1735047354,1735047722,368,2.970154057491415,5.330922197719749,0.9793278706108041,0.8743545391866538
634,1735138314,1735138608,294,2.8423830901276452,5.091720553535363,0.7337138828447807,0.4066016408926869
635,1735264074,1735264224,150,2.5921723186039474,5.096030809550078,0.6694743883849371,0.24548810418635353
636,1735263954,1735264466,512,3.0022570746385613,5.31768462303155,0.6248707871578313,0.15581354878019274
637,1735305234,1735305683,449,2.862332528664494,5.371579681055509,0.7407871153647374,0.35142998049196883
638,1735326714,1735327185,471,2.720514682641705,5.050359941833629,0.13831628466044293,0.3510107744228119
639,1735309254,1735309819,565,3.1659773684277415,5.0742859422290065,0.9734494829554015,0.6154326701731837
640,1735422654,1735423035,381,2.863024317752199,5.220299426904439,0.957339276363482,0.2163276988810963
641,1735521954,1735522127,173,2.7157249606433562,5.1349149470019535,0.8384923350241078,0.18465323915991888
642,1735478994,1735479349,355,2.653676611444213,5.18957988403541,0.681577816490938,0.8618239521716078
643,1735495314,1735495734,420,2.9345917486187036,5.157635520013421,0.5271999208992462,0.3150384566011445
644,1735503714,1735504070,356,2.8196299754269707,5.2823628877428925,0.5341855788445357,0.6303292030896647
645,1735566894,1735567055,161,2.983996031220433,5.272391801190901,0.13576920982578009,0.7736199967599534
646,1735594914,1735595438,524,2.6804549191529143,5.441778067922247,0.4577867739226168,0.3496226631937903
647,1735672494,1735672657,163,3.0409505145399973,5.4660665689214545,0.8926498354069214,0.21194507662418655
648,1735765254,1735765402,148,2.926942331028782,5.150488087123747,0.47598464005307295,0.36379836559303125
649,1735738494,1735739055,561,2.8007284394593666,5.468807764550575,0.820282169655678,0.34961950624465643
650,1735738494,1735739036,542,2.6783984266550536,5.0515879979815885,0.8788811499581116,0.25136404978477384
651,1735766094,1735766353,259,2.6289078706309734,5.205242734972371,0.5648690896171941,0.5159822638763019
652,1735829694,1735830041,347,2.692564809901215,5.186556372085489,0.2094034452259967,0.5266564807825798
653,1735860474,1735860751,277,2.812607896801233,5.000897512151102,0.5347582098871378,0.33985402364209316
654,1735919034,1735919226,192,2.695840204229588,5.296854161691595,0.9275800698514707,0.18208794144189733
655,1736025414,1736025943,529,3.073414927112907,5.477269044019479,0.43818304726409163,0.5468504219955476
656,1736023074,1736023427,353,2.7060436018737977,5.2400209262631465,0.8517176497600384,0.949608636880271
657,1736005734,1736005978,244,2.9194384495410572,5.039403038654689,0.7424017255589901,0.4952753463024189
658,1736116194,1736116381,187,2.9086817937571063,5.364238224778209,0.6795386325749422,0.9635531921395694
659,1736107554,1736107887,333,2.624284656937328,5.2174626141228355,0.3159152563963226,0.7799516129075458
660,1736191134,1736191257,123,2.7602178960322443,5.06777749063243,0.7716260673157894,0.7044201908145772
661,1736182314,1736182747,433,2.5925029944438083,5.444333653718067,0.3973881813200921,0.20677173033283514
662,1736259354,1736259580,226,2.9430115252295392,5.445346865443029,0.8523797377965756,0.6027968368656914
663,1736272254,1736272556,302,3.150121136522702,5.258984334898109,0.5061719124796134,0.8607589041292193
664,1736272134,1736272546,412,2.9691182099971654,5.483928712467315,0.7823082223408312,0.31245787756175364
665,1736362734,1736363121,387,2.6881372077621912,5.324996286044336,0.2771796004165101,0.10675406440229568
666,1736370894,1736371237,343,2.955535872441445,5.434118927093731,0.10931633628138752,0.6417033009727687
667,1736384574,1736384907,333,3.027013114708853,5.156751195135025,0.7365034465152005,0.711440155064983
668,1736372574,1736372946,372,2.782796232606644,5.1925833046202925,0.7284118136617205,0.3881433586708041
669,1736466654,1736467175,521,2.951887275676913,5.206017449888403,0.4385115935059618,0.532102075501778
670,1736431794,1736432145,351,2.7382140058597155,5.314531286079505,0.7222740696253409,0.46891328926286935
671,1736521914,1736522371,457,2.641513953367012,5.144547651836972,0.9965617634184077,0.6686050253148625
672,1736554374,1736554835,461,2.96393183182713,5.134990457988385,0.4612130238067752,0.7518145952816406
673,1736603154,1736603391,237,2.8220934780268268,5.393182368780216,0.7008167085470204,0.46042920477691673
674,1736630034,1736630388,354,2.713194703929771,5.054529210050392,0.9889139987631521,0.8641425073140475
675,1736628954,1736629162,208,2.7307878979236575,5.087159175827143,0.8221015365482449,0.10626670017324417
676,1736634954,1736635155,201,2.7595759558221253,5.191067168431122,0.6759745693207361,0.8768923653875372
677,1736703954,1736704100,146,2.5926621842519753,5.00054898476604,0.2756170248813862,0.8692699578615438
678,1736788074,1736788570,496,2.8763557487935207,5.036210222610732,0.5749411066401197,0.5732015566447128
679,1736817714,1736818136,422,2.6715720950373933,5.411226723413786,0.8734714888953228,0.9273611998934542
680,1736813094,1736813360,266,2.7591143774035225,5.026747845727876,0.2475590115432847,0.5412126822788326
681,1736904234,1736904517,283,2.9078489665916916,5.0749679347597025,0.9036681667270595,0.6837093550618486
682,1736896194,1736896728,534,2.7934524018436093,5.039045511446413,0.6331984251399841,0.12083228433405489
683,1736896434,1736896919,485,2.967583289130257,5.0858209898250255,0.9224009246806761,0.8176866117976337
684,1736898294,1736898832,538,2.769767406688377,5.1147164068334945,0.13113921427835531,0.5781113148928877
685,1736967294,1736967828,534,2.53391725693695,5.292398293396824,0.32514340486909643,0.13307896521602688
686,1736982954,1736983186,232,2.6866138036207654,5.4417312506040565,0.41838163762991765,0.5027500765742529
687,1737045414,1737045817,403,2.706700321867514,5.488281886642482,0.49458832165851074,0.46047989852267357
688,1737069354,1737069912,558,2.7467590333083414,5.0274649580651785,0.7024683657097655,0.905593331694657
689,1737042174,1737042346,172,2.8490676315491474,5.436505100225587,0.41525888951043055,0.3570309407444051
690,1737079914,1737080341,427,2.787007111816736,5.081160084665603,0.5213264389648996,0.41476201605059615
691,1737121254,1737121597,343,2.516537721056226,5.06536993489058,0.8176620591814593,0.11993164984479815
692,1737128394,1737128832,438,2.63728513829492,5.4627839061081245,0.8958958386970621,0.6184675766175285
693,1737246534,1737246951,417,2.834320061512629,5.336370441946564,0.5211476116047227,0.6012306092653459
694,1737233454,1737233733,279,2.6068591440432134,5.279070449131157,0.4566790186385995,0.15881733009849539
695,1737310494,1737310743,249,2.635146719677374,5.017886524116861,0.47971393700060294,0.6716634828456169
696,1737317094,1737317399,305,3.000449364326494,5.3444707045015605,0.29018989691526464,0.5939894301314391
697,1737292554,1737292757,203,2.7241195423193356,5.479024197727931,0.7655416218391137,0.7311005713205823
698,1737295794,1737296374,580,2.7091704174533686,5.262122763535396,0.9813609086650409,0.8189707910415259
699,1737386994,1737387547,553,2.6027365397376574,5.262676742456449,0.3909946817095411,0.7818358461749059
700,1737511674,1737511892,218,3.179861981489134,5.328691190110362,0.10541826256232151,0.3701356618353304
701,1737480174,1737480697,523,2.864800801624741,5.438737555471343,0.7459421236877354,0.5797033613428474
702,1737500094,1737500495,401,2.8234018268493104,5.020332328662344,0.8665750905904981,0.3256755457503215
703,1737492174,1737492327,153,3.0083535805406063,5.188239310688044,0.8641578216087827,0.7919329915940757
704,1737573834,1737574065,231,2.7652482159829614,5.448930479741275,0.3803306870944415,0.2781891923661704
705,1737574554,1737574749,195,2.8275417412591044,5.020848708390201,0.16928413367055029,0.6993127659084882
706,1737562314,1737562554,240,2.9075815271871024,5.04207481177776,0.5437816846830479,0.6981040200426454
707,1737561954,1737562231,277,2.6952387778389855,5.020279688025586,0.9309903126210348,0.5068619484512491
708,1737668694,1737668839,145,2.7930210042219565,5.030410405830247,0.49476805061809626,0.9059933023383517
709,1737728934,1737729527,593,2.8874345074394387,5.408560085715536,0.6932671326209496,0.3055961745171065
710,1737746994,1737747479,485,2.899053102735672,5.150746763130378,0.3682262822148129,0.7546722443507374
711,1737811254,1737811813,559,2.905510515002902,5.21691062780276,0.21078311751691275,0.7775175887208478
712,1737848694,1737849276,582,2.5277625890991433,5.3583647399986045,0.6554198141818219,0.4482246698247112
713,1737912114,1737912627,513,2.6840759962441814,5.312764649802209,0.4237253893816999,0.692501314930677
714,1737984654,1737984879,225,2.9659835191531965,5.083776392561161,0.20461908557180847,0.13152814381323064
715,1737998574,1737999102,528,2.9820286022807645,5.422929654230991,0.8471530725961068,0.27312094092656036
716,1738100814,1738101098,284,2.794566346596172,5.476626678943322,0.46411442395566527,0.32002793933064155
717,1738161234,1738161807,573,2.6768239324741074,5.3679610275392395,0.36338229391898047,0.15417475877459755
718,1738157274,1738157782,508,2.8797514187752244,5.1736863906981405,0.25163208738402876,0.25914873099039276
719,1738201494,1738201808,314,2.7177868015734807,5.312230638644247,0.40161201229190735,0.20718687899979293
720,1738248354,1738248849,495,2.7299020213027414,5.433231796354825,0.38907643406333514,0.37317596515934914
721,1738272954,1738273220,266,2.690467697057783,5.495521599942738,0.6505498505422792,0.40354933385315817
722,1738250574,1738250811,237,2.8197529073903453,5.433764927265827,0.2816729320745983,0.7343219292685075
723,1738250934,1738251120,186,2.821317918799389,5.116775702926187,0.19881409606125994,0.7437245952918895
724,1738346214,1738346476,262,2.567490453661604,5.130189973581741,0.6317116735462507,0.46656426847101795
725,1738330134,1738330431,297,2.978425729894216,5.374472056316062,0.4075285520233607,0.7595829100093984
726,1738342434,1738342612,178,2.992107817811403,5.4113022524738374,0.5910342921751539,0.43690944454874014
727,1738437894,1738438392,498,2.8129762603532926,5.3502468970137,0.24276896309971613,0.11235364185008848
728,1738423794,1738423993,199,2.560544480928053,5.3018263069011144,0.1602218576811922,0.7885486281187747
729,1738511334,1738511455,121,2.6041614922421874,5.094006313196494,0.8385610376413117,0.23707588066429952
730,1738592694,1738593057,363,3.1190595071067286,5.319542830557982,0.9790886410445521,0.8348297536846969
731,1738610094,1738610559,465,2.8821230578901975,5.386526274686114,0.4569478579311913,0.7653198684595506
732,1738711734,1738712252,518,2.8344375841178917,5.1774487518367955,0.8483520599382676,0.7524135576164033
733,1738695294,1738695431,137,2.9932044811436844,5.353417656015976,0.9624516614494751,0.7559669340144403
734,1738690374,1738690882,508,2.956156210672446,5.233356609988173,0.46601373584434214,0.4020062102593711
735,1738793094,1738793483,389,2.822915893530051,5.062456335906086,0.3640012186129915,0.7334909202196486
736,1738765254,1738765786,532,2.907084914774599,5.403501653560095,0.8025382185899177,0.17647872782334392
737,1738872114,1738872600,486,2.6607303627355368,5.189456951786889,0.9977290936438511,0.6930081083016241
738,1738856814,1738857110,296,2.77017246267291,5.213733741897255,0.8116187010137698,0.8673953978773188
739,1738851294,1738851775,481,2.8047481281230255,5.283751959579281,0.9203257365265873,0.5929737161078814
740,1738973394,1738973950,556,3.03640394650617,5.3461031526009055,0.6200110844052017,0.446667970078343
741,1738954254,1738954701,447,2.5915936079736492,5.1897903351733,0.5130516142735808,0.15987150389246121
742,1738952934,1738953412,478,2.8167169479938106,5.424103977093583,0.939729407917423,0.8555020570730553
743,1739026194,1739026469,275,2.873093271955489,5.459108612968267,0.8729108247385469,0.4442175811072081
744,1739060034,1739060580,546,3.099438880129521,5.140232779294617,0.8203634935670688,0.12182909957432791
745,1739028294,1739028465,171,2.960121750654743,5.2274794139787835,0.48396405034466994,0.32834543585849074
746,1739117094,1739117541,447,2.894869305149692,5.268534469207801,0.20239988765741215,0.6509152930041426
747,1739114754,1739115129,375,3.125086351927855,5.330232338998058,0.8904467100537843,0.4998233079066341
748,1739144274,1739144633,359,2.660372515653735,5.0516603800061315,0.9839775396524953,0.8238781320803209
749,1739146974,1739147152,178,2.8966236884594427,5.035180461159536,0.3443527969968473,0.4824476149299971
750,1739213934,1739214176,242,2.863050035353851,5.408743586298451,0.2188330218321546,0.8620695164022837
751,1739232054,1739232278,224,2.9481741279720817,5.399293950872326,0.15034041131809656,0.5716506197080499
752,1739217774,1739218253,479,3.047417462551549,5.203177944701196,0.7483792306337734,0.18376226372559407
753,1739285514,1739286029,515,2.873927878843549,5.496861778788993,0.5668322679910855,0.2516704330941252
754,1739316894,1739317444,550,2.6642485348676903,5.0370289808467605,0.31165509429709454,0.2371451314489456
755,1739299014,1739299518,504,2.9179625904990205,5.284859923292004,0.1707695463360187,0.20700283148152687
756,1739321934,1739322124,190,2.770820893150781,5.440347903644676,0.9375067444305519,0.6906507135452087
757,1739388654,1739388957,303,2.658128773191573,5.441999589316978,0.9982040471108237,0.922022460627392
758,1739395854,1739395981,127,2.8797615766780513,5.3903714923513455,0.8920227993308344,0.8954322686529319
759,1739405274,1739405626,352,2.8973684739847387,5.159540418242719,0.5842529490181034,0.6550351397399091
760,1739388474,1739388716,242,2.627165956810304,5.042439312488887,0.229058857965375,0.2495252970640635
761,1739453574,1739454012,438,2.7489755244776997,5.0371594029324385,0.5829125127378262,0.2992729106226456
762,1739480934,1739481205,271,2.8627869807871775,5.326025201648118,0.6273939554038678,0.9916996980317551
763,1739484954,1739485221,267,2.831529343760679,5.4552007480807,0.36770059005443656,0.3695681229815636
764,1739557194,1739557459,265,2.8303942158781563,5.27987043984837,0.27215462759730547,0.6176375913814449
765,1739554614,1739555191,577,3.1535532305055223,5.181955269958174,0.2742137327692156,0.9480616272821653
766,1739565114,1739565443,329,2.484463853643345,5.158126748920192,0.23153594009203604,0.8418049291314011
767,1739648214,1739648631,417,2.7184752956074574,5.251257280287698,0.8609313597915439,0.6008761926801184
768,1739638554,1739638791,237,3.1188958543667957,5.099066537272565,0.7502818004907036,0.4063545183561895
769,1739752554,1739753141,587,2.5828917554997215,5.241521402393411,0.8569517606783777,0.8565340646496008
770,1739750694,1739751278,584,2.8127259709067105,5.428928661805439,0.8167761827002247,0.8063713204106492
771,1739727294,1739727825,531,3.1107994947311473,5.242905429593784,0.538393203580794,0.7733895472544866
772,1739831574,1739831776,202,2.660330340648553,5.268175232898134,0.948615465462728,0.22485425361007283
773,1739820294,1739820500,206,2.5941898094446105,5.09780334884442,0.4181256655877401,0.3558113997117627
774,1739831334,1739831585,251,2.6507386586195767,5.389049500726012,0.8229958616722212,0.7279680454774011
775,1739913534,1739913769,235,2.94597885355786,5.490442441460534,0.9591839057966078,0.9553010001877048
776,1739888274,1739888714,440,2.5875775450082172,5.205540409946449,0.2611434142128976,0.20406757911891743
777,1739902614,1739903201,587,2.8394507851827027,5.426683591680391,0.21694092199631002,0.3235447482279701
778,1739926854,1739927153,299,2.9405252929024965,5.339289325178427,0.9421484327713452,0.3019548961860234
779,1739994834,1739995186,352,2.8337246798410916,5.252668343695931,0.6361574263129238,0.9989491708354226
780,1739971974,1739972539,565,2.8984493537618183,5.005375728299645,0.8462573339041024,0.8499841598650841
781,1739975334,1739975649,315,2.9161581974519177,5.443299343360093,0.6929017966089454,0.3088576994930248
782,1739980914,1739981236,322,2.684386055989841,5.437387817424925,0.20968592062245422,0.5822751660545106
783,1740081054,1740081426,372,2.9769755964139235,5.247169637114185,0.40441327418109985,0.6973114571680652
784,1740179094,1740179232,138,2.843286909376756,5.207244487420766,0.5528982405240948,0.8999582233073785
785,1740146754,1740147336,582,2.9865012337862407,5.201520838264701,0.8413389466302248,0.2424891888239717
786,1740147174,1740147617,443,2.902315570446903,5.361914895507771,0.15951254619862712,0.285447817146321
787,1740271554,1740272054,500,2.662202204046,5.381511966961229,0.48028701205147084,0.3648015054728987
788,1740230034,1740230299,265,2.689710476973958,5.462394960143584,0.7052143727168816,0.5576930202932917
789,1740321954,1740322149,195,2.7845973010304608,5.33134356728184,0.8540925029655345,0.7096698785715628
790,1740328074,1740328600,526,3.0553145088637748,5.327952287260552,0.41887401702388305,0.3039681256488387
791,1740347814,1740348181,367,2.8552967458883356,5.062349822969993,0.3026628202998342,0.19995790551581
792,1740336834,1740337130,296,2.718726856338982,5.441345814126661,0.7977445553196962,0.7407144964479265
793,1740412434,1740412795,361,2.962691969338808,5.167751860162892,0.54149062402472,0.5104241048545767
794,1740406014,1740406376,362,2.6883616638168206,5.206872650327193,0.2478626914771383,0.218172458446463
795,1740410934,1740411426,492,2.464717263445554,5.220981957607116,0.9642859295166841,0.7919077851689206
796,1740403134,1740403312,178,2.57478668075817,5.098656439334613,0.23952666470277273,0.8238904385214934
797,1740507174,1740507704,530,2.5195012518144604,5.282960182656934,0.9303625973958396,0.17998273422908584
798,1740508494,1740508618,124,2.617002273671811,5.079507161450767,0.2547035222609587,0.16204642428894728
799,1740504054,1740504531,477,2.847820401620276,5.496831748990235,0.7691433449064193,0.2743508338088674
800,1740511914,1740512261,347,3.0151422069221443,5.3945618100694865,0.42281207982322233,0.417841628697199
801,1740605454,1740605699,245,2.7472749952754896,5.175444948136153,0.17900068518714107,0.18845876051566882
802,1740600474,1740601008,534,2.785623455270461,5.4455364197706855,0.8789608537478141,0.598132738044414
803,1740687114,1740687659,545,2.675384643112691,5.2988385651731456,0.2760821767865681,0.19065855583285196
804,1740668934,1740669484,550,2.643011894735406,5.395331689416309,0.7493715989805172,0.49468963265180854
805,1740794274,1740794851,577,2.8655016489866934,5.073011717311168,0.5075150714402881,0.5771037298716528
806,1740778554,1740778748,194,2.8606562909791897,5.013408764035098,0.45287520930667147,0.5093198128092972
807,1740787974,1740788137,163,2.7306873525544213,5.01978570291591,0.5117405321596551,0.30981200459485625
808,1740794214,1740794359,145,2.8746333744318697,5.1583596747562295,0.5448978487413485,0.6700094235681326
809,1740841494,1740842033,539,2.8145766780056225,5.440043230698496,0.5937056211951606,0.6700757634706876
810,1740861114,1740861575,461,2.8149689388486077,5.3501798154487705,0.3004579760049799,0.27210147888869884
811,1740847074,1740847220,146,2.908059750391285,5.081332930082745,0.8403459741336862,0.12441735031214948
812,1740931374,1740931666,292,2.6254540247945655,5.077241293162963,0.10494298058140118,0.8866791105551689
813,1740927954,1740928262,308,2.8341573985733786,5.481943692103923,0.962286525097936,0.4631740383881857
814,1740941514,1740941978,464,2.788518439743025,5.249141747782949,0.2615674935100972,0.930557641270423
815,1740956694,1740957093,399,2.9002873650521055,5.297443695374668,0.25140782649884863,0.16302917626617852
816,1741015914,1741016140,226,3.114381773008573,5.45372690083279,0.184753597128785,0.19643014567430644
817,1741007574,1741007985,411,2.810181489171452,5.170017922163278,0.7064479757886872,0.10999250833830626
818,1741031634,1741031762,128,3.0427159797515753,5.099057744159052,0.8540894574178498,0.6715790734800318
819,1741104474,1741104646,172,2.8520868096795176,5.295137495042802,0.4583082499878982,0.7392929912896389
820,1741182354,1741182555,201,2.9624241670193086,5.063726110885636,0.5178262407665424,0.2019928432659287
821,1741199154,1741199465,311,2.8754451411072552,5.266695547193795,0.16184881466605944,0.6775658035898853
822,1741211634,1741212125,491,2.83518026582863,5.418452514397858,0.1441340893010568,0.19192136042217958
823,1741273794,1741274080,286,3.125803421116746,5.104983697788585,0.7526054905693169,0.3476689655305474
824,1741388514,1741388904,390,2.688247997406922,5.41177535729989,0.4872843804748874,0.33291411086458034
825,1741360494,1741360856,362,2.774328240249363,5.41122714176685,0.5562686681391468,0.6120023722794005
826,1741380954,1741381519,565,2.6343728665249984,5.233417634723044,0.30421053277396704,0.993377831330821
827,1741484994,1741485541,547,2.8593341637450425,5.143536993104262,0.2321161119258845,0.6943044684586867
828,1741553994,1741554226,232,2.8049511597275827,5.402185853442513,0.4077497597980174,0.1733222692714102
829,1741553574,1741554161,587,3.1265740880898405,5.110018218225992,0.3567882708828185,0.1443677616298416
830,1741547874,1741548183,309,2.894706668172634,5.1621415919827855,0.9097807782160445,0.7476216297248167
831,1741639194,1741639635,441,2.5167525825722006,5.409935257605162,0.3753808527506747,0.7407231766895603
832,1741656534,1741656770,236,2.919088970731972,5.330007816191689,0.270588332262103,0.597446069539397
833,1741622694,1741622930,236,2.580191126208081,5.308721685646678,0.47643148609543384,0.8785335784176723
834,1741651134,1741651589,455,2.9859635696521365,5.44538699659342,0.3870670393093689,0.33122412267167856
835,1741727394,1741727932,538,2.6123870516803356,5.49619609972707,0.8994836046976823,0.35369409007311725
836,1741733334,1741733493,159,2.842530274819445,5.203507506105486,0.6363337525978987,0.5434084370189751
837,1741727934,1741728363,429,2.8417575069709047,5.269027909737156,0.6159296725483305,0.5879221617467598
838,1741735614,1741735911,297,2.6082146338004817,5.445339522397019,0.8164884632057584,0.5189581949526015
839,1741824114,1741824398,284,3.0592455095567543,5.072159120791893,0.17290057953959037,0.9498851375281075
840,1741872054,1741872186,132,2.4665104188892504,5.099942531186373,0.3743054929118793,0.13612585944647626
841,1741913214,1741913813,599,2.629712514821652,5.234143761589201,0.7324720213378585,0.2572531414321766
842,1741886934,1741887525,591,2.786745257126801,5.126574183991909,0.9952877456342324,0.4248914640194952
843,1741998954,1741999429,475,2.817695286369571,5.479289215218887,0.6908817992722946,0.741931047295956
844,1741964454,1741964879,425,3.0156103561210066,5.072775936466233,0.5407681281467741,0.21664401721809343
845,1741989354,1741989916,562,3.11951517654427,5.016107352636804,0.7455643419698836,0.8336110658660257
846,1741970214,1741970567,353,3.0537312601990503,5.406097207985099,0.7655815648587515,0.42156357699174274
847,1742071014,1742071159,145,2.9877549154062857,5.331987225695504,0.2171471864319937,0.7562455611393586
848,1742173194,1742173541,347,2.682630874768032,5.064415716178507,0.5319775354147187,0.5753747311536564
849,1742160774,1742161182,408,2.6857542854084024,5.134917007303485,0.1694388235234835,0.33525014647684476
850,1742143014,1742143541,527,2.653459707686564,5.364358598760214,0.4379358436138433,0.9609725024285379
851,1742263074,1742263597,523,2.942054517293804,5.396489662103252,0.18724547837007516,0.41836954742085397
852,1742217954,1742218360,406,3.0773024228259658,5.112151654490539,0.5906482959878744,0.4983589445730653
853,1742235954,1742236351,397,2.998777441909284,5.434712764872473,0.22224880905317618,0.3015003848161836
854,1742249394,1742249818,424,2.6427730787289256,5.418619744852345,0.8147706116593684,0.6683320142719595
855,1742347734,1742348196,462,2.8475732958004674,5.289959123392277,0.9265163876735817,0.559110222908379
856,1742312754,1742313239,485,2.914972019443444,5.315753761458102,0.5365767631180526,0.42134382343863297
857,1742322054,1742322206,152,3.0354009132558373,5.089599623859455,0.16550750403861103,0.7565645068170161
858,1742406174,1742406319,145,3.070017794315793,5.080649588215979,0.8395075552104964,0.19040498515930027
859,1742429634,1742429931,297,2.767389693446643,5.345288009303572,0.17660049738778968,0.24974730529202477
860,1742425794,1742426236,442,2.7162288139056137,5.156177260295373,0.20766440286972038,0.9824404449018126
861,1742426214,1742426731,517,2.754498410539026,5.00196816439217,0.7273766986172662,0.44294994257904785
862,1742494854,1742495281,427,3.07350280636239,5.483546884008747,0.28539794895691084,0.6374768963890824
863,1742514294,1742514448,154,3.0655385596870275,5.337246385437293,0.6794812084172824,0.5046820845520343
864,1742605794,1742606153,359,2.864775196670041,5.133491670049266,0.43120899389934775,0.2717473110150149
865,1742590074,1742590343,269,2.647132027706188,5.039795147173081,0.2872678235895312,0.7183565567951097
866,1742606694,1742607115,421,2.706360393523101,5.307931371867747,0.9676664141070859,0.9421105552438486
867,1742609334,1742609933,599,2.7865153168311867,5.011691820486417,0.5460496175839751,0.6032754225233732
868,1742656734,1742657135,401,2.6167613077100746,5.487539911475724,0.2887955396464352,0.31735068647618225
869,1742665734,1742666131,397,2.7611753481680523,5.33151718396382,0.41073224784353013,0.8372445802074745
870,1742695074,1742695616,542,2.9375676941072286,5.26962164210276,0.8749127606676991,0.3082559190640549
871,1742663094,1742663522,428,2.762924743383829,5.304572771035002,0.36349502910303044,0.252363334865911
872,1742770434,1742770611,177,2.906203031473151,5.047591234561479,0.22944315242070684,0.913814867696833
873,1742740194,1742740669,475,2.63333871051196,5.447871176095688,0.9091245245844923,0.14465538228981578
874,1742744334,1742744915,581,2.564261666557955,5.242559214867191,0.7716807398793001,0.11698104474739263
875,1742750094,1742750320,226,2.791497045514234,5.233068395817885,0.7959728331564546,0.8770137961454411
876,1742823714,1742824307,593,2.8055489513675007,5.4660449223404735,0.2263123026051469,0.3775516881788429
877,1742866914,1742867513,599,2.605162978660501,5.367494936274981,0.9139030591211825,0.2420283368432542
878,1742862534,1742863093,559,2.8415523643952993,5.3314756718029255,0.21598642250127223,0.9613445597164233
879,1742946774,1742947123,349,2.946458400040344,5.49416688208474,0.7536081499253815,0.9611447170638785
880,1742914554,1742914728,174,2.7381207115098936,5.325679710794514,0.5984295676748251,0.5124074933473404
881,1742924274,1742924844,570,2.8655499486164198,5.162388468353293,0.332152827541308,0.8631533371131169
882,1742952714,1742953122,408,3.0627802471461547,5.205941662169209,0.19030829270150523,0.5391915159724312
883,1743003354,1743003568,214,2.8414744899691406,5.3417615668622505,0.6658997939960539,0.39879842746805894
884,1743006234,1743006733,499,2.594011380706716,5.118217304689574,0.6460584264805774,0.3863882126718612
885,1743028674,1743028848,174,2.642079210260079,5.247252555400244,0.1953680735594323,0.33559881368041083
886,1743017754,1743018309,555,2.7933096650344753,5.437210567553332,0.16202895150918034,0.14631720080795774
887,1743117534,1743117842,308,3.083730697939748,5.1601597264629975,0.2006674190408121,0.39442811380289977
888,1743099114,1743099528,414,3.059267174598895,5.4660819581809825,0.3169853076985555,0.5322801286775137
889,1743084954,1743085381,427,2.518086868959502,5.05614171345865,0.8026257463379339,0.12108718838277314
890,1743211674,1743211873,199,2.769413990853043,5.397628896778711,0.44455050915752337,0.19349224878143184
891,1743269454,1743270011,557,2.7975917211630956,5.02192687086287,0.11933069345791923,0.6664871362540289
892,1743270474,1743270691,217,3.017673854317731,5.495545752599802,0.18013416919635944,0.7540187379210334
893,1743267174,1743267331,157,2.649427822699062,5.498591152883892,0.7714366228881018,0.429459876791658
894,1743346194,1743346472,278,2.815457856629361,5.037526407743683,0.9370133172261588,0.22680026300612516
895,1743367074,1743367569,495,2.812895952538684,5.021840495326917,0.3377285178515966,0.104785325712314
896,1743430674,1743430796,122,2.6841721123821274,5.15062353882721,0.7662481813656781,0.49035425387508424
897,1743438354,1743438763,409,3.1065208148278747,5.467117948526166,0.26624127507168,0.20780403607263248
898,1743439614,1743440112,498,3.0386104425220513,5.227063411008444,0.2842829819711794,0.11451403030232161
899,1743446514,1743446734,220,2.6449988622403935,5.37685036463302,0.7718280664609516,0.43356639210459025
900,1743555594,1743556154,560,2.907474589016059,5.393110209946851,0.18099136727973014,0.4454288602484465
901,1743644694,1743644970,276,2.5623302804252006,5.280832977085045,0.44057684109472484,0.9905763006889867
902,1743600774,1743601244,470,2.623127181174064,5.228592933959589,0.5095206394216844,0.4453080315335406
903,1743604914,1743605180,266,2.725213408834715,5.377212466461283,0.10881011661110604,0.5637167206191733
904,1743732534,1743732926,392,3.030362777880356,5.165818176583236,0.22781507439901116,0.14030997978914173
905,1743725874,1743726030,156,2.488645616095926,5.274808716809851,0.426195561676172,0.7131063038106964
906,1743716874,1743717361,487,2.8607021864003723,5.200600012102446,0.33584171135418006,0.7435765639518432
907,1743693234,1743693742,508,2.81737493036486,5.4554571799915275,0.1305632275471775,0.3218589566859935
908,1743798414,1743798753,339,2.939052374291686,5.414450594144327,0.7515269441061365,0.255600643004504
909,1743784674,1743784993,319,2.7163018359492135,5.205876268058253,0.5389074168373583,0.9409999580708481
910,1743815394,1743815812,418,2.879908986442616,5.32523373160063,0.2663528769151161,0.8500941241581711
911,1743813234,1743813722,488,2.9638142328007855,5.465492340290999,0.7891087651933842,0.27821429247519436
912,1743904914,1743905266,352,2.974465959596773,5.416074992912278,0.428614484391155,0.8284332760095031
913,1743986754,1743986939,185,2.8474649787689152,5.174157584878707,0.7528597933353757,0.37399764848752715
914,1744058814,1744059293,479,3.006797444673768,5.1937410983662184,0.4244366496388473,0.5440671668387123
915,1744061334,1744061514,180,2.771554976066992,5.01510596838877,0.4790412443760459,0.631101042744421
916,1744130694,1744130827,133,3.028161087862081,5.053629222093576,0.7010307735539155,0.6035749344391236
917,1744121994,1744122482,488,2.620287982932916,5.140183399573589,0.38103768801976523,0.9824441712252417
918,1744120614,1744121161,547,2.8131092657935644,5.359323419588492,0.9919955675843455,0.9670682086769861
919,1744161354,1744161495,141,2.585247233422495,5.413194464680898,0.6059714493998863,0.296056272327893
920,1744237914,1744238510,596,2.89197600778484,5.002422062779058,0.8572321033239235,0.9276568943873897
921,1744227654,1744228126,472,2.948656104873815,5.487168748661204,0.972824253856966,0.7971781903613575
922,1744225554,1744226043,489,2.797892038181278,5.20696713780093,0.10735762118559031,0.7229902683972461
923,1744224234,1744224787,553,2.934424600261915,5.077378389089914,0.8110199754505045,0.3113378468485597
924,1744305594,1744306192,598,2.847658978074596,5.451399351076037,0.4903329669674258,0.6349807261079514
925,1744313574,1744313942,368,3.044823095762198,5.02389434889067,0.7169029901123434,0.6730029264514602
926,1744331394,1744331675,281,2.9177586302274263,5.407467304555928,0.11209491758602766,0.28373953062043517
927,1744304454,1744304735,281,2.7229469515706306,5.203184701094925,0.48284747625095314,0.551108263480816
928,1744379574,1744380083,509,2.6127478292266066,5.150467457621525,0.1571648237683958,0.562671633967293
929,1744399134,1744399481,347,2.8370083755456994,5.458589479970885,0.5149841983878255,0.367506309234224
930,1744399014,1744399402,388,2.8005937532810394,5.202056926096908,0.9379418722998906,0.5761785684622603
931,1744488594,1744488722,128,2.9398329002668326,5.42542777831409,0.5273812181997763,0.8991196939761141
932,1744494954,1744495335,381,2.7373801254211463,5.4571532965156875,0.9601222504108123,0.48870247245863063
933,1744485474,1744485829,355,2.725868663862548,5.159208197948388,0.5147761499877112,0.5610185208205699
934,1744471854,1744472002,148,2.7294738424562874,5.360360566561918,0.5312952334234478,0.9999244281489865
935,1744581234,1744581632,398,2.702283683299109,5.2660036338643055,0.4109965016149171,0.7672362502102217
936,1744554474,1744554905,431,2.84810007079199,5.39790524748181,0.25775840562049135,0.305906775668057
937,1744596114,1744596476,362,2.931082948221127,5.426219202457911,0.2775480207923513,0.972772167788841
938,1744656174,1744656651,477,2.7049798012605906,5.181219157555814,0.9864093430587765,0.10704402701300053
939,1744760394,1744760867,473,3.0320646914023395,5.153085101731284,0.7876542047404594,0.8218699498060673
940,1744737474,1744737909,435,3.0387103668041173,5.033408883845544,0.7922245317700414,0.7015463163122235
941,1744845354,1744845664,310,2.747736806138543,5.3193897071721965,0.12543751550372959,0.741849529441584
942,1744914474,1744915057,583,2.74661857641902,5.003715448256133,0.8143319735412965,0.1974875112774898
943,1744902054,1744902590,536,2.8643049268615344,5.300441561536452,0.9710999495319353,0.8457758148899748
944,1744910994,1744911562,568,2.637524963806795,5.026044576549011,0.15854308252130384,0.2803121677801174
945,1744910334,1744910876,542,2.8833842739584354,5.375097927157965,0.6392169904207547,0.15607863194470595
946,1745027514,1745027865,351,2.945241519146693,5.24827142980587,0.9278538991534864,0.763067106365089
947,1745100834,1745101007,173,3.0745805535036506,5.0916208967480445,0.4871907978681298,0.7135001615660479
948,1745167554,1745168056,502,2.6740632554231776,5.251129436433611,0.2933819116756451,0.25111429007331504
949,1745286294,1745286552,258,2.7570728861996314,5.461478995585176,0.7642362977864448,0.5609800538135022
950,1745278554,1745278968,414,2.723179399427349,5.191152334391572,0.4127562603570962,0.22541417839824626
951,1745343294,1745343522,228,2.763694288694276,5.310996469801064,0.8600679718547772,0.7944988178419318
952,1745368734,1745369272,538,2.956001109847878,5.058744194626338,0.12533711692833843,0.9388470459041057
