id,start_time,end_time,duration,power,voltage,priority_t,priority_e
1,1713919811,1713919853,42,6.250153002279904,3.873864399763675,0.37303796720272875,0.7541284257326137
2,1714013651,1714013850,199,7.328869139149855,3.778128501728038,0.24422408744402274,0.9009217582519842
3,1714025291,1714025460,169,16.167619708465487,3.876645575624508,0.39158627942126356,0.22512591806217797
4,1713986051,1713986111,60,13.001507859429648,4.186831451399115,0.43082933477467067,0.8094278870585135
5,1714054811,1714055004,193,17.407962183592268,4.07693656459204,0.7227077724671932,0.25446627013432466
6,1714141871,1714142134,263,7.942439650350369,4.871369011674138,0.4761435333896048,0.8013711969344121
7,1714204871,1714204961,90,14.238578475887048,3.42330118338347,0.32750380148490754,0.7214232167714119
8,1714270691,1714270975,284,13.863931844193536,3.317408277392356,0.42689499290033495,0.9405133458627575
9,1714341371,1714341602,231,14.27883759822353,3.6069077143924435,0.3191960964797905,0.21758261981329172
10,1714346771,1714346882,111,15.32686677389595,4.752334748490156,0.9502623916541495,0.2238567791843609
11,1714425851,1714425929,78,6.004827021194075,4.672858196048212,0.8232116227497445,0.32553965862350775
12,1714412111,1714412143,32,6.08330498409361,4.475459227725117,0.9786288946506874,0.6964538084915526
13,1714452611,1714452853,242,6.713633536233935,3.457341679092457,0.3443244730253895,0.2574800136360625
14,1714509911,1714510016,105,9.158973003564022,3.7693598071166132,0.7728191139663226,0.9008965575803829
15,1714493051,1714493268,217,17.82441765983492,4.072165303608407,0.30920335376985386,0.8121590586844541
16,1714561751,1714562025,274,9.508299219413907,4.481777222590008,0.7133596560496648,0.19090308976471515
17,1714589231,1714589530,299,14.393770668987425,3.900708823234628,0.4407228951668801,0.7200760904174784
18,1714633691,1714633954,263,12.3656609626278,3.343945778886322,0.4486571078490492,0.12058256123682297
19,1714690451,1714690648,197,15.305524428339059,3.351603300401812,0.807890983579326,0.36916611688121637
20,1714713551,1714713603,52,10.778329702662873,3.883478730650533,0.4825924207598349,0.2992013850130524
21,1714638611,1714638797,186,17.44960364356794,3.720532162851685,0.18571447842442335,0.779742032457655
22,1714775591,1714775868,277,10.767067519431059,4.164324150513738,0.6146366705394156,0.41614025501439356
23,1714762391,1714762479,88,14.61123139605931,4.746689744489655,0.7731052239578726,0.34979644888000644
24,1714754771,1714754889,118,15.926398045962635,4.447976183182697,0.2555631786933069,0.46279119448493444
25,1714831151,1714831394,243,16.41512083551723,4.615246035574822,0.5235402011390338,0.262538639479183
26,1714855271,1714855492,221,9.627591026310927,4.825148536483445,0.48767476080573835,0.1352859675722186
27,1714939271,1714939428,157,17.045523459778188,4.249003273509874,0.8648005775459231,0.23242050679958412
28,1714896131,1714896289,158,18.835335959496533,3.805623482117383,0.2203191080107834,0.8926652121620224
29,1714965971,1714966238,267,8.66029312358714,4.980864143833038,0.5686626697843568,0.2610396998922597
30,1714995071,1714995119,48,11.119033856648791,3.5586331624788086,0.402243019765283,0.197171263195973
31,1715075171,1715075205,34,17.398699002590085,3.3519724685757146,0.3465199460739265,0.8539303713083936
32,1715107331,1715107522,191,6.163703303894181,4.813446896421165,0.8993422023319549,0.654359823112038
33,1715229131,1715229290,159,9.730216335107869,3.973049231360755,0.21203340934559586,0.18343012842487025
34,1715156831,1715157114,283,6.452408228409471,4.5422021808308735,0.5009812156294677,0.6982920665968911
35,1715218571,1715218612,41,15.116302963898486,4.342138298405525,0.9669751061334297,0.5383302428770058
36,1715277371,1715277655,284,9.863289173411614,4.681433185670669,0.2355434970986961,0.8990031277120684
37,1715271551,1715271666,115,6.0482742586989335,3.6785125464893853,0.8048151133714765,0.21557541651362255
38,1715250731,1715250767,36,12.351431431187047,4.818634349054388,0.38656991051694134,0.9435812615209763
39,1715368871,1715369013,142,11.029321840091402,3.9284818686674194,0.5309644950151653,0.9809775112888792
40,1715376791,1715376995,204,15.194091186267082,4.634048982375168,0.6789738097476079,0.9972405636611207
41,1715349431,1715349510,79,8.529344974905362,4.827242123330294,0.18494686229190713,0.5567863988420879
42,1715473931,1715474192,261,12.02655009318913,3.922619427195539,0.13655696324239044,0.24947437624332522
43,1715422091,1715422374,283,12.114381271131117,3.845912343843909,0.2509400297503785,0.84442232578129
44,1715551271,1715551557,286,16.382685949782527,3.4580036143392108,0.8806425116937988,0.9600533558369917
45,1715580611,1715580857,246,8.777528178129689,3.5610712520250045,0.527083422585191,0.8072591961470416
46,1715618891,1715619134,243,7.569013818157082,3.92962387120721,0.7466667138943651,0.6145098974833016
47,1715685731,1715685945,214,11.80281052024316,3.8614829124999486,0.760305866073687,0.14309400943458755
48,1715766311,1715766516,205,6.051905153581428,4.263784761916134,0.14918945045514181,0.6044432259897173
49,1715792771,1715792991,220,8.272754651961977,4.265958603861388,0.2507479648759544,0.8387880363705716
50,1715888171,1715888342,171,19.955057175074906,4.841970515361854,0.6394697856512441,0.21405321459134946
51,1715875751,1715875963,212,5.197890626992095,4.107231011649697,0.6733838439970249,0.1446539504148596
52,1715934071,1715934104,33,19.30365653853066,3.447134349896633,0.7729206895987196,0.5961668832879238
53,1715982611,1715982659,48,9.274880645201602,3.739091136111254,0.13936003293360122,0.6064147951697224
54,1716081011,1716081102,91,11.515991902364377,4.2395500211079735,0.9188857314669344,0.3785205513440615
55,1716072011,1716072128,117,12.403893228569636,4.409688952748418,0.44869554017174185,0.46729777519201643
56,1716052991,1716053196,205,13.028566047989255,4.096484522832038,0.4465581443252462,0.52116177876111
57,1716128351,1716128409,58,7.218671348375306,3.918340593973247,0.8478192166647862,0.1687533091220916
58,1716169151,1716169395,244,19.436784116111777,4.17341600593536,0.48046192364366214,0.9780114402549079
59,1716194531,1716194659,128,14.02118605161208,4.378102447058793,0.11035349118400875,0.4425765075407452
60,1716190091,1716190308,217,11.114199406088469,3.7892585080868875,0.26490069936974137,0.6616403099201682
61,1716341351,1716341648,297,15.237281151614589,4.396680021368167,0.40070702104286493,0.21621518928547556
62,1716325331,1716325539,208,8.630018373549168,3.4479580188037295,0.49184195008013476,0.4039033529469419
63,1716383651,1716383826,175,7.5900950329929024,3.6080476056760657,0.2330839966200836,0.45912014323298833
64,1716437831,1716438037,206,6.117871371946175,4.758654774605981,0.17744168706076582,0.19129141236483263
65,1716477551,1716477825,274,14.773041160029335,4.498514265792702,0.8625690017465123,0.9015235113599497
66,1716595331,1716595411,80,10.395137060966729,4.782513372799653,0.6082936310914276,0.5753770059584338
67,1716582371,1716582467,96,14.361581457641929,4.691461754521071,0.26448945102612503,0.7215823342739001
68,1716561431,1716561606,175,14.620690844696163,4.799210175084429,0.5137322389490069,0.8594602019247929
69,1716628991,1716629233,242,17.746751250608206,3.9309337483717948,0.9731415517413046,0.7731847804489326
70,1716653291,1716653386,95,6.500019803454939,4.365428966850494,0.5868895979091188,0.5130311662179927
71,1716720011,1716720175,164,8.414832420056099,4.079576841979249,0.9619467353862343,0.9560864345778893
72,1716749711,1716749974,263,8.17607178913653,4.711867917822328,0.7709312655621758,0.8891089643002982
73,1716787751,1716787839,88,16.188395467460836,4.702539645735273,0.7200355460591648,0.6060786521766124
74,1716851051,1716851324,273,8.067580108875386,4.641070363399506,0.21015840319761653,0.7158111429869762
75,1716832151,1716832370,219,18.56796616960928,4.352657516421408,0.643406578268437,0.46995273033987683
76,1716851651,1716851853,202,12.525891314280996,4.242930403606866,0.5390113853747888,0.3310599174034037
77,1716905471,1716905610,139,18.891703361918527,3.5366441516049063,0.3822108118031502,0.6513592467016417
78,1717048271,1717048412,141,6.854278030781256,3.81537577891794,0.5838392575892557,0.36270507520993545
79,1717121411,1717121697,286,16.130026907928876,4.029511250798079,0.739098429612381,0.1097572694559857
80,1717125311,1717125447,136,7.403367641873588,4.688949378318826,0.5676510318383889,0.24689992915975317
81,1717197611,1717197738,127,6.4265797585228,3.8862173973750638,0.6787880709787649,0.20969015127004717
82,1717270331,1717270613,282,6.035946477841514,3.7823601796332866,0.8963734660487692,0.8165465924544552
83,1717261511,1717261732,221,8.864273211462299,4.666461276309794,0.6513030294603562,0.1485260511094909
84,1717345871,1717346113,242,9.206365065451495,4.833876308835869,0.42192278163998354,0.5717590285727112
85,1717396571,1717396690,119,6.614437838104932,3.545344362360101,0.44098018934733585,0.8472120061952926
86,1717409771,1717410056,285,19.51676661915964,3.90706153658952,0.30565558949432153,0.9506578425025717
87,1717464851,1717464927,76,13.906424683151728,3.738104360825216,0.4649589132463182,0.3163211820451907
88,1717453391,1717453565,174,7.9147458512846605,4.7436623276877015,0.8484922517572614,0.15433837133396874
89,1717521971,1717522083,112,8.35172302158133,3.4761017741391718,0.6155850140123171,0.5855801070061113
90,1717540451,1717540620,169,17.963841342225358,3.861224152833903,0.2529113232581597,0.6818529313551646
91,1717567211,1717567314,103,16.838476889421727,3.5670842201039816,0.18670979944393468,0.18666351195926628
92,1717634951,1717635092,141,9.929980956891729,3.4699522731607257,0.8699631110203828,0.7524386849414422
93,1717605851,1717605953,102,17.883810271963824,3.5431562450280287,0.31255677111719044,0.7491334822024321
94,1717663571,1717663634,63,7.718118981366113,3.9333927347156603,0.8081192328306207,0.5134745906258213
95,1717744151,1717744351,200,17.751290508160807,3.943950339218628,0.618042260244813,0.7970231057406499
96,1717803551,1717803753,202,5.369017939932943,3.8363867162318055,0.31214728575365425,0.6396388995516419
97,1717866311,1717866538,227,17.847140899638173,4.247772469192825,0.9251364932319381,0.8612086967011402
98,1717916711,1717916908,197,8.98539379974892,3.365176601618537,0.1185114816359387,0.9505838865003432
99,1717961411,1717961483,72,18.23128042280476,4.871062988724994,0.6552743471946245,0.9905718022204688
100,1717967591,1717967785,194,19.62635742212929,4.627246460089125,0.8184328305706076,0.35087373830831403
101,1717925231,1717925367,136,13.077864645509385,4.977266849402648,0.5559614756652935,0.6979550155715888
102,1718056331,1718056523,192,10.927369700858259,3.35185067965467,0.9226217526226484,0.5886236082703107
103,1718088311,1718088445,134,19.515703709132413,3.353823271438929,0.7333699322053632,0.6825305033805132
104,1718039891,1718040066,175,7.503342908896595,3.733510004558327,0.3184761574566545,0.8500806070551719
105,1718154671,1718154726,55,12.120237618998754,4.389094108964076,0.4025813178581954,0.8881001624277695
106,1718122811,1718122884,73,15.854243334824547,4.205311511710862,0.17594922639025762,0.7473257259352447
107,1718225591,1718225695,104,15.123460265887335,3.391067199233714,0.7640328704055717,0.884199234788648
108,1718276291,1718276564,273,19.485839301534334,3.5829582877597037,0.9508840773731184,0.7896385278888547
109,1718299691,1718299862,171,18.417636456653998,4.198665532634264,0.15713355006229363,0.40801232417258737
110,1718346251,1718346453,202,10.812617499016369,4.121589659668788,0.7866279936334516,0.15327621910662964
111,1718352971,1718353088,117,19.681206976483782,4.85639928707265,0.7038010170154262,0.8288191339322105
112,1718424311,1718424578,267,6.742694156507095,4.246575731642413,0.677303403542837,0.7256637732787082
113,1718435351,1718435548,197,8.080711979155298,4.428730825721101,0.5219339523582284,0.17543593384984646
114,1718473931,1718474151,220,16.903156616795513,4.394633742621041,0.7942304638159066,0.280551990043704
115,1718515031,1718515138,107,8.633859403820148,4.061295700699818,0.18051244091479773,0.8534128756881658
116,1718546291,1718546385,94,17.517697198691526,4.521120972632154,0.4319291556009146,0.29376670013392203
117,1718534231,1718534474,243,12.564616355158684,4.5849745408878935,0.22558988502911242,0.5093059483811642
118,1718679611,1718679698,87,17.366899098621424,4.89607073952299,0.42760937070857785,0.6026603364568487
119,1718687771,1718687952,181,15.628521813071968,3.5424732526052565,0.10583107397059899,0.40448747690517717
120,1718688431,1718688692,261,10.655545333653059,3.5761882544481836,0.9496492125105976,0.4814752043902505
121,1718777471,1718777508,37,11.975503892853315,3.47121563576141,0.9770273804769849,0.3502745890212572
122,1718756291,1718756455,164,14.441405173386851,3.6056258234886918,0.19850906425219655,0.3193381082333613
123,1718727731,1718727864,133,19.02130579016187,3.9878005177912885,0.3746970443525488,0.6463240875325996
124,1718797811,1718798048,237,10.397484116456052,3.9773480630315543,0.6599933251856492,0.2510539070005796
125,1718781431,1718781526,95,12.777150003426591,4.4167022295939535,0.4918330188455775,0.6830871088904351
126,1718835371,1718835574,203,13.490602130598472,4.595939215121081,0.8077013027806534,0.7425925047963416
127,1718926211,1718926382,171,17.57861526272439,4.7361180526013795,0.9739371493292327,0.30930753161711655
128,1718950271,1718950394,123,12.248275716610308,4.146293776228565,0.17363778053560375,0.7147005012068464
129,1718940011,1718940269,258,13.572284615542756,4.103959980522503,0.7812947464051101,0.8428656714760848
130,1719034691,1719034831,140,7.531341060796835,4.288977884048524,0.4524526932484779,0.7268434951499144
131,1719023531,1719023566,35,10.81219249218369,3.7465888968177716,0.48349346287111106,0.21266396554404549
132,1718997071,1718997330,259,11.03047681200568,4.824731427218189,0.5699713631232514,0.1072926092909551
133,1719045911,1719046110,199,12.170741451350786,4.072994701588718,0.2622364625151451,0.4366632949366557
134,1719115571,1719115709,138,11.17840981048184,4.07372068152768,0.37503671869997957,0.7504978034741264
135,1719149711,1719150008,297,13.771152820451904,3.6752984688867825,0.7791632028052032,0.34451314725649684
136,1719186491,1719186658,167,6.629379408264972,4.737637117826164,0.5832894019403211,0.18655069835179916
137,1719225011,1719225267,256,9.845507982606788,3.720122594982238,0.3523203446033425,0.6487868514037425
138,1719347111,1719347191,80,14.451306273887973,3.984013578726781,0.11556383811750814,0.9218454417503973
139,1719349091,1719349237,146,18.318455742820788,3.8443152989455696,0.7344974340326731,0.4719437780784306
140,1719368171,1719368440,269,10.928532463738836,4.352256748117469,0.16850065468984737,0.9935899150047562
141,1719389291,1719389548,257,14.931014912365853,4.32637294316703,0.9122325279311014,0.2809462867195013
142,1719488051,1719488273,222,16.6010344978812,4.835762751420748,0.3728084063466073,0.8445713450083951
143,1719634451,1719634515,64,9.345814462919275,3.5844241286591725,0.5502909831116267,0.8755909621685494
144,1719722891,1719723139,248,16.31225834677261,3.920652623487677,0.15457009933659024,0.680851581516268
145,1719652511,1719652799,288,14.05987529719499,4.689559913013428,0.9287028701465805,0.3811064549093697
146,1719743111,1719743295,184,13.32696025777612,3.52357152995931,0.15045147419538074,0.32333788494129706
147,1719793871,1719794138,267,18.568175515385676,4.337822483296716,0.5356655093942674,0.3633824324723064
148,1719899651,1719899913,262,6.839046815686686,3.5023612827382453,0.3512246955823489,0.713020577921124
149,1719894071,1719894224,153,17.759317239862888,4.863417533784849,0.12782488630385705,0.5569164168504235
150,1719910631,1719910710,79,8.878653998981786,4.654948105693714,0.8940214659939814,0.8298607259711281
151,1720019351,1720019425,74,19.724288790711817,4.555932894020718,0.8160820302290462,0.8982318670274135
152,1720006031,1720006118,87,9.292628102116911,4.3017161127825485,0.45835179145780247,0.2780398942288389
153,1720045631,1720045768,137,18.615420167927606,4.20766165059637,0.83870563299916,0.9061525883776037
154,1720129091,1720129241,150,15.660271495515872,4.700469115432955,0.22243544467613846,0.17125991659554438
155,1720210931,1720211230,299,5.677673131832799,4.849797947839669,0.5380293964504221,0.9338545513625308
156,1720172831,1720172973,142,7.826841909849813,3.6849130092846365,0.18050679387930912,0.42369176788595786
157,1720168391,1720168545,154,17.839673941844953,3.564147844149764,0.13510678928548225,0.33914194563121697
158,1720250291,1720250527,236,12.478250901686478,3.4575903168697293,0.7076407758480281,0.7443467804956639
159,1720269071,1720269180,109,17.673863849590234,4.677022469488112,0.49719941977919546,0.14411031154099502
160,1720318151,1720318280,129,17.80030067363024,3.953862392233912,0.4415736954821706,0.5348358666863146
161,1720351451,1720351597,146,10.234030502235598,4.582337062069507,0.34881763095887264,0.8970696982002314
162,1720345811,1720345910,99,7.538287089041521,3.7247266747823646,0.5417724229262544,0.19806432465614232
163,1720354871,1720355160,289,13.860038834765586,3.908816231873299,0.5340390511468527,0.12337694566429194
164,1720458431,1720458608,177,10.886894136575147,4.916216072698159,0.10782921462683484,0.9300871488270825
165,1720493231,1720493451,220,15.23380193303617,4.161275025859533,0.7154928220398431,0.49419562302838826
166,1720539491,1720539785,294,17.55515688181815,4.8538218678748635,0.9223595065330785,0.3380550471007829
167,1720669211,1720669381,170,11.353295322333565,3.7329299609239093,0.9294584817450812,0.650090415419659
168,1720600991,1720601150,159,7.696674378380984,3.7343187416755166,0.8535789472049867,0.7167184896842801
169,1720722431,1720722635,204,19.53119702174117,4.47639899678004,0.6768608757454793,0.3348536529166145
170,1720712711,1720712909,198,7.459311851748636,4.574941457029127,0.2545796265365825,0.14032060349776443
171,1720771211,1720771341,130,9.05151506135245,4.304617763254417,0.303801987043432,0.9988575075383319
172,1720773071,1720773222,151,12.667999730001043,4.197052174611427,0.9886959848043819,0.7738517714206928
173,1720847591,1720847685,94,12.174512519759565,4.45073817420594,0.19423212743456503,0.6130673434376471
174,1720924931,1720925168,237,6.39857920806255,4.216298796732954,0.9007660141187985,0.4977207344130491
175,1720912631,1720912665,34,13.001703736581648,4.345920105335477,0.845556858976818,0.9841641393722862
176,1720855091,1720855124,33,10.16275430628638,3.8982153850031116,0.993890022090036,0.8788639710023154
177,1720966511,1720966729,218,8.379857225445043,3.4421575305593417,0.32337426526046076,0.35684901995478213
178,1721018111,1721018264,153,18.92711053104714,3.96239066031739,0.6299314587469304,0.6229324425289968
179,1721072351,1721072478,127,5.152550699327401,4.537074637385193,0.16970696924506395,0.3072182566156524
180,1721157671,1721157756,85,11.57329682695856,3.3238271337232943,0.9287620524244188,0.9150353585736339
181,1721173511,1721173738,227,7.675671366755819,3.4711149904854643,0.9848305700123369,0.7450454415999745
182,1721151131,1721151338,207,11.991098484993824,4.099806804833811,0.5231485230776438,0.3607310557864414
183,1721205371,1721205457,86,10.580045990750934,3.529685579437775,0.2558715871376076,0.9019292600291496
184,1721322551,1721322806,255,11.431030945454609,4.038271794874806,0.8149301957608305,0.25291782423085146
185,1721293931,1721294102,171,8.389126822596621,3.3704445389313538,0.3814610651664192,0.28189687682909753
186,1721422331,1721422459,128,7.340763436005182,4.118182799117812,0.5679987217989994,0.8350080643363244
187,1721433311,1721433601,290,10.869976742068477,4.943488690394402,0.9679389101738326,0.8672115504572318
188,1721381951,1721382093,142,8.043037053100704,4.283934774133069,0.4045928532621548,0.2687736265845956
189,1721521031,1721521102,71,12.532409676687235,4.905119336248013,0.18840883405384004,0.8585333422234251
190,1721488571,1721488829,258,13.313353949095582,4.957099617140257,0.6652722907479967,0.49171770398208303
191,1721491151,1721491414,263,6.891013376792015,4.665932792468813,0.44125048170658043,0.6794947560538561
192,1721546831,1721547130,299,5.242779997956896,3.410801429534539,0.17631145594466308,0.610613682408989
193,1721570651,1721570864,213,17.69705581745357,3.5707339512174494,0.33650694849057744,0.9965423922284582
194,1721664551,1721664587,36,15.041920051636723,4.793057907498472,0.762887043602898,0.41244661166821495
195,1721767451,1721767708,257,8.265028583399344,4.957131147991589,0.9318763679179888,0.44838613322759246
196,1721751611,1721751702,91,6.541365142908406,4.061370443234477,0.7450059486973057,0.931396383201372
197,1721769791,1721769898,107,7.358502772173366,4.317861196974205,0.29068554594700646,0.42922739428338996
198,1721852951,1721853116,165,8.85805254815908,4.682805641706641,0.47530438073551384,0.8462718632704379
199,1721969891,1721970053,162,19.689421069416383,4.930661712285966,0.7644590359654675,0.6334603684642481
200,1721905451,1721905705,254,16.66606397302699,3.4919358427280267,0.9561011770766458,0.9602180928412176
201,1721970371,1721970606,235,10.071592696453848,4.957498898567571,0.9202005424406806,0.48573538622542367
202,1722008591,1722008643,52,7.768846543316759,4.425869798359573,0.4960048860440486,0.43913458846182374
203,1722110471,1722110555,84,16.737962854881154,3.6872080401563694,0.21128226337733796,0.44526951511952984
204,1722114011,1722114121,110,5.08365670227316,3.4383625544061633,0.36907129276368944,0.6946154005974333
205,1722120131,1722120323,192,16.03220700315388,3.838002033311036,0.5655379222150125,0.5832058896639919
206,1722153431,1722153575,144,16.284787309911003,4.870899526404209,0.17408929257295003,0.644043319549961
207,1722156791,1722156928,137,13.480132534374839,3.3054413052628795,0.4924918798618704,0.29482081950333905
208,1722164951,1722165127,176,14.746621256677047,4.263759021270507,0.21052217870048814,0.7393329504627033
209,1722263891,1722264010,119,11.361341269268,4.01111055787442,0.6464612960015661,0.4473881502667679
210,1722375131,1722375347,216,12.286339433490543,4.323724135045386,0.10922901552273381,0.3356455447276494
211,1722377891,1722377921,30,17.98222353830963,3.772711943830384,0.5591086653814563,0.6926345324136471
212,1722350831,1722350866,35,14.293410528020058,4.749157558935407,0.2682324311215356,0.6710001949957904
213,1722446891,1722446976,85,8.22547868936124,4.271028873958627,0.30059791528888247,0.36253623720716577
214,1722490691,1722490736,45,8.136860825049906,4.216213901848203,0.8451893862190843,0.5807801416599596
215,1722504731,1722504887,156,17.943917878616205,3.7750541630635612,0.15986588585592804,0.12147177416655953
216,1722569831,1722570026,195,9.413987626826295,4.339072174611599,0.4521876541260953,0.7930515281425162
217,1722499451,1722499670,219,11.162919571693907,4.100452654331106,0.842677876404336,0.2958687725255774
218,1722624491,1722624563,72,19.973068153633918,3.9859639113766994,0.48777725904037705,0.5616814464992202
219,1722687311,1722687390,79,17.111240738554564,4.665879036870166,0.8073629077375475,0.5993280723429881
220,1722678851,1722679092,241,6.887578644193343,3.3235139554569773,0.6118558438453982,0.16104382883109408
221,1722721511,1722721766,255,10.918044357453391,3.701554027460364,0.27964767528528056,0.43106210815531576
222,1722830171,1722830296,125,17.99619912370552,4.754173651020351,0.2811733088861477,0.35255963420924097
223,1722783551,1722783654,103,19.535212626991985,3.7154753868886825,0.8835081744615026,0.6627147528702318
224,1722881471,1722881554,83,13.151997255876957,4.685832770150464,0.3268873287616263,0.2712969964966609
225,1722849131,1722849431,300,18.28602576788423,4.426231504169314,0.41846988764984516,0.7137704030614553
226,1722913751,1722913886,135,14.301451392742639,4.658204405038713,0.1011011843179903,0.9901785222906103
227,1722992471,1722992508,37,10.378999184025165,4.814418631853983,0.9401495970978109,0.7711177581095638
228,1723092611,1723092851,240,9.391557347511862,4.35293061311245,0.9080909073008115,0.897068506425598
229,1723149071,1723149318,247,17.200893651933683,3.701933223872971,0.5724350911630042,0.23443410794696828
230,1723192571,1723192721,150,8.9200349239573,4.859705711426524,0.15182215223141846,0.579068387109731
231,1723295771,1723295866,95,19.181390040977256,4.081478803935396,0.2870130313618737,0.9682693784393841
232,1723282091,1723282368,277,14.530301658449863,3.9575863659623587,0.6029669819043793,0.6425596823662495
233,1723324451,1723324683,232,9.284606663625308,4.3620639418009794,0.4994054585844333,0.6777062493425948
234,1723417211,1723417343,132,7.4073686196335204,4.605652590289692,0.16742113555824306,0.37536041634507467
235,1723418651,1723418684,33,5.643421366684675,4.007775229713873,0.14764898631207032,0.690309894228339
236,1723449251,1723449311,60,9.185414517994948,4.996178831290865,0.9379349538122999,0.28351895274374517
237,1723614611,1723614889,278,9.14265627192028,4.3738411290637345,0.5544790990091868,0.2976128208013311
238,1723590611,1723590879,268,8.906175332318249,4.034312133730845,0.241880309958508,0.6786114991143237
239,1723695251,1723695543,292,8.003972055865209,3.4569573899747192,0.5538942241236988,0.9207608849227472
240,1723719551,1723719851,300,19.036977947557535,4.451470458052247,0.5235232963082997,0.6496803986445863
241,1723790411,1723790604,193,19.91081439212951,4.041935557594594,0.3523134996620647,0.9135511050934911
242,1723784891,1723784933,42,12.367500753895902,4.372849920669111,0.7074431234305198,0.23776071806270963
243,1723856651,1723856780,129,12.09706625203853,4.3770884123127995,0.8478183867482749,0.31008912915557596
244,1723821851,1723822041,190,9.627295190293692,3.345530684052599,0.6927111996302158,0.35153810891175197
245,1723811651,1723811767,116,9.36471214727328,3.3121865673467603,0.10686586811723381,0.35238456163777043
246,1723922531,1723922829,298,12.588362302811387,4.275886138942131,0.7267257963262785,0.47837024786077376
247,1724023931,1724024188,257,11.973835121458965,4.852594467512445,0.3603999195324723,0.5636231420436754
248,1723969631,1723969713,82,14.69617919233623,4.405732747586562,0.716716538013242,0.7835744548504825
249,1724086211,1724086490,279,14.612200745608718,3.962805230357955,0.31692128019734467,0.33697958032136754
250,1724082251,1724082488,237,17.526249141258916,4.273719760004313,0.19460033164943774,0.13236612753042573
251,1724191391,1724191559,168,17.67689447410647,3.590770373433278,0.4158297951606984,0.19915705344258688
252,1724169071,1724169298,227,9.088422093372477,4.42223466289754,0.8687018530411371,0.7725887308169495
253,1724240231,1724240383,152,10.148247182534835,3.5029390339666104,0.13147389065577209,0.9795675905986256
254,1724350031,1724350185,154,19.916900714285433,4.3347724153494545,0.2069984962605289,0.8986614080806671
255,1724456591,1724456882,291,19.5565765904689,4.486227347935391,0.5578514005076685,0.752364396417486
256,1724475431,1724475583,152,17.706293704904677,4.067889511295672,0.3108739803630447,0.926680447511489
257,1724487731,1724487994,263,16.212330062008707,4.184198075445233,0.4076987331434372,0.29747730354193713
258,1724545811,1724545913,102,13.539499266065043,3.6197813177096725,0.4857402798114683,0.30801352186312964
259,1724631791,1724631881,90,9.324870974013614,3.8950817934851303,0.11752546101414676,0.7070693620523076
260,1724610851,1724611021,170,16.208061946288577,3.3019808727031723,0.5708349730998649,0.18260082690546767
261,1724713751,1724714015,264,14.00733756123611,3.772036573467388,0.3756996733947606,0.4615352620545733
262,1724736431,1724736480,49,8.707081240253377,3.541689348580175,0.6659114043257153,0.1439193697846149
263,1724733971,1724734268,297,11.613704863715494,4.058373038514768,0.5620622299679702,0.11417006694463484
264,1724813231,1724813530,299,18.38765632368863,4.9175810376661175,0.8041412612431763,0.4808720309247112
265,1724826491,1724826716,225,14.864962105904418,3.992680602571,0.8385408359817691,0.8148209981188062
266,1724862611,1724862758,147,12.432239688458045,4.626650285003304,0.19297179774857498,0.6991631134599496
267,1724971331,1724971511,180,18.746653966801993,4.315071078683326,0.7292405265779714,0.4252676705761552
268,1724982611,1724982666,55,13.702367747483995,4.531978172612709,0.8559590844039701,0.4508359583311362
269,1724954771,1724955029,258,10.307370608758045,4.3265367062029,0.5302375370131694,0.14658995683183274
270,1725077531,1725077611,80,13.766987659700364,4.503606923534453,0.28771183551660523,0.5706765856339165
271,1725168491,1725168544,53,15.053972170762139,4.4501269784802275,0.9132150550414431,0.6445724776560574
272,1725182591,1725182776,185,14.624041075959939,4.719718926918999,0.4222463105793167,0.3895379756937536
273,1725302891,1725302979,88,9.358690565525574,4.64684487268164,0.12487457107122879,0.7721220624016428
274,1725317051,1725317219,168,9.510079702352932,4.381344711900972,0.47953682231539285,0.6388789513810476
275,1725318491,1725318755,264,15.007504478599241,4.85134961724232,0.4444202290753754,0.6866877006315013
276,1725429551,1725429650,99,11.232533376278614,4.346163574016285,0.5382146409940176,0.584189510860194
277,1725482171,1725482259,88,12.496283459841226,4.596685159005734,0.8159439503501965,0.559542031477776
278,1725436811,1725436859,48,12.10931535494516,3.4918980449415162,0.2186955377617804,0.5755544165332425
279,1725551591,1725551835,244,17.37220454826229,4.897796292779945,0.6755073030642932,0.9283596787471013
280,1725583151,1725583232,81,16.867939902090995,4.420931335397404,0.5651044007963106,0.6527802961355601
281,1725526511,1725526652,141,16.02575015928766,3.74626064881259,0.9092118648864335,0.44251941309289644
282,1725649511,1725649768,257,13.57604852259978,4.821149396109734,0.6168109940348002,0.17852235826006455
283,1725655211,1725655459,248,15.072387188193764,4.3264766617341675,0.7436446554938327,0.17344221038187904
284,1725613031,1725613247,216,18.99441426636944,3.810157988111138,0.7275222851172428,0.27419542636401084
285,1725770351,1725770556,205,5.608680532320071,4.530990048316905,0.145188942504281,0.1116219955824383
286,1725740831,1725741052,221,14.009106271019952,3.769316431246849,0.5503289003442311,0.8363606562291206
287,1725763391,1725763457,66,10.529926889737379,4.696402428606985,0.5475414566793553,0.12427479949573067
288,1725829991,1725830034,43,18.930773865868947,3.525814762506033,0.9020957326159841,0.20491899593903984
289,1725795011,1725795242,231,8.01391391470977,4.090469385887858,0.15861231492082611,0.5998128524379402
290,1725893171,1725893462,291,10.20148238310218,4.211929068735325,0.12478419332490669,0.5458294155849392
291,1726010051,1726010118,67,19.147789507065983,4.381500987683227,0.5631319332126107,0.7641226923134711
292,1726095671,1726095800,129,6.046814521560178,3.646792774647451,0.3615223849320456,0.10628905689134048
293,1726162271,1726162351,80,10.679484424115586,4.087132908147702,0.8301288771100206,0.6132512326096436
294,1726128971,1726129205,234,18.705042018176663,4.936889127180171,0.18623738063856027,0.34672782720860157
295,1726296911,1726297187,276,6.102373764878509,3.4610696411833297,0.5300269408807453,0.49892140367573545
296,1726294871,1726294913,42,16.768303885348452,3.4477768961871127,0.1429924290439178,0.8030320338816483
297,1726223831,1726223904,73,19.52979210294599,4.687667412288169,0.13201436993123705,0.38306773565571206
298,1726301591,1726301647,56,16.812215498741168,4.216027184761016,0.9702601002381445,0.9493873258322824
299,1726318091,1726318200,109,19.386085008933502,4.972392099739233,0.9433782473212616,0.9098680249911798
300,1726404611,1726404754,143,11.690723697678878,4.006775992179312,0.18553883093137025,0.817007393213798
301,1726494551,1726494584,33,16.51568938493479,4.672902652260953,0.8232847135780119,0.5180480405437675
302,1726479191,1726479297,106,17.72803886170336,4.14786522985605,0.6313600185582039,0.7590902301226351
303,1726535291,1726535483,192,17.70471459130289,4.036896963140425,0.12506625744786068,0.8999724366742942
304,1726623251,1726623339,88,13.646197333088816,4.48510994506141,0.4212619116030005,0.3898364441423131
305,1726660211,1726660501,290,14.464328348042521,3.8005339522430623,0.8617762012866425,0.34173706512097507
306,1726786631,1726786717,86,8.784422851902058,4.6275119539610525,0.44562937006822156,0.529763421006039
307,1726889291,1726889341,50,9.56790742841056,4.3557650210978744,0.79614508904735,0.11089094721944659
308,1726868531,1726868636,105,5.626035377348871,3.3057794320579115,0.6329878462193383,0.7648506290701264
309,1726937411,1726937468,57,14.25026777453832,3.8909824922283356,0.6099720477164047,0.6818344067661793
310,1726930211,1726930453,242,13.174309462182023,4.591873635035341,0.9167071743293563,0.44253474712434804
311,1726973111,1726973307,196,12.676838646407482,3.5907710542980906,0.9962902761150895,0.9435493497023854
312,1727056151,1727056420,269,7.5990977821457175,4.032127761698898,0.2198262320925562,0.10710748987954173
313,1727030771,1727030913,142,9.368660101254886,3.4611092828952894,0.45119786670201767,0.33009783080186333
314,1727022731,1727022906,175,15.524126472860734,4.106666521134008,0.49340504283208486,0.5821544523407356
315,1727124791,1727125060,269,11.18672995977119,3.3499201867969965,0.6229808341151027,0.9979641747945717
316,1727133431,1727133605,174,18.98143581466159,3.8128663156795652,0.7109355917056812,0.7360908223623648
317,1727131271,1727131367,96,6.723571354873457,4.278036870858051,0.7661945862804629,0.80393023961246
318,1727180051,1727180150,99,5.657643260061781,3.709537677418208,0.7997789844784559,0.5054542217812635
319,1727180891,1727180947,56,18.416278561153447,4.372294832020387,0.9778805369432426,0.12065142843705214
320,1727312111,1727312265,154,12.616711300052819,3.461326280135179,0.26886797964237097,0.22529364284394857
321,1727252711,1727253004,293,17.433629142218628,3.442331788145876,0.3059517078668062,0.4350205665772555
322,1727374211,1727374293,82,19.84877327298637,4.914793043190285,0.8324774949017953,0.39246731681925506
323,1727439851,1727439897,46,7.634581976082287,4.142072356663855,0.28803047833318507,0.526367017734198
324,1727465471,1727465689,218,14.99245378942131,4.557283705700472,0.22896325630976827,0.6310328521651426
325,1727443931,1727444167,236,14.848894675280789,3.671441516293334,0.15175001963162532,0.6244751154693854
326,1727529431,1727529730,299,19.775548696457125,4.096102374843144,0.6041048874007567,0.6214423405912686
327,1727549651,1727549736,85,14.91857757254382,3.911736160025859,0.8469870155206296,0.517658019252753
328,1727564951,1727565156,205,19.503896717356383,4.753448637993179,0.9175951543172691,0.7536557597240174
329,1727671151,1727671322,171,11.256199210744175,4.913130757326096,0.5448274390332698,0.8881764667389225
330,1727637491,1727637587,96,18.656099729569316,3.874920531058534,0.47496783047332647,0.4667859886899304
331,1727616851,1727616890,39,17.026641300124993,4.971979262937989,0.10614758009384506,0.8596843918487681
332,1727719031,1727719234,203,19.472906202587623,3.910885744462948,0.2632278859616018,0.33425057671046654
333,1727680811,1727680958,147,9.195094943572641,4.546724839590827,0.8075246384569664,0.9276385648092859
334,1727707331,1727707528,197,18.72436908869176,4.75314682638917,0.8801572395699133,0.13532820178039542
335,1727810891,1727810929,38,19.995146004761715,4.307331427264879,0.5826145540844913,0.4330181674615251
336,1727797331,1727797537,206,6.933561881494089,4.4803221614117374,0.9104523573781873,0.859827933474591
337,1727770751,1727770882,131,7.729261198886084,3.784096326327438,0.43688475090015366,0.9175421056351303
338,1727923871,1727924036,165,14.45166921955108,3.7039695159682506,0.8506712417182105,0.7755943650894197
339,1727867591,1727867885,294,19.064089870831772,4.627083410101577,0.8518492188058627,0.24815304493526208
340,1728016751,1728016950,199,10.678735895493759,3.6223390904374586,0.19841979114947011,0.4903323697361315
341,1727982431,1727982469,38,5.523909459111316,4.7467178966171275,0.2746279846441076,0.9682512661015277
342,1728102731,1728102790,59,18.28714475877114,4.651302056521789,0.8298409611647782,0.6109527689068914
343,1728166331,1728166399,68,8.177705710138552,4.713235764266738,0.39155565218907196,0.4717815829911992
344,1728176831,1728177002,171,13.2805471121744,3.837063457112928,0.6612641781041365,0.3047420468220924
345,1728138371,1728138620,249,15.160533889460595,3.903250719688513,0.2888936627654186,0.9129426124744165
346,1728201191,1728201390,199,17.99433325690873,3.514182384895636,0.7378626595816611,0.7022305501439585
347,1728290831,1728290911,80,14.137034121821491,3.34613039026175,0.21432063500430776,0.22938305991991342
348,1728357251,1728357313,62,19.232400350986502,4.685946249640749,0.8462231706249108,0.47424757206581725
349,1728370451,1728370640,189,15.058121485682229,4.354235381500237,0.5878268583506353,0.4422164029665552
350,1728431411,1728431473,62,17.250454149574445,4.677815251540663,0.8567594753146996,0.7838346796752226
351,1728426431,1728426561,130,19.33138285854922,3.920299486690519,0.1394697443582838,0.5422902141692296
352,1728449471,1728449670,199,10.808547954286425,4.790335816478454,0.8112089502830802,0.4073905590886424
353,1728512411,1728512698,287,12.750578726151387,4.706203710683132,0.42490857741816423,0.453128087080112
354,1728475871,1728476132,261,11.543185488382166,4.373352546367252,0.9615594786612504,0.6736980027607862
355,1728530411,1728530442,31,11.26063104189025,4.4446959355177755,0.8761515634097443,0.6701247578069978
356,1728551171,1728551469,298,5.262514990660259,3.7207249207558695,0.8348850541097146,0.5968040661449366
357,1728656291,1728656534,243,12.23473819888956,3.5579024025408352,0.3902119671804789,0.9314696515408134
358,1728769811,1728769892,81,16.458992141457536,3.8715570903206316,0.49412485817102547,0.6260564228779392
359,1728795071,1728795319,248,9.123802920245417,3.364958469938556,0.17564457803111833,0.442040024481807
360,1728783191,1728783491,300,7.96842377350503,4.9351693180373,0.7363898522167013,0.5871260499806508
361,1728834431,1728834623,192,14.860914606861488,4.2308138363402845,0.7456521797296286,0.21787586683516857
362,1728864551,1728864665,114,6.905883398415353,3.6109176768988154,0.7417733710158008,0.26169183136869334
363,1728887831,1728888016,185,13.75061684154095,3.519361667340915,0.6505483258592338,0.8823352730977602
364,1728936551,1728936637,86,15.161966143132636,3.74924204425958,0.5351231094014445,0.4550325584227729
365,1728892331,1728892383,52,13.340351650738112,4.892981594602306,0.854176392794569,0.11857885078901725
366,1728992051,1728992092,41,6.160657366637777,4.1000861112575775,0.8677280670333127,0.7986576461162316
367,1729111991,1729112264,273,11.597957219441508,4.820660879926152,0.6480307113651705,0.8603754826915794
368,1729065431,1729065684,253,7.8593090731526045,3.8972861214593872,0.42866865895919026,0.6035511045333316
369,1729138331,1729138514,183,11.466396079915391,3.647053062792726,0.3160948020680773,0.5023690753715123
370,1729202531,1729202689,158,13.836117252810238,4.942866098618648,0.8176227124537966,0.32548675584654907
371,1729168211,1729168415,204,11.559859473809796,4.905419867754739,0.8541121108263865,0.8551211835292701
372,1729317131,1729317172,41,12.468913281737795,4.450260254242632,0.6984729590664084,0.39671715064694235
373,1729298351,1729298637,286,6.197245844779837,4.9094921226109625,0.30110774155638914,0.8580083336235111
374,1729351211,1729351380,169,9.782912754380504,3.572992683794008,0.1381601643632642,0.8926369781721641
375,1729398731,1729398968,237,7.433371959550874,4.4805450405167235,0.1123631400155766,0.6801005503617173
376,1729483751,1729483858,107,5.939071494806866,3.427982895985677,0.16308144072017167,0.8841445299860966
377,1729556171,1729556458,287,11.87185331219995,4.480220578930823,0.4949867337896712,0.2133011619649526
378,1729498631,1729498833,202,10.221374592385917,4.428811852144099,0.7596254115669638,0.22559542863583448
379,1729569071,1729569323,252,16.520973431657758,4.733392842224847,0.7138567614945591,0.8016098765883325
380,1729631111,1729631314,203,8.671894169459126,4.798408273021512,0.4635746479627244,0.7029224702619195
381,1729623071,1729623333,262,19.641366772342774,3.4495055379715422,0.11425594844996963,0.48065310592198573
382,1729726211,1729726421,210,13.285166893838596,3.4355211491406012,0.5349027353742998,0.2372355475594215
383,1729676771,1729676924,153,14.833022601791948,4.844340778126049,0.6291752833088735,0.6277436283628369
384,1729807331,1729807567,236,13.466191552993456,4.705594302751087,0.7916011024350735,0.32779574507337306
385,1729904291,1729904433,142,5.330962009867789,4.062212225263075,0.8826319766647414,0.854677669031996
386,1729885871,1729886012,141,7.678032243822227,4.547557249226787,0.9176286016281195,0.7090062035650472
387,1729887851,1729888018,167,15.775674092527172,3.6826550295949736,0.4667915660354258,0.7392828816874716
388,1729979831,1729980115,284,15.787301715817296,3.6370215746300936,0.17037218657033676,0.1362204514448364
389,1729971491,1729971667,176,12.511648346025236,4.803901748719122,0.7494358047826924,0.9173349060168446
390,1729927391,1729927521,130,12.293568145380412,4.821852075089408,0.7730422429862474,0.9949953944547627
391,1730080871,1730081108,237,18.42944506227903,3.4738102591546074,0.2584394508206611,0.13107708310299085
392,1730016491,1730016678,187,10.056639269836676,3.468157269328895,0.3375293760048208,0.5481248871973373
393,1730121611,1730121686,75,15.445289413426316,3.798948763155209,0.23131750400971635,0.6072854712923959
394,1730219591,1730219793,202,18.06604923112726,4.357388254423352,0.5607193820750476,0.2592712107047204
395,1730233451,1730233723,272,19.248845288171538,3.517434017310824,0.16034013420034415,0.3577002719086917
396,1730261831,1730262077,246,6.154362287311269,4.06317421676687,0.27080818170913734,0.6541167771116903
397,1730344871,1730345165,294,10.590219482061883,3.956082562705279,0.19709003241496278,0.2988573393882785
398,1730403731,1730403830,99,7.831257656784399,4.728563683138232,0.713235370859341,0.9106320997696143
399,1730412971,1730413169,198,6.151373798031882,4.458178792447189,0.7823337609311224,0.6175846027404588
400,1730523911,1730524027,116,15.833689860949384,3.528589432428314,0.7737376205204446,0.6716982383602904
401,1730573771,1730573962,191,18.38823925329808,3.5097554873941963,0.5859744160663397,0.7708791465124173
402,1730534891,1730535057,166,6.326912264879422,4.58607792899004,0.9928115849428701,0.8027506944727179
403,1730694131,1730694351,220,12.609762732173687,3.4254711059945064,0.7384611966522929,0.3779197402504788
404,1730668751,1730668793,42,9.69254535855409,4.215222611303081,0.8518699258744631,0.990123811731601
405,1730621951,1730622039,88,19.433160849155435,4.656720513022203,0.5811666466934542,0.986787619699681
406,1730775491,1730775629,138,19.97788592481012,4.563660517108847,0.47904284657117646,0.8561539682831681
407,1730782991,1730783217,226,7.638008725228584,3.4034311911793704,0.43661796363521366,0.5117194396361467
408,1730871611,1730871878,267,14.597829776034933,3.4816398468458134,0.8108527513514998,0.4210056910880544
409,1730857511,1730857768,257,13.34353627070077,3.446534160677075,0.21638668937899427,0.11085824916117629
410,1730941991,1730942133,142,7.729556649464697,3.352835919727197,0.5739725884618405,0.9681776773979769
411,1730915891,1730916169,278,12.867175789114658,3.777098228509142,0.8038085235267893,0.9609999794101487
412,1731025031,1731025202,171,5.782536091932312,4.976284073791193,0.6572489188284304,0.8896021329290952
413,1731022451,1731022719,268,8.395976026773363,4.6379219254339645,0.44189832515776195,0.44615284010764633
414,1731081071,1731081337,266,5.092435986441724,4.937631294742431,0.19694530589063244,0.7652367411925114
415,1731111791,1731112002,211,7.460392322695556,3.30453082657484,0.466993705056861,0.7708616374962363
416,1731094331,1731094380,49,16.352804125032236,3.4831437767203117,0.6732900450344026,0.4350395272561476
417,1731148991,1731149036,45,11.904510387426123,4.035308769617413,0.6960351566663184,0.2401208574132193
418,1731214031,1731214305,274,7.243743207299061,4.201724260263524,0.3348558337800971,0.288114698325214
419,1731153731,1731153837,106,19.69518689173364,4.406908330097873,0.18668710948785006,0.6252614059304468
420,1731256931,1731257157,226,8.968128451425414,3.9659916418174426,0.3418038524855693,0.49132113608368366
421,1731330671,1731330759,88,17.834778986382673,4.225008243757703,0.17558667941982398,0.3344076343562979
422,1731466571,1731466721,150,16.61485934340991,3.58687020261646,0.2008199944902172,0.3728020349923782
423,1731510791,1731511083,292,6.171883428948138,3.7036095918153147,0.7842671708325959,0.7169400459438391
424,1731648911,1731649156,245,11.16176778682228,3.3914608699891287,0.8383963452572262,0.6005977729771976
425,1731640271,1731640501,230,5.54228259770107,4.691465763326863,0.6234815284436251,0.9063435127871685
426,1731647231,1731647438,207,6.801090575245752,4.1347374489804904,0.5532887731019317,0.9077752785063108
427,1731701471,1731701578,107,7.910570264627862,3.845551703338434,0.9596966515350779,0.8922561717095728
428,1731726491,1731726704,213,13.139144041995099,4.692203329539754,0.7644365073157652,0.24172289701682212
429,1731773951,1731774195,244,19.99757605854883,4.4109043989451395,0.23921607766507355,0.564061104349779
430,1731764471,1731764669,198,18.471362507572096,4.5429423414708,0.4142576725167081,0.34136932906950956
431,1731835631,1731835915,284,16.125916607991016,4.087643545470467,0.10167665646110757,0.37421688832692057
432,1731937571,1731937756,185,9.3787398115065,4.876299007951113,0.728439910115459,0.9970232158104811
433,1731968951,1731969081,130,10.684523681805004,3.956867115817893,0.5504365302509739,0.46973557682680167
434,1732002971,1732003241,270,14.150022029724052,3.6261338652431103,0.7620932792276266,0.13456485730533924
435,1732035311,1732035505,194,5.66901660395973,4.320014757882735,0.8598084473546431,0.6146972567755806
436,1732168691,1732168922,231,10.818650007512119,4.94975525892062,0.3229366150645989,0.8341985596725559
437,1732116611,1732116669,58,17.530811247572032,3.982580892135233,0.8737131433248325,0.30366186234785814
438,1732104431,1732104719,288,5.230702593215465,3.415200762546575,0.9602226243923528,0.6013230977579045
439,1732249031,1732249117,86,15.799947530862175,3.507224523997466,0.26175608477141954,0.6178600042831816
440,1732174031,1732174108,77,10.75416038139566,4.2058735716063715,0.7085444925224335,0.15089170950010694
441,1732304111,1732304410,299,9.656951937851309,3.6180132918712378,0.54031004871311,0.22602852628241316
442,1732360151,1732360364,213,11.349159725449677,3.5501781943936415,0.7775777599736817,0.10297276816292077
443,1732402091,1732402303,212,14.81031005653258,4.417516314106676,0.4458969539730221,0.6765837505195296
444,1732509251,1732509530,279,15.431361918221105,4.221201093393793,0.32788444537078276,0.8317735971217513
445,1732603931,1732604164,233,11.107645630920459,4.236920968152781,0.3776816848572393,0.17117514319683125
446,1732562591,1732562845,254,16.78436801613953,3.961534875466269,0.9992222964445024,0.7244239680499972
447,1732666631,1732666841,210,13.82212767385152,3.411406394750775,0.12666689054306182,0.24900999928584616
448,1732630751,1732630994,243,13.956641770739264,4.710670683996448,0.8469306907251564,0.926399934818761
449,1732776671,1732776827,156,18.40232078324558,4.787704439449012,0.6890912199359246,0.7957490639459132
450,1732738151,1732738370,219,19.325878714373573,3.380843539237541,0.10280379642756328,0.9747147061564284
451,1732838591,1732838660,69,7.071736438755298,4.321998896593909,0.9947890538093375,0.5468268353743964
452,1732801931,1732802209,278,10.692269757291012,3.9507944073541847,0.3127769547451368,0.7620968167116956
453,1732786631,1732786759,128,14.952022412209907,4.429260961179489,0.6445140976396778,0.3159421865289926
454,1732901411,1732901535,124,16.369412536217666,4.141130321004367,0.2600466068167985,0.6064767626956535
455,1732923071,1732923180,109,5.104506943583209,4.5958444701636925,0.7824575901697639,0.5933249131025599
456,1732918451,1732918613,162,19.029467322957064,3.742246809681056,0.2480427055119464,0.7401021599490334
457,1732966751,1732966874,123,6.116908423906331,4.43334205941728,0.5505813509049811,0.4936729089359967
458,1733075351,1733075583,232,18.206500967366665,3.535784155915936,0.2073265292506425,0.17837486559672755
459,1733083451,1733083661,210,12.22730692660295,4.063196935864293,0.6227636346652355,0.36677972874723674
460,1733120231,1733120456,225,10.250578801360914,3.835376516140224,0.5925999633864235,0.4353804352427526
461,1733178251,1733178496,245,14.896823070221787,4.942536568433635,0.8193204599292221,0.8092172202338344
462,1733161871,1733162076,205,12.254881778337614,3.686280632825841,0.979296692521692,0.39676802673990785
463,1733266871,1733266922,51,16.445676152733522,4.042778409009084,0.5453592261988807,0.5957619349349171
464,1733238491,1733238715,224,9.066902881651568,4.379878708374948,0.480842218947809,0.52030786832506
465,1733320271,1733320551,280,5.145409033379841,3.7172595128969714,0.3363214425044902,0.5585076263363428
466,1733303471,1733303505,34,18.946165302636132,3.821562496033213,0.4964304947441577,0.6416717174689406
467,1733358911,1733359032,121,17.298349865547763,3.676858555333479,0.8761165117521813,0.6958076449432442
468,1733454431,1733454498,67,10.678091729387326,4.665353959987112,0.18386109498096515,0.5313378475551378
469,1733453591,1733453835,244,19.9660780715662,4.025686359619899,0.24603834546682216,0.926565269610104
470,1733486111,1733486312,201,6.683843156753654,4.747475060468416,0.513514168149398,0.518598126891076
471,1733488871,1733488919,48,5.8920152458741235,3.583938503919435,0.28693901825040097,0.8414856229772759
472,1733627771,1733627879,108,7.111636957609321,3.56177468470749,0.30993125526324095,0.6947109701749332
473,1733591471,1733591529,58,14.113129208749008,3.9000510569089393,0.8114860486795414,0.43041879283876394
474,1733556311,1733556490,179,19.498603332315454,3.6243208131319724,0.5058392146303958,0.1878762764591855
475,1733670911,1733671046,135,10.256132851805258,3.950374356195297,0.7414861700824946,0.688000954513596
476,1733716931,1733717092,161,13.76620901150957,3.61008414688158,0.6375520514569878,0.45345889515986393
477,1733764571,1733764790,219,6.570667123480424,4.772424285684875,0.4069272465372211,0.2512812508884354
478,1733823011,1733823189,178,16.69438071042842,4.528194426673874,0.3445764786717484,0.15716094360973024
479,1733840171,1733840411,240,15.898533951198171,3.669135514017356,0.1876080785011346,0.8608657134116828
480,1733888471,1733888672,201,17.319089199865537,3.6107392203260114,0.8123377902190478,0.2850777958518563
481,1733959631,1733959870,239,8.912373077467038,4.614467723038639,0.7623509397122553,0.8907563325943788
482,1733911211,1733911418,207,7.152979344663726,4.162227412634924,0.8718483493306202,0.23866779040432237
483,1733918051,1733918257,206,14.95629457016339,4.672030929881182,0.15493978615981627,0.5301557779405075
484,1734032111,1734032190,79,9.702058240595706,3.5249611243300154,0.45027424924573445,0.7292087366319926
485,1734068891,1734068993,102,19.599290328343685,3.5721270139265604,0.721157085810336,0.6202791101328424
486,1733996891,1733997084,193,9.804009893507253,3.4107793059373153,0.4661441676459086,0.5806226461998587
487,1734086171,1734086279,108,14.46259513693473,4.271526680486589,0.2122710080137204,0.15333416131571379
488,1734103211,1734103305,94,8.966211431350748,4.261026675196142,0.10903086701540968,0.3607671593243822
489,1734210731,1734210802,71,5.144871647432471,4.290213437375441,0.12768905525980867,0.8870955904109611
490,1734214211,1734214247,36,15.91164124255837,4.780143280009257,0.33232200214734064,0.8127431487918667
491,1734181031,1734181241,210,13.25411716392018,4.73770421101829,0.6930447465848765,0.6515701216244187
492,1734326411,1734326702,291,9.99197243780919,3.3323415195996673,0.11294818442919241,0.8050326337537662
493,1734310631,1734310925,294,10.15190067159038,3.371084646456711,0.7514706884588158,0.5624595922708551
494,1734340391,1734340586,195,10.795484997315153,4.287288985500173,0.3905860241218464,0.7549116965245147
495,1734333431,1734333528,97,11.525183327070213,3.6337667091750814,0.17229898459776016,0.2689513318306354
496,1734484511,1734484572,61,11.175500010061421,4.68995395499718,0.23342183038249514,0.20093090747357303
497,1734450731,1734450822,91,14.095470966443951,3.355768672940216,0.7575985376166811,0.1545144413561939
498,1734590111,1734590388,277,8.852074765856457,4.735183386160922,0.829673227504883,0.4338060468393178
499,1734576851,1734577027,176,15.956643641974415,4.189929360565605,0.15208570862843193,0.2503139875896279
500,1734664451,1734664734,283,17.50344812715259,3.536542632135711,0.4058087378647839,0.2951071106777596
501,1734734111,1734734317,206,10.164682837974617,4.946783985072834,0.22493308613548396,0.8844572501343332
502,1734714551,1734714690,139,17.3454159688042,4.095443794862521,0.8776994083396078,0.2377503107332243
503,1734770651,1734770934,283,15.365245535297397,3.6842864623622167,0.7417600204637776,0.6198390932848737
504,1734837131,1734837222,91,19.65645843228569,4.076164023399874,0.8952660319265182,0.42365434424465853
505,1734920591,1734920801,210,12.527214297323965,4.022205079438194,0.16398073580292077,0.6170208108616191
506,1734909071,1734909359,288,19.44484540220479,4.007247295506999,0.8301014174643014,0.7538784871469972
507,1734925091,1734925159,68,17.28842269707368,3.861014984344499,0.12855388876158674,0.292839721698373
508,1734951551,1734951705,154,10.4500252519241,4.594055866051113,0.10305467254976401,0.3186939819099801
509,1735061531,1735061807,276,5.849321408360963,3.460331375977089,0.5326158407915724,0.4530004096632172
510,1735045511,1735045683,172,13.746387863873085,3.745262361943692,0.41633267415765574,0.726058031408886
511,1735120391,1735120554,163,17.046842182709437,3.804048686377585,0.9204472730818072,0.1868394204206203
512,1735164191,1735164395,204,17.968233797231065,3.3451129349273705,0.18309421925129443,0.7381551315727243
513,1735244651,1735244795,144,14.669560192356135,3.834052576372854,0.9102983919715136,0.8716298298495783
514,1735280411,1735280527,116,5.925723758157646,3.759788259382815,0.6350431103025854,0.46971198142932924
515,1735229471,1735229565,94,10.3578591913198,3.464110172645149,0.5821122070901811,0.7876297730978942
516,1735304231,1735304485,254,7.274233193787468,3.327459573618316,0.17956851538248977,0.4315932354207114
517,1735368071,1735368243,172,8.171814091136131,3.6802096071715127,0.35276992807176266,0.7759432612453064
518,1735370471,1735370719,248,10.957009254452574,4.781535349150259,0.6872951017737404,0.748290212495685
519,1735408271,1735408416,145,11.452081781213668,4.296779794816617,0.4507749850150269,0.7773559607672252
520,1735411271,1735411510,239,13.04790562309818,4.1571113723547946,0.5752448979519524,0.9795311144061167
521,1735499891,1735500039,148,18.621098762821887,4.81889592096038,0.6883391123115784,0.7999029212947198
522,1735487351,1735487598,247,16.5365734832488,4.735541051456194,0.860409696146544,0.8510131212741497
523,1735475351,1735475463,112,9.618223956525885,4.931630698600736,0.1310490277828519,0.39308662558739005
524,1735613831,1735613873,42,7.495646037769909,3.3202964468864136,0.5425843470395298,0.7772748235193998
525,1735561151,1735561312,161,10.537254684085468,4.083270319070016,0.18901879831751406,0.47863226022269734
526,1735709891,1735710079,188,15.784608587853834,3.4562428594443424,0.4253637987821586,0.6476845075715608
527,1735744451,1735744492,41,12.295048837783526,3.313475352620117,0.5429689645336924,0.3218956828333822
528,1735815851,1735816120,269,9.831545421856724,4.149370302609555,0.7689465906293577,0.9305743600295207
529,1735824611,1735824735,124,13.249973638302267,3.32689246204134,0.6983554520757073,0.4109541588515768
530,1735908731,1735908884,153,17.557998469912974,3.6903741375620807,0.9545025131127419,0.6580431989297495
531,1735953251,1735953441,190,8.96065387068554,3.959085208155183,0.7967014985198394,0.44007356183082824
532,1736015711,1736015919,208,14.13101404056739,4.679019560646303,0.3910524175536457,0.33939238197561594
533,1736104391,1736104624,233,11.755615534544665,3.8770371940038935,0.21054538789748373,0.6484946321003802
534,1736098691,1736098818,127,6.385940597394336,4.40412065267963,0.8740900153984624,0.9493072079389141
535,1736148131,1736148220,89,14.724023793831996,4.002960578794971,0.405326061981666,0.8938364424731362
536,1736176991,1736177261,270,19.25957033021905,4.137718379734062,0.864483576987524,0.4141230302504777
537,1736262851,1736262943,92,15.261524341027746,4.091269373455429,0.1970227381944482,0.5951909664659009
538,1736264111,1736264182,71,14.635506572734327,3.420808029939496,0.3176303677362856,0.20363085175303597
539,1736277611,1736277645,34,11.504136189403923,4.771284379848144,0.912738783240084,0.9627122674433715
540,1736364731,1736364805,74,6.122669157628942,3.5263896879625176,0.6316749570960603,0.8431287285573228
541,1736477291,1736477420,129,8.857796660204995,3.907410099939546,0.25303094993042097,0.9356544615618161
542,1736482631,1736482814,183,5.362129713096053,4.410661059389566,0.38175279550949615,0.46562326235897367
543,1736420951,1736420985,34,6.602859466346824,4.731356872878065,0.5593690856558968,0.9607044759160911
544,1736523731,1736523895,164,7.964229286850397,4.935089817287597,0.9235516130235308,0.32661872601582986
545,1736563991,1736564246,255,15.133672686558132,3.5472703441231404,0.9123944240894502,0.11202629173477559
546,1736579351,1736579651,300,15.09890739801301,4.413090561859616,0.5689894909313261,0.19709003221264432
547,1736616311,1736616475,164,5.187340908040355,4.739293895850304,0.26760519623890383,0.9281659892244035
548,1736698451,1736698510,59,5.034592268849395,4.269159070484729,0.6300923573393235,0.45328479464219185
549,1736759651,1736759781,130,19.447653406802296,4.728930896846732,0.5147603959122226,0.230458693719755
550,1736832671,1736832796,125,10.364119745365155,3.4275619617393907,0.3395446019303701,0.6366602124835904
551,1736859971,1736860103,132,11.665006482163276,3.457410782526186,0.180432189694945,0.43487322680557017
552,1736920511,1736920716,205,16.75922769651772,3.3664510203335736,0.989386032785403,0.2187537429656638
553,1736944631,1736944843,212,6.3071394600990764,3.8242422695477165,0.30361898954364086,0.2793639138209611
554,1736985791,1736986010,219,17.08048967146245,3.3685320094833457,0.10521203525988389,0.9718060721980819
555,1736970911,1736970942,31,12.61760189209699,4.588322150129397,0.11808896452692673,0.6308805627412953
556,1737021611,1737021700,89,12.575370957571973,3.3024034666055377,0.3530916823849448,0.6279756099811001
557,1737049511,1737049755,244,17.080314838669658,4.455365918839884,0.3171188801088779,0.8371244487001668
558,1737055571,1737055643,72,6.429747112014315,4.13054330039019,0.5921860465694786,0.5467635490061998
559,1737165851,1737165991,140,11.836945393705124,3.509522796588614,0.2305084390456561,0.7531491424611095
560,1737161171,1737161386,215,6.136609016776555,3.916211625973745,0.7487097128908689,0.692034023265803
561,1737145571,1737145635,64,12.655510191368789,3.7068767896817008,0.768647725434033,0.5471115687765072
562,1737224711,1737224985,274,18.608442824073595,3.6825327209511363,0.4121925235448346,0.7375932202282816
563,1737245771,1737245802,31,18.945316691441825,4.229427616180656,0.804114265256541,0.4170621156348112
564,1737321731,1737321986,255,7.106440107911673,4.871172091352787,0.9038545965243676,0.43186390667742003
565,1737303611,1737303673,62,12.077378185964111,4.089323252279229,0.970989187478928,0.23640645328981874
566,1737369191,1737369476,285,10.154938485275812,4.792646523201899,0.9637882992570207,0.9384702688993602
567,1737432371,1737432459,88,5.012668653158131,3.8220320000687464,0.1237228921669038,0.9134193074164909
568,1737373211,1737373433,222,6.522859808587793,4.62547803206739,0.3766572748771805,0.7952609753550837
569,1737509711,1737509769,58,14.947602598647123,3.9223749308958986,0.8665035382026823,0.8804645860586671
570,1737491711,1737491765,54,14.961735377453671,3.3955871198881935,0.1868809713407128,0.6124399185840816
571,1737526931,1737527162,231,12.661971717259096,4.894419398988897,0.42356873778850923,0.43668504426855537
572,1737595331,1737595592,261,7.641891310656858,4.7406587878585915,0.41736135012156017,0.2827630318556415
573,1737691631,1737691780,149,13.3231720493426,4.189794062373157,0.5695493888074864,0.7408658596811701
574,1737641531,1737641690,159,18.09533349461533,4.9463537004376885,0.32309312403550666,0.8254503281581567
575,1737717731,1737717998,267,5.652308772359316,3.42729919480501,0.9540915528739751,0.33420599359865844
576,1737803111,1737803308,197,18.80925366172886,4.334630503101881,0.4626009356532479,0.4379897531625869
577,1737928451,1737928711,260,12.79882090108385,4.519216854078227,0.6155375283567132,0.49972183063246667
578,1737898931,1737899215,284,13.008886220842623,3.6895462072276857,0.18516775407599223,0.18475453632846334
579,1737913271,1737913387,116,19.022290568761925,4.567238292878154,0.9132271833659321,0.8680596654762229
580,1738000511,1738000733,222,8.014781878980322,4.782303105881373,0.8921004031607758,0.9736104284158108
581,1738003211,1738003404,193,16.983049066762383,4.021904655628159,0.2077505143881985,0.18570550914544093
582,1738014071,1738014162,91,9.118860816456182,4.66684420399567,0.8608815415779633,0.5151620439238658
583,1738073831,1738073950,119,19.543621964555417,3.572368503003086,0.44809520183522344,0.43136696832775945
584,1738214711,1738214932,221,8.518549796645491,3.714615304033802,0.6872056451740538,0.7081569906125524
585,1738173131,1738173242,111,19.105715344157545,3.378529771979546,0.787677214802549,0.49060099912267574
586,1738258991,1738259108,117,18.642002756669793,4.267092735473152,0.5641741520284017,0.5284302089705307
587,1738246031,1738246095,64,13.962460897705645,3.9251516162915348,0.3198976102906032,0.2733479189167017
588,1738328171,1738328210,39,14.045219303409985,3.759675895023699,0.9996330008282104,0.5969759783749616
589,1738444631,1738444928,297,16.93188207101973,3.9196795573230445,0.702897047858562,0.24935772712273488
590,1738425251,1738425445,194,12.745499929133297,4.448429293501697,0.7418526320356689,0.6274223271909383
591,1738414871,1738415085,214,6.467347117151126,4.144768530109928,0.7928816934387056,0.3770468807810824
592,1738481171,1738481209,38,14.924130131546793,3.404263552033105,0.4917842063613189,0.3865358098881039
593,1738554551,1738554708,157,10.971526664239299,4.782721992361267,0.5569928680225862,0.5754137761485618
594,1738581071,1738581250,179,9.420861110999118,4.183928821876086,0.2620982951914544,0.9166433537337132
595,1738573211,1738573249,38,15.312167809959602,4.188820897936456,0.7883255305849263,0.9611429735656196
596,1738621871,1738621921,50,15.130878848965178,4.8225000873251975,0.7423275375008367,0.2941714530556321
597,1738703831,1738704061,230,7.563668821633769,3.3799025451721163,0.9978740421751744,0.8264702692550113
598,1738699931,1738700155,224,16.69841113997766,3.9904842428519167,0.71933172065254,0.4561167993429174
599,1738662551,1738662618,67,10.669392139624083,3.6189975710824753,0.6926002462752138,0.6033230759770083
600,1738744811,1738744928,117,11.993257819532904,3.9519116698237395,0.5554415819042888,0.2929473273124475
601,1738857911,1738858089,178,11.811331239936635,4.880356009305375,0.23647332699923299,0.9091730059989686
602,1738847351,1738847395,44,14.282225930650132,3.3127007186225095,0.5196138647910806,0.8478735938491603
603,1738847291,1738847456,165,17.55159939365787,4.051464208924428,0.9160497394448629,0.5578602565668663
604,1738990571,1738990786,215,5.756052233164274,4.159467495363964,0.1680139156864305,0.36952360924915795
605,1739067251,1739067375,124,13.617299210917906,3.415393177510737,0.48875538274973296,0.24371254425849231
606,1739015891,1739016163,272,17.616543587539578,3.768350011737066,0.8629771842145145,0.8437007014286655
607,1739153171,1739153303,132,13.90204066166394,4.261886171520122,0.8436443137433792,0.21069141541745157
608,1739211131,1739211256,125,8.771796984517863,4.983529507384827,0.6365942768058922,0.5177671700802253
609,1739290751,1739290904,153,19.62387682952366,4.5269952808401,0.8959902110470448,0.8718848085391723
610,1739281451,1739281728,277,12.463018778404901,4.481162871417533,0.7019675508146118,0.8835526080849228
611,1739344991,1739345023,32,16.46844127463487,4.149113273055103,0.3771089352042445,0.6296596161004282
612,1739409551,1739409794,243,6.088711813413912,4.501380546344617,0.5999230677305255,0.7654536063273171
613,1739513111,1739513241,130,8.317360852270586,3.371874160982975,0.54877692461678,0.4853846422999104
614,1739596751,1739596781,30,19.72355612782245,4.861962332125444,0.1901671674074185,0.7680352768834561
615,1739589011,1739589205,194,18.95006468934981,4.27278062196297,0.9530516528534241,0.4354710249814776
616,1739640611,1739640873,262,13.786913319199856,4.489647579238341,0.5152411533119843,0.5373940554579527
617,1739611211,1739611401,190,19.191472478305133,4.927967438351264,0.5024517181150792,0.8053748352297448
618,1739675411,1739675468,57,13.495884466678298,4.992751756783299,0.2017162956041149,0.2918409084300428
619,1739739191,1739739418,227,18.064069343990912,4.110055230205513,0.3481119965570607,0.6004917595623797
620,1739828291,1739828441,150,7.8086959499620034,3.725914866906353,0.845702706754875,0.6307497194093468
621,1739889371,1739889533,162,6.750923805313752,4.165573764089274,0.5182389426982329,0.7338614648037064
622,1740003251,1740003481,230,15.821860967610528,3.72413625026944,0.992444209709358,0.9609895357631962
623,1740112871,1740113009,138,15.47108132704621,4.986919288336055,0.9303515421133973,0.9914427164723602
624,1740129671,1740129749,78,17.922601464367744,3.6280790839110373,0.31603600871560367,0.9379867268258314
625,1740209471,1740209595,124,13.5852162497455,4.920240076760929,0.3452340205857171,0.9499937406472411
626,1740276791,1740276867,76,16.913591316847047,4.152377556943748,0.362428693313245,0.690418753434678
627,1740232211,1740232332,121,7.529929874571853,4.32989608240395,0.47468418889861763,0.6800090667162202
628,1740339851,1740339959,108,19.618789665503172,3.9873908939711433,0.18730970321529533,0.8540579470565658
629,1740299411,1740299691,280,14.633887501157961,4.553190304391109,0.890438355166195,0.4090458017336027
630,1740374831,1740375002,171,5.781519228462911,4.880742151019505,0.5319560839844402,0.11133176350467298
631,1740435791,1740436075,284,15.238190132812315,3.84847231908884,0.7783288927433362,0.7645515210333452
632,1740444731,1740444846,115,11.546944125530693,4.051407768071291,0.1999784948358392,0.7345019096435768
633,1740440051,1740440173,122,13.373949796353592,4.836293755317456,0.7363868172497947,0.92443372741669
634,1740480311,1740480570,259,9.227636608827925,3.934754919274554,0.8346973365129906,0.28786744773247336
635,1740546611,1740546652,41,15.867953884338322,4.049564526798174,0.9577571631389435,0.467058436313022
636,1740599711,1740599827,116,9.495072767485139,4.634085310806247,0.6475375517202805,0.8250793569496613
637,1740637271,1740637512,241,19.374988562901926,3.4509576893398504,0.9019738723512957,0.5282380664137202
638,1740706451,1740706516,65,8.368223436060063,3.3215874311196414,0.7964380511295235,0.5555033281126959
639,1740733991,1740734083,92,12.468289619823517,4.911973426260534,0.6343143587106065,0.5554399975012966
640,1740767471,1740767571,100,14.395295549505022,3.931173174472909,0.9339791712848283,0.9292045397597878
641,1740748211,1740748307,96,19.84643759362311,4.737354579787553,0.7889728853589144,0.9103989513386772
642,1740864911,1740865069,158,9.359481678496511,3.4802215431459556,0.5197664959030608,0.2495863653223907
643,1740843971,1740844240,269,6.264430970948208,4.47812278810431,0.26730210846556623,0.15113765108364588
644,1740976211,1740976379,168,18.614277780546857,3.915362685404056,0.6744055475101459,0.6739706012009572
645,1740948671,1740948762,91,11.364312655019303,3.7779977841699854,0.7154558702876235,0.5031078090760164
646,1740985391,1740985621,230,14.333936638063507,4.269595235319015,0.18930645116365677,0.5280597298420923
647,1741028951,1741029140,189,18.668052194740156,4.943515539601502,0.20677013309839376,0.6771077756207476
648,1741059791,1741059979,188,18.064161383325327,3.4855161984938716,0.9057208206867223,0.8887040171843918
649,1741149551,1741149683,132,16.195132055792683,3.7736227112098577,0.10576596086517782,0.9499190621649224
650,1741138931,1741139107,176,8.533122650789196,4.696747579066348,0.4060013535338396,0.4371426251092203
651,1741155611,1741155903,292,10.621140561507445,4.32211812904387,0.12728999029560764,0.8745030916423164
652,1741233011,1741233154,143,18.28517937751502,4.721494929187434,0.9646913652201239,0.4669687412937368
653,1741199711,1741199968,257,16.581588298575397,3.3419331407110513,0.9930012847269829,0.29313852688192876
654,1741250951,1741251109,158,11.233930308187242,3.5390196247907237,0.5229506199748215,0.8847097840074274
655,1741408151,1741408185,34,8.57589705976125,3.4682951780266174,0.6045273014749925,0.3653678312055807
656,1741503971,1741504189,218,11.48305521527022,4.385286946020772,0.8415135534615988,0.7588886060592039
657,1741569491,1741569620,129,15.050013678563008,3.3576113283364935,0.6097243212230814,0.3187490166414918
658,1741622351,1741622465,114,7.369132094186037,3.487558498953319,0.6513837487632052,0.6757041057665598
659,1741605311,1741605587,276,10.429171130669214,4.06350998902492,0.3318885366737876,0.890995224676684
660,1741709291,1741709386,95,14.144072350350267,4.656837235361568,0.6476876151136927,0.6132312986377808
661,1741752971,1741753237,266,11.934134992188792,3.496376091268803,0.7384148267286961,0.8533383056199499
662,1741683971,1741684009,38,11.415598387318159,3.9064107427057237,0.8951448845323197,0.22882922548462475
663,1741764251,1741764471,220,13.732773917070395,3.3856856001035287,0.3364183375631588,0.6439635505395386
664,1741936091,1741936300,209,12.716621373232632,3.8742969817369213,0.5880637817475599,0.856542117053809
665,1741890851,1741891139,288,9.506419943918992,4.544672452899219,0.4178627701949723,0.7083191604654387
666,1741892951,1741893080,129,12.343189307303835,3.345966154748477,0.5507650934517643,0.11287725230499762
667,1741960391,1741960681,290,9.965536050583982,4.151393467206361,0.4400249297604878,0.8515371952231353
668,1741978811,1741978876,65,12.223625985840231,3.9451616872415025,0.5828134636532997,0.30832156787410947
669,1742045531,1742045655,124,8.140276296864592,3.750322919985307,0.3085180364242862,0.9570282157162951
670,1742103911,1742104191,280,7.057932810950234,4.291517362438353,0.5040893285334431,0.48727642398119597
671,1742177531,1742177657,126,15.769292876753584,3.889558297759385,0.26759922566635275,0.31124949153751164
672,1742145551,1742145767,216,5.175463539623258,4.5745427186538645,0.5007788753545658,0.438322910839007
673,1742143991,1742144025,34,10.095711939688533,3.5851649128528087,0.15272809454329872,0.6242871916107362
674,1742225411,1742225580,169,18.930351813909375,3.8139712445506992,0.8708560719443302,0.9749581264129659
675,1742207711,1742207813,102,7.651101732613936,3.855681851773457,0.15297316927841392,0.5479872642296613
676,1742329151,1742329194,43,18.978113324610916,3.5125710147349074,0.34037267164848983,0.12656671876106484
677,1742304251,1742304307,56,11.431670828153969,4.931553279005136,0.4845197308818484,0.4895397935750715
678,1742431751,1742431814,63,7.666710700779628,4.9431573948251435,0.8525288992413915,0.9754118061430292
679,1742537171,1742537380,209,15.757945448857978,4.735952738052745,0.22388434325676065,0.5099774276505169
680,1742458631,1742458719,88,5.425230902685804,4.730383251782169,0.8125550098349023,0.7483699310407137
681,1742561651,1742561702,51,6.39532812482593,4.189670620418284,0.5502113444926404,0.7398351565345103
682,1742551631,1742551854,223,12.537657892340004,4.041266150890978,0.7555375391599399,0.5820427381072649
683,1742572991,1742573150,159,5.353506299400547,3.78295100318296,0.6019296799977406,0.6290265702036975
684,1742644931,1742645001,70,14.841479079011215,3.665799159458458,0.20090837535463207,0.49741939159665516
685,1742726291,1742726442,151,10.969054560195538,4.565275070786369,0.3470984381485571,0.5359702251197523
686,1742866331,1742866440,109,6.532285226550086,4.902499741580991,0.6639174623676614,0.5280747190857461
687,1742946491,1742946624,133,18.03375174261135,4.942893601819918,0.28925609744946107,0.9693799068889675
688,1742979251,1742979371,120,9.623904442200413,3.6998457003238254,0.2619208820019589,0.1344782420118888
689,1743029291,1743029513,222,19.209264172587602,4.004656472960397,0.790022509397222,0.7778620191087133
690,1743141251,1743141376,125,16.047065500386253,4.517481953712101,0.8013652651412952,0.989612393828796
691,1743221171,1743221466,295,15.320768914861553,4.626108149897636,0.7632026828387384,0.4991049104425004
692,1743178331,1743178490,159,10.200671522854627,4.772140569469062,0.2966304933054349,0.8701106641083581
693,1743276251,1743276406,155,17.643552846097364,3.492468970325213,0.7864617573552428,0.2684975353617342
694,1743298211,1743298406,195,14.206125208208354,3.396076644384742,0.834158337661796,0.20837310338955137
695,1743297371,1743297625,254,15.722056974395054,4.877156119307005,0.21965902228647,0.8371963944793869
696,1743378071,1743378246,175,14.775304489214093,4.20664105275643,0.19213086035745333,0.5071110768377198
697,1743376931,1743377218,287,11.541182575159954,4.661026096658951,0.6706053539921749,0.7830889814998947
698,1743367451,1743367595,144,10.878666052661853,3.6054207226395496,0.8357729228472279,0.9721327560994458
699,1743459431,1743459711,280,5.246623146594256,3.796339413462126,0.3079157800731502,0.9635383121727119
700,1743458351,1743458482,131,17.272661335482372,4.478693702523987,0.6365437113464051,0.7054689617300648
701,1743495551,1743495628,77,13.407428200570028,3.963880078267948,0.38720891076676034,0.7438623902109962
702,1743651131,1743651309,178,12.411642079902201,3.5260111939187806,0.9876076775447129,0.1918932518203197
703,1743646691,1743646879,188,5.70158999533935,3.7398810628421186,0.44097197313535585,0.9866874812754177
704,1743676391,1743676425,34,6.579048274243157,3.3836690257153776,0.4544070363896697,0.8435308793515588
705,1743810251,1743810398,147,9.731342787728499,3.783429518763859,0.8069354280523119,0.32596997329262545
706,1743805271,1743805542,271,19.952263544894198,3.9497252815909976,0.3920561875471279,0.8159296119174747
707,1743753311,1743753466,155,18.169426623231423,4.961200083325467,0.18521407445094432,0.9550358038432046
708,1743907991,1743908261,270,9.220548521164499,3.413555194652047,0.4287830250765404,0.1727426699551176
709,1743953591,1743953674,83,5.140344921402215,3.7001092530514414,0.3562078741067859,0.2440261584781689
710,1743972071,1743972102,31,10.67582596464383,3.503544071329571,0.7054264729860352,0.9900542817564276
711,1744073231,1744073376,145,15.105633304641373,4.1977098318746835,0.439974386245809,0.20801029103189816
712,1744013111,1744013313,202,10.941894976322047,3.450353207854359,0.9423136032625465,0.12723898870133218
713,1744087991,1744088196,205,13.259415233081338,4.291231421890183,0.93726853450742,0.6354743023155758
714,1744181711,1744181907,196,11.196319987554991,3.457221377441905,0.8095100567617792,0.7530071294535485
715,1744157231,1744157387,156,7.813915794237592,4.423160128952246,0.6116151756488843,0.8953256971847152
716,1744216031,1744216160,129,5.845339690957695,3.7297049868789274,0.30590264038136006,0.3953902010811269
717,1744213691,1744213942,251,5.0859161591228315,4.46005446045957,0.10037941361101113,0.7385020057502774
718,1744345271,1744345529,258,16.652005282506117,4.819859578384227,0.14605393499715616,0.8980479711846134
719,1744362791,1744362967,176,13.887791333830721,4.58579281729425,0.5611408014044161,0.25396416247845954
720,1744472351,1744472605,254,9.447310225477297,3.74926899710037,0.24958858926619593,0.45201191506638294
721,1744529051,1744529150,99,12.457603346526543,4.724102492608531,0.21264627206826636,0.8544319887872348
722,1744628231,1744628434,203,10.745240651423838,4.364181409085486,0.40351409812904815,0.8009273262746289
723,1744627391,1744627438,47,5.443568101198948,3.7973104261874955,0.42041657980368596,0.1102362440714219
724,1744773611,1744773909,298,18.51840361804919,4.34294847344005,0.17791390812408647,0.43670738986818947
725,1744836851,1744837002,151,8.680393021116775,4.008676022944084,0.7367364283332143,0.11843529176044418
726,1744800251,1744800338,87,15.200901552458404,4.763579786748002,0.9992124715355616,0.8188356063496725
727,1744792391,1744792635,244,8.28483617032332,4.961542795597575,0.2618725408622863,0.7757303108943805
728,1744880231,1744880281,50,7.454052863154327,3.76013918791375,0.15403279799216502,0.7123868875406105
729,1744955771,1744955924,153,16.86384053905389,3.620607207634957,0.12173372173754113,0.9510605537660376
730,1745008211,1745008298,87,19.036070698982982,3.6253680608538037,0.3879878462263935,0.8716888212233609
731,1744965791,1744966041,250,7.813054948306171,3.7827439210770235,0.2196427888242926,0.5612597764539667
732,1745013071,1745013131,60,16.834464091380013,3.9836215183102586,0.7464147276731525,0.32561276916467086
733,1745099951,1745100115,164,7.7454040573853025,4.624548354840622,0.6736729850559247,0.961628843754816
734,1745090531,1745090790,259,7.753427599915392,4.011418373781092,0.6904167720841831,0.1967121630513531
735,1745049071,1745049352,281,17.285443082424393,3.889462726108126,0.9690318333299522,0.4145692793362432
736,1745157911,1745158177,266,15.382337049901576,4.50467280710936,0.8681583390128977,0.641774053794544
737,1745282591,1745282846,255,10.641141279580346,4.060061824418942,0.9542020943971524,0.8875151694818576
738,1745303111,1745303321,210,9.055643579212088,4.900888208505904,0.512465230254126,0.9583000227140354
739,1745332211,1745332331,120,12.473806763274755,4.219359794941435,0.2398536613357387,0.6147753336439308
