id,start_time,end_time,duration,power,voltage,priority_t,priority_e
1,1713878002,1713878012,10,0.5401208420475933,4.984279966577109,0.7482671338019868,0.6767157305219257
2,1713864802,1713864805,3,0.8914857054352655,3.344784640631399,0.2769417090896607,0.9775281935303597
3,1713933382,1713933385,3,0.5250986682673129,4.112417515913157,0.5307568810523383,0.9542780780851485
4,1714014622,1714014625,3,1.453000410459335,4.33464772594594,0.9849226055318796,0.15674750415825592
5,1713981262,1713981268,6,0.8324290909462282,4.3622590487145905,0.17416687269860914,0.6859239416912777
6,1713946342,1713946347,5,0.5042547822775547,3.4563731487530225,0.38295940408891427,0.4255161380194965
7,1714088242,1714088244,2,1.088367404496748,4.271788253254522,0.7396370798341618,0.9281088116669397
8,1714034002,1714034011,9,1.1617241890911834,4.783513254770266,0.6344690174211941,0.9857842305180156
9,1714059562,1714059569,7,0.5406574587550753,4.627473506528279,0.21035095447966962,0.623810493509738
10,1714160602,1714160603,1,1.3000494500068676,3.0101480164992056,0.14734740917169326,0.32715969484074947
11,1714210282,1714210284,2,1.215538578544718,3.9397706691774275,0.5138592617116295,0.8925492294395839
12,1714221442,1714221444,2,1.0025111245280467,3.1713976517794,0.32044983214911427,0.4257309494345727
13,1714321522,1714321529,7,0.6533960377884557,3.078076168422048,0.9232290919216356,0.9700081333973143
14,1714391782,1714391789,7,1.3543379133165763,4.54477450566241,0.9600450744235839,0.5561202894411124
15,1714449322,1714449332,10,1.1184140441474062,3.6222200766086483,0.8489275877428951,0.530431831285705
16,1714535302,1714535307,5,0.9136449580961314,3.642179320502702,0.5879746663229594,0.8432967554179105
17,1714524142,1714524143,1,0.6100583270496513,3.2019761118199446,0.7551000386822607,0.41891469008755855
18,1714509022,1714509025,3,0.9608828318524442,4.4956691470197665,0.6906459514333129,0.48150264547776156
19,1714520722,1714520730,8,1.2688756389295883,4.926659865016443,0.9639119077402156,0.12287545804158634
20,1714578502,1714578510,8,0.5467509801001104,3.6125449022179286,0.2163888254469248,0.1378947561192071
21,1714706542,1714706550,8,0.9151644228593266,3.0779803948416937,0.818282280998488,0.49874480663890053
22,1714672102,1714672111,9,1.232279866809563,4.0127761096651735,0.47055636017119484,0.8291382548679548
23,1714685962,1714685963,1,1.3990503477878953,3.223075540256305,0.27151870627156527,0.46304016030883977
24,1714804162,1714804169,7,0.8242026325915289,4.776262829960898,0.5954270086746171,0.5162882732277189
25,1714854862,1714854868,6,1.3791350132267999,3.0385441610996056,0.8173445277343654,0.9901506723451216
26,1714855702,1714855709,7,1.4474134908767755,4.368450994249548,0.5486966064928649,0.4748903743144801
27,1714934122,1714934127,5,0.827935315044551,3.917602343887264,0.9861330306980486,0.31306846099116853
28,1714900282,1714900285,3,1.3669195489068964,4.284954850226954,0.23414457550831563,0.6081000143685243
29,1714947202,1714947203,1,1.2501458389986544,4.131973637831934,0.7705490596685926,0.8265495206341826
30,1714948642,1714948644,2,1.4147824347752245,4.3745613244449215,0.3146438611691478,0.43426049317248505
31,1714983382,1714983390,8,0.9874529837247622,4.870288186026311,0.445108902364581,0.7927433385197745
32,1715115682,1715115692,10,1.163692169694254,3.2348092302056264,0.2533520531967711,0.1604023092524038
33,1715106922,1715106930,8,0.5540353104670198,4.28764387556426,0.9607371724669651,0.5192686151018217
34,1715218042,1715218046,4,1.242876366944162,4.822560087324881,0.13611132997414768,0.1770532343298778
35,1715185582,1715185591,9,0.511378683837925,4.532344502121605,0.9446739304910273,0.24225524339752494
36,1715285302,1715285310,8,1.2861500177709604,4.157346977762176,0.9651100558980868,0.716705956166182
37,1715303902,1715303903,1,1.226432479527603,4.461216465739663,0.3152006023285876,0.886704289169598
38,1715242642,1715242643,1,1.3924919314715987,3.5352597910305823,0.7114432102256244,0.2864267559223208
39,1715267302,1715267310,8,0.8906190178373306,4.556872754744401,0.22272819029722735,0.20286042637792887
40,1715397742,1715397748,6,0.5693442052582047,4.534234536356711,0.33677742323993964,0.7005275602978192
41,1715346262,1715346266,4,1.1668161876304146,3.7377869503634513,0.4735361361004865,0.20671232728914724
42,1715378122,1715378123,1,1.3817634000370702,4.148515460969402,0.9085733323497,0.9795576513858971
43,1715328022,1715328025,3,1.1796679037213522,3.947509539411535,0.13708751983296144,0.6522451491516396
44,1715465182,1715465191,9,0.6679868676047923,3.8691354562066813,0.680872171284248,0.8498126679084459
45,1715442442,1715442448,6,1.0373692870790927,3.2166175236496377,0.518020628670227,0.4791262220074535
46,1715506402,1715506408,6,0.8827907640961666,4.743231728307173,0.7341500348606131,0.9475155004681882
47,1715564242,1715564246,4,1.478173038810147,3.988066677174817,0.9931205074106361,0.3214471525479824
48,1715506282,1715506288,6,1.3423349059187863,3.5081485163084327,0.3044560425362398,0.3766043726654831
49,1715573902,1715573904,2,0.6461712316098234,3.879626992229481,0.355421042628179,0.6149982778544426
50,1715601622,1715601628,6,0.7937842599806175,3.0718679099508046,0.9545486319934607,0.5323961364174601
51,1715719222,1715719231,9,1.0207602071399187,3.910161376580093,0.4821445225240175,0.6433344168585208
52,1715685202,1715685212,10,0.884075437789571,3.2159947127155863,0.6962525009965648,0.7150594409436033
53,1715740582,1715740587,5,0.7067896801524687,4.458016372388247,0.3369456836474757,0.556990374182217
54,1715698042,1715698043,1,0.9375488837649629,3.1094707622279643,0.7561855219627652,0.52131371549366
55,1715803582,1715803588,6,1.4094015080752686,4.671387715945934,0.6214150810853787,0.7442925189248308
56,1715771662,1715771671,9,0.9145451407173546,4.034727406243385,0.9842625432081982,0.42442694741033427
57,1715835142,1715835148,6,1.2416870301950271,3.257198567481276,0.9576456813282334,0.8333519316260118
58,1715877502,1715877505,3,1.0481148405253262,4.247845678181175,0.14441149797048053,0.8933132865898556
59,1715889262,1715889265,3,0.9408053235589372,4.964097165517845,0.5613812731213079,0.1737014724266665
60,1715925802,1715925806,4,1.4329617615552726,3.6424515898492915,0.3294439951540684,0.6243417324387249
61,1715933962,1715933971,9,0.639025833651397,3.47541469216337,0.40720317892285596,0.5271457038529883
62,1715958802,1715958810,8,1.0290724757709142,4.0852760020700565,0.78105476499149,0.47713236507546375
63,1715989102,1715989104,2,1.2030004022156577,3.6503622949770023,0.8651356257167035,0.22289043906069883
64,1715952442,1715952443,1,1.4019806058315178,3.983457852066649,0.522299520736619,0.8257574040936543
65,1716025942,1716025943,1,1.108464974927293,3.066356028148701,0.19871559641242217,0.6135859149960119
66,1716031222,1716031224,2,1.0434246574754518,4.223557131843858,0.3849351965586454,0.7082620741164233
67,1716092602,1716092607,5,0.9363189595724859,4.73042209453893,0.7596696823713114,0.7991729521189597
68,1716047122,1716047127,5,1.451127268955283,3.3449195983032327,0.8840959893199579,0.36029169081767864
69,1716148582,1716148583,1,0.9017850020351122,4.5894207139868515,0.21120420187785144,0.3806758807449443
70,1716182782,1716182788,6,1.0952913104334097,4.996707647766955,0.30387541997841705,0.4961113238860685
71,1716239302,1716239309,7,1.2801336322211738,4.067508672101993,0.23665039995516773,0.6186939627156117
72,1716212662,1716212669,7,0.6362493715477181,3.9475309063823483,0.8300590807031589,0.5056370946930994
73,1716192682,1716192683,1,1.0378195956062775,3.344068252150217,0.6261752591050592,0.16460656115050165
74,1716191122,1716191129,7,1.2562760762767455,4.412161441978829,0.2825389681678549,0.3296014410935988
75,1716341002,1716341012,10,1.2103790052472596,4.752676862324421,0.992662666116482,0.4204337578518428
76,1716325282,1716325289,7,0.696167354330091,4.708063295896048,0.9851868191337659,0.8895342865737961
77,1716397402,1716397409,7,1.2171432386273868,4.305637473061168,0.3845418969608769,0.788747738180817
78,1716416302,1716416308,6,1.349237079858809,3.3361363954127583,0.1989611888111789,0.9991707368453596
79,1716434302,1716434309,7,1.0079484942853063,3.105177012508504,0.3813170925873065,0.8893482486141892
80,1716431122,1716431130,8,1.2397756358550698,3.2749518117345056,0.419678580998036,0.4214835117685406
81,1716503302,1716503304,2,0.8191414243064097,3.6964825032037396,0.6743008981727608,0.5874222844421141
82,1716470962,1716470969,7,0.9690765061004378,4.0534020962702595,0.406786172324202,0.2876916910920038
83,1716530362,1716530364,2,0.9877078132200374,4.423681740826513,0.2745536137223816,0.1696563698701939
84,1716518962,1716518966,4,1.1966527223493892,3.684147239887145,0.43876286878143833,0.4790729092483209
85,1716564202,1716564203,1,0.5578296804923941,4.614186325859979,0.9577579143143938,0.7203453253575749
86,1716614542,1716614544,2,0.914463475127936,3.7952804082933014,0.9068319554235503,0.42741098664903
87,1716575122,1716575124,2,1.1658378648444776,4.039637336618627,0.22212252231171858,0.5348031568346027
88,1716638662,1716638663,1,1.1450718140043776,3.3373039688938206,0.15557873131590313,0.7767798658386721
89,1716686302,1716686312,10,1.0785293265848024,4.045385675115273,0.10869831395613543,0.7396936303010753
90,1716701182,1716701184,2,0.8024298693331922,3.666674322554977,0.9069887587929713,0.8237383564350422
91,1716636382,1716636386,4,1.4181612869220817,3.3922598499942387,0.8994768837880445,0.44210645528356995
92,1716780022,1716780026,4,1.3825090453614373,3.322674495768352,0.4619374886370702,0.26155983577128034
93,1716830842,1716830850,8,0.9371543093712209,3.838100926499726,0.8856287413759377,0.854333481721329
94,1716877342,1716877352,10,0.6889505020884605,4.914789554149939,0.11012905996515646,0.7313925290315413
95,1716883582,1716883588,6,1.2256520421162502,4.557906511039814,0.18019087600762201,0.10212379383051605
96,1716956362,1716956367,5,0.5130422996430553,3.9528746352410544,0.826845018280564,0.260795880874618
97,1717016482,1717016485,3,1.4256986574369002,3.591106504889394,0.21807065150138655,0.4529291607906195
98,1717014262,1717014266,4,1.0320171555280573,4.633934866278597,0.1913367644798119,0.8702920058936753
99,1717110922,1717110932,10,0.9643461054470293,4.726278899497627,0.18443266665879904,0.997012594823877
100,1717166242,1717166249,7,0.8532413369843196,3.174350498587918,0.17028229805294703,0.14890767298292776
101,1717251922,1717251930,8,0.8893138443318505,3.633295013802633,0.34325002371837177,0.9188135339114032
102,1717272742,1717272747,5,1.0820179599938982,4.128117008956207,0.9797089073349731,0.6062348594455335
103,1717373122,1717373132,10,0.8880161967958009,3.9529047204680663,0.7382535534053083,0.3096395599061679
104,1717445662,1717445668,6,0.5509521786921479,4.542211661248917,0.9002213326163291,0.9623470264815219
105,1717416802,1717416809,7,0.5288856749156972,4.887502388508762,0.24428225395680817,0.9502273916906632
106,1717479022,1717479032,10,1.4037155351220227,4.677735891123077,0.9557041375762624,0.13998135323065117
107,1717446802,1717446808,6,0.6759088334340974,3.880680580290523,0.2564133031984335,0.8282167712118136
108,1717527322,1717527328,6,1.3771578555407358,3.450099946398952,0.9846076511693825,0.8473257500119961
109,1717585942,1717585951,9,0.6531209541036948,4.445381604498991,0.5321362090424656,0.7504434689846748
110,1717655122,1717655128,6,0.7403512741442284,4.837087310886933,0.18123896400351697,0.8120716186113489
111,1717659322,1717659328,6,0.5542148836313847,3.3345803889230856,0.5699273332477932,0.5753313161081518
112,1717679962,1717679963,1,1.3317314785730772,3.8207201321094857,0.37845312476473514,0.7097183563192576
113,1717665382,1717665388,6,1.2570663681568868,3.0053741840893524,0.7651474457174322,0.1946236525850338
114,1717796002,1717796003,1,0.6346097084013621,3.699508383184329,0.4845339121982355,0.547953900456952
115,1717785742,1717785747,5,0.925903517491903,3.216426011733792,0.4958283905658579,0.5699608813690782
116,1717817062,1717817068,6,0.5924783069712346,3.8639756503185554,0.4615341642945401,0.8758461681827251
117,1717804342,1717804351,9,0.98966151547207,3.178233719687121,0.11908960421500239,0.600836877491744
118,1717880842,1717880843,1,1.1595260051654175,4.874758346492599,0.28438865192603613,0.8671302986820261
119,1717862662,1717862665,3,0.7622742249819431,3.1562526190860036,0.6156484629675338,0.65114564180943
120,1717938382,1717938391,9,1.28393648877775,4.906446362394213,0.7322199939549183,0.2861073179623372
121,1718019322,1718019325,3,0.8829476612950791,3.7925498721494812,0.5708264274294016,0.38604552013102056
122,1718084122,1718084132,10,1.0497291969211289,4.56717468283762,0.1939988977674256,0.41979813822793466
123,1718013682,1718013689,7,1.0262013788037274,3.996007234939254,0.3724883149711632,0.23125628196407716
124,1718105122,1718105127,5,0.7442839459132214,3.082340755189623,0.6970045784417165,0.5543523575425291
125,1718148202,1718148211,9,0.8717141985633516,4.232399653245733,0.21827660631515244,0.3611210432854356
126,1718163202,1718163203,1,0.9642484098242523,4.063126787857218,0.589347637540469,0.83131858576494
127,1718143822,1718143832,10,1.0497391110818808,3.3863015115353887,0.14738703045061352,0.26297271427342317
128,1718230942,1718230947,5,0.9967808620340384,4.686579455473866,0.7546229805264891,0.411693082045553
129,1718249902,1718249912,10,0.9498704899730365,4.84704990146492,0.9950736133273236,0.25997366677067374
130,1718287282,1718287289,7,1.056769981845024,4.524997082232205,0.448771825270321,0.7167896943098373
131,1718419942,1718419947,5,0.9847168040936414,4.928925457737222,0.7819821851038437,0.33890740526700164
132,1718474182,1718474184,2,1.4161965512689179,4.86203926929985,0.707805213192854,0.8478139873585888
133,1718481862,1718481866,4,0.7321517241841223,3.436053367118311,0.112219616833122,0.9033809739344112
134,1718516602,1718516608,6,0.8065924081760122,3.741067750904038,0.6846354399262983,0.9026926663016748
135,1718606002,1718606012,10,0.8152349925586002,4.712513684497828,0.9699069104080532,0.6441937927423558
136,1718606242,1718606252,10,1.272532554702658,3.070700122410103,0.13435107639503413,0.2962185914687633
137,1718561782,1718561790,8,0.550003585131271,3.7457959464136437,0.3590230742708893,0.2596567350760413
138,1718645302,1718645304,2,1.0390247292116044,3.293189437788684,0.8589786389600571,0.2373428957272066
139,1718678002,1718678009,7,0.907656715204913,3.9970208822103452,0.1678113181439438,0.4153390932532901
140,1718752102,1718752110,8,0.7584294573551122,4.583897508224359,0.7703423326503066,0.8047761521427667
141,1718746282,1718746287,5,1.0192111369050303,3.145877120519517,0.6576142039580013,0.6964475823859972
142,1718702602,1718702611,9,0.8020296695482897,3.8501162751753,0.8174828415200832,0.8780592196300991
143,1718781022,1718781026,4,0.8593377669283748,4.6187277648870095,0.874539911702059,0.4360917822536191
144,1718790082,1718790090,8,0.6973752837013234,4.5606794785595115,0.9415337625509619,0.7830133294683074
145,1718831962,1718831966,4,1.2101470472865175,3.1007848317304507,0.3390066551855958,0.6320464254723912
146,1718798782,1718798785,3,1.2691597658046119,3.187306659624321,0.10188538806264957,0.6494746381369008
147,1718857342,1718857352,10,1.0389777222232814,3.127485437044954,0.9517022638782658,0.5546510750368673
148,1718885482,1718885486,4,1.4087120464627525,3.3440708945089783,0.5162876159049063,0.500947602807875
149,1718990842,1718990847,5,0.5080932809994307,3.015481268313644,0.8764678402976369,0.36263662238631755
150,1719015322,1719015332,10,0.6559675502610834,3.682571275193553,0.6758371733520794,0.595255739839934
151,1719052822,1719052832,10,0.8571207642930914,4.844529163951805,0.7304181332299051,0.36771082718877535
152,1719071182,1719071184,2,1.2578073089836215,3.964731719294579,0.9134258972093922,0.226173763301307
153,1719122782,1719122789,7,0.9693070125325708,4.020195374462648,0.4660039978695585,0.6614250365719755
154,1719192202,1719192205,3,0.9517737277092498,3.4385535227819144,0.9743415462221087,0.7997169503590066
155,1719196702,1719196708,6,0.8547996099418745,3.517726870067092,0.6818307895573009,0.7562146714496022
156,1719143242,1719143248,6,1.1482350773684402,4.86251879785913,0.7243439841369681,0.7282011420880153
157,1719153562,1719153567,5,1.2931759251158357,4.36584110429869,0.8016781559647476,0.49243145330723637
158,1719232942,1719232947,5,0.9720793844904817,3.4087291838978997,0.27985504507373216,0.6198280003822305
159,1719274462,1719274466,4,1.1861301850385684,4.904658282020405,0.6822759462819887,0.4571826026761453
160,1719231742,1719231746,4,1.0099278452332587,4.3722889840401,0.9954079443678473,0.38717638078055217
161,1719332362,1719332370,8,0.5037417876304542,4.005342653100891,0.45033793555548385,0.31673789103976824
162,1719360862,1719360864,2,0.6640477541274555,4.557673073738866,0.787349506845153,0.9573407020247793
163,1719337102,1719337110,8,1.4830248981948526,3.4783285848121857,0.3744514477094999,0.64235634972312
164,1719308662,1719308663,1,1.379965649989808,3.5287674095544848,0.8499660050892048,0.6943572638415049
165,1719468622,1719468632,10,0.8720728562651864,3.558411002480703,0.6595517800057106,0.2021062371358323
166,1719436642,1719436648,6,0.8554816118637083,4.543660356284889,0.9165976174251452,0.37576312036576376
167,1719438322,1719438327,5,1.191865730871723,3.7934841396835774,0.834939130650219,0.24911764585743143
168,1719554302,1719554306,4,0.9667262146261744,3.386349292691815,0.17780263210344788,0.6573161938083782
169,1719474982,1719474983,1,0.98524449404638,3.4586510886183035,0.49643107332087966,0.10317960014335886
170,1719484222,1719484228,6,0.5923066172832958,3.384118471234599,0.30482771675164066,0.6986338773619171
171,1719641422,1719641425,3,0.8981615529988674,4.775666968143347,0.38814215600068824,0.9551725447294919
172,1719566422,1719566425,3,0.5803445971246256,4.61847611512228,0.2098814718887947,0.4408957242340157
173,1719588202,1719588204,2,0.9623112247336642,3.3960364359068302,0.14664054008624833,0.7616997189610186
174,1719683902,1719683911,9,0.823822716698057,4.0787983393367595,0.1979108313817673,0.642192682730752
175,1719655462,1719655469,7,1.424262187469148,4.723606069517008,0.9421052974565453,0.910234123009529
176,1719787222,1719787225,3,1.1797698767706428,4.175065803188469,0.8112556173520857,0.8891473627163191
177,1719751162,1719751165,3,0.9309531365465329,4.135139466144697,0.6280814093385428,0.6743948628078875
178,1719767362,1719767366,4,0.7107545885612179,4.144018194027787,0.6840120522318609,0.28194555381073916
179,1719834862,1719834863,1,1.4374645687669887,3.192799543449069,0.6575586668309248,0.5200019887706647
180,1719955882,1719955887,5,1.459838312222003,4.171506640861368,0.8760994870116664,0.15388842545503953
181,1720043422,1720043428,6,1.353914007846251,4.21420022435243,0.8252724845558358,0.761880882449098
182,1720009702,1720009707,5,0.8116180442132903,3.6080633217617546,0.6180007739805359,0.4346073640224364
183,1720101442,1720101452,10,0.6588985639960225,3.640727129898717,0.9717094606031991,0.619100544309663
184,1720194322,1720194327,5,0.7175284037110868,3.9402702121913595,0.3491317305471363,0.9830344039570273
185,1720305742,1720305749,7,0.7142347085894629,3.1614116951185203,0.676669992657556,0.696541459827383
186,1720305982,1720305983,1,0.5812136167635663,4.758392344384115,0.19899306394076194,0.9822251404602682
187,1720282882,1720282884,2,1.2366364597582984,3.6071999766769034,0.7265692910029954,0.2955720705235174
188,1720295182,1720295191,9,1.4543040719135338,4.421859819978753,0.7358820056532758,0.6343706408874116
189,1720363462,1720363468,6,0.909586916783328,4.96794071541811,0.7382939371131357,0.8514055249692001
190,1720341262,1720341267,5,0.5943794944689484,3.1618646421712198,0.8310421360264649,0.17321640240625058
191,1720465222,1720465228,6,0.7894792070114666,4.381003032743129,0.6930419054536422,0.12608217703757202
192,1720521562,1720521571,9,0.7660346709570055,3.2671286157923323,0.6875046507887772,0.9695854238245972
193,1720509262,1720509263,1,0.5623877018299849,4.349193378611683,0.7595473243067347,0.7996523255184921
194,1720590502,1720590509,7,1.3801705220063418,3.7169269123385966,0.5461745236688507,0.564315786388794
195,1720625122,1720625128,6,1.2268278716549608,4.341510930582855,0.5598365078429612,0.74657594129584
196,1720762522,1720762527,5,0.6318488180071116,4.560694738136592,0.7124378656569297,0.8586530579408885
197,1720718722,1720718731,9,0.7654939015693644,4.819342968783529,0.9895140184050338,0.15518629780279367
198,1720682602,1720682603,1,0.856822668310492,4.659071997798051,0.833592189078332,0.12590468731490173
199,1720849762,1720849771,9,1.381587562894825,4.3349537030076295,0.37668432590303924,0.3290519785823124
200,1720794382,1720794392,10,1.2444479607524297,4.172202988936397,0.5036906800449947,0.26208732387921996
201,1720823002,1720823012,10,1.4839078918021613,3.171271291607913,0.5474227451316648,0.17264980478985598
202,1720781062,1720781068,6,1.1713265012611433,3.4997520073581403,0.4539189991858147,0.9486017672138566
203,1720866682,1720866687,5,1.3910263967421845,3.9065153418147807,0.6266817848607382,0.9853117307907786
204,1720937722,1720937727,5,1.3606158758359275,4.204433169616961,0.25138931523801955,0.36493948020314104
205,1720952782,1720952784,2,0.8036569986365459,3.278001305926164,0.8774332339977753,0.731814211781175
206,1721072902,1721072911,9,1.3091397242055915,4.055731886946534,0.5702690694206806,0.6516389565599959
207,1721102482,1721102488,6,1.3323701206444278,4.0707017623909385,0.7211598926874572,0.5801878589942605
208,1721085022,1721085024,2,0.8834221720487301,4.677344540133629,0.11724951397555891,0.6373703478952686
209,1721185762,1721185765,3,1.2489598873971643,3.741944746664962,0.9714912834659366,0.14147990777474845
210,1721250442,1721250447,5,0.7315239797086933,4.857489583623684,0.9295379086239082,0.991351043969045
211,1721237302,1721237307,5,1.4462530777347227,3.0028682848258725,0.34082120650788417,0.7299534439104636
212,1721218702,1721218710,8,1.4850390574255288,4.233726722426455,0.15737690209567684,0.35795427257424794
213,1721332042,1721332048,6,0.7929848568942383,3.930352893544959,0.9204646547985192,0.5829868262329614
214,1721349142,1721349146,4,1.379775516289877,3.6553549182328173,0.5220543571450577,0.5722183185762121
215,1721453422,1721453430,8,1.0537606888396533,3.352868865928258,0.5700560050991009,0.9849722007691077
216,1721410702,1721410703,1,0.7307822692019356,3.804370338236742,0.24554227376223853,0.18117059898327237
217,1721403862,1721403870,8,1.4644343109112508,4.953010983880163,0.38105782394376475,0.1765082902523153
218,1721401282,1721401284,2,1.0584853358916826,4.6139222261313835,0.2084009668271245,0.13007125818197376
219,1721519302,1721519306,4,1.0409474445126878,4.590755429056978,0.4723869826699528,0.2527012730300872
220,1721561542,1721561548,6,1.4090828508975468,4.957742257066917,0.4351115407819407,0.9125925574237143
221,1721718262,1721718265,3,0.5607750332551958,3.04326563203544,0.5553639251284588,0.7584559653624333
222,1721780902,1721780903,1,0.74615874684041,4.777905823872947,0.8197467009000224,0.7359327252997879
223,1721720422,1721720429,7,1.4282275217466291,4.4808670000056505,0.788404114535316,0.6122727132816822
224,1721835022,1721835032,10,0.7369222875133825,4.180687980820123,0.17279277835870135,0.9706129204046973
225,1721831842,1721831846,4,1.3633051635853128,4.344014301857419,0.9938410210612721,0.8035973039960574
226,1721828482,1721828488,6,1.4056771743728307,4.871639024787591,0.2670923449674277,0.455374179470027
227,1721908882,1721908886,4,0.7693267697941761,4.36797275092836,0.39083104198195073,0.5430661690144992
228,1721974102,1721974108,6,1.2497800037321822,3.7004698940404257,0.7631169166079258,0.27790712822580366
229,1722048982,1722048989,7,0.9669162985287693,3.341689784095273,0.47197398608072016,0.13723023132773188
230,1722048742,1722048747,5,1.3112835002053225,3.916516041657959,0.8166212138452159,0.9891669424365402
231,1721994982,1721994991,9,1.2892144741046352,4.267966442972764,0.8605478289292786,0.5549365400549241
232,1722023062,1722023065,3,0.8655573711158832,3.9063583231992105,0.17803096388241368,0.5216575278150597
233,1722106102,1722106104,2,0.5680893748449367,4.538598457551005,0.7196378588463777,0.9763849511703928
234,1722065542,1722065543,1,1.230631079298692,4.28220315519958,0.19761551363382207,0.9484480866606256
235,1722207802,1722207803,1,0.7215079381337524,3.0806890266245253,0.8185394312727513,0.7630500083559052
236,1722209842,1722209849,7,0.5104225107626389,4.764401858678065,0.8833351088909223,0.9900449885328064
237,1722159622,1722159627,5,1.3502574607119748,3.502193670756502,0.7521154153352644,0.3123064192062177
238,1722246682,1722246686,4,1.1115466550786686,4.061584442515523,0.8737426943437774,0.1147622540721602
239,1722249022,1722249031,9,1.2513969611909905,4.286711452863185,0.20931119721087404,0.8538127398332154
240,1722398662,1722398664,2,0.8100398813126801,4.274589544600869,0.16095132821466837,0.3996154222412601
241,1722330502,1722330509,7,0.597162707244184,3.498837024532839,0.8401127789201203,0.2893033926268173
242,1722490342,1722490350,8,0.9040462842319722,4.882132049218045,0.24402503811006251,0.5346319891328879
243,1722490462,1722490471,9,0.659634025793317,3.3181594051573344,0.26563274813849735,0.7468166731166634
244,1722410902,1722410905,3,0.6086937361032945,3.267125594467132,0.66504408377257,0.5465230350094085
245,1722548542,1722548544,2,1.4782292958101317,3.3673707156675965,0.8602751276026155,0.12021070917656039
246,1722529582,1722529586,4,0.8643589449972048,3.1561343541818427,0.9652029852457518,0.7440166664668685
247,1722564922,1722564926,4,1.211509341740891,3.4669015533884746,0.13213386011599842,0.3118776461026723
248,1722550822,1722550824,2,0.8664573096805731,4.429827800966178,0.26482513875674746,0.3493679275973611
249,1722642022,1722642023,1,0.9707730091615191,3.3354624348072153,0.3653319712304419,0.14766921186642595
250,1722657022,1722657029,7,0.724853844350749,4.913362060721591,0.7395082991863466,0.8086596746089412
251,1722704962,1722704969,7,0.7270839329012467,4.204737752943737,0.8878733346941469,0.7794015891258217
252,1722684142,1722684149,7,0.5911285746689839,3.306189305526032,0.9597825819943625,0.4611502836719551
253,1722671542,1722671550,8,1.40269018906156,3.094468148710744,0.7834160353440758,0.5734569490336952
254,1722727222,1722727231,9,1.3228771802140273,4.726698581691101,0.3633748299903533,0.2456503401891453
255,1722780262,1722780268,6,1.1196352690350704,4.680876254299822,0.8968697816709162,0.850999840605523
256,1722895762,1722895768,6,1.0470044940926817,3.5034976927035606,0.6527361941398685,0.8036507320023628
257,1722858322,1722858324,2,1.1573074586793477,4.73390244790928,0.5551203996621576,0.8280769653784062
258,1722913042,1722913048,6,1.0038427865610358,4.659307653706847,0.4477350614704194,0.4585206326369414
259,1722934762,1722934771,9,0.9868699605959411,3.676992733742652,0.42442827318826193,0.35633846972311733
260,1723026262,1723026263,1,1.0869545942590153,3.0945023717239106,0.6517905796101483,0.5070960553924464
261,1723113982,1723113991,9,1.0328689154704067,4.7337369139729075,0.47503759816552105,0.8291120577626453
262,1723167202,1723167205,3,0.6518556951918802,4.461088511713135,0.9785194899336253,0.707976713972719
263,1723138822,1723138826,4,0.7856389318158824,4.4946681129480295,0.6529875189565248,0.6410309491292229
264,1723133242,1723133243,1,0.7478129849115333,4.692558608714419,0.7060884484998632,0.5175294185388917
265,1723222102,1723222103,1,1.0928645415046376,4.8242203841326745,0.6113978288730583,0.14937173136453605
266,1723226542,1723226552,10,0.5462924759061103,3.510775655189395,0.6796380299270115,0.31401212810157975
267,1723199722,1723199727,5,1.188158108210463,3.0036904527725463,0.8716537586063076,0.7620254428611084
268,1723326502,1723326503,1,1.339037688701096,4.2647047981456785,0.9567972587774727,0.8643680105693029
269,1723290442,1723290443,1,1.2659763283431447,4.905517223905305,0.2728277134328392,0.9801067386540876
270,1723406842,1723406844,2,0.6719825344074489,4.064252772376513,0.2145307360411775,0.4495714594891861
271,1723430362,1723430371,9,0.5770844640972633,4.217342885942381,0.33292113310937566,0.45335502811748196
272,1723441522,1723441529,7,0.5797562699758667,3.8005609478775417,0.7945260172295636,0.2775410413957148
273,1723380202,1723380211,9,0.6218373659972537,4.367841595973095,0.3922296456564267,0.3410514237158373
274,1723448182,1723448185,3,1.2924199562716372,3.0410061800842065,0.32658698923345436,0.4019198008760677
275,1723518802,1723518809,7,0.9854719262616883,3.7333833507555956,0.10571796414205847,0.15357706247243771
276,1723504402,1723504407,5,0.9582103529409214,4.775955658262838,0.4764191859764033,0.24354795453480158
277,1723563262,1723563263,1,1.222425285675809,3.887964277085045,0.3951957591031151,0.17606402391786552
278,1723653922,1723653923,1,1.1535779844834078,3.303126618238132,0.6651125173922436,0.99577617233255
279,1723623742,1723623747,5,1.3115331948266848,3.449579669119011,0.6861672966781416,0.2634161285285683
280,1723721542,1723721546,4,0.7788165337930458,4.329637635929883,0.47934529399501713,0.26534356272960036
281,1723739122,1723739127,5,1.136306601171034,4.207746439643358,0.8562788794433633,0.6418151048816535
282,1723750462,1723750467,5,0.583273460517121,3.2384052682470545,0.32834712837982416,0.1328397758888233
283,1723830982,1723830985,3,0.7669944297509244,4.792232361412798,0.8426706013716465,0.575752421306337
284,1723861762,1723861764,2,1.1949692969525292,3.086867805020516,0.37505856352043787,0.7789366446224064
285,1723840762,1723840766,4,0.891549320106355,4.879053869299117,0.5763700658853964,0.8802336711065403
286,1723797502,1723797511,9,1.2152072873404896,4.5256814659014735,0.7801958701441912,0.5058450997504577
287,1723945342,1723945348,6,1.269466537277034,3.5535763297855603,0.3878516407383872,0.36776332066797235
288,1723939282,1723939292,10,1.361490387996745,3.6626391269911274,0.24320286829405935,0.9480896674935142
289,1723932022,1723932023,1,0.5864527276502842,4.795667493888521,0.7336607114075919,0.6288024729639788
290,1723980922,1723980924,2,0.9346217936941588,3.810216938586067,0.5963800829416309,0.8010556120667119
291,1724024602,1724024603,1,0.9267235491370251,4.836119814427732,0.1478380469353052,0.24246504986833095
292,1724001442,1724001449,7,0.7776659215307394,4.730401696903412,0.6647368396854627,0.1852272081431845
293,1724039362,1724039366,4,0.85703318670362,4.39861273562651,0.3984636963550753,0.12005060563007065
294,1724133682,1724133691,9,0.5169424523697225,4.857211855071762,0.9888574338384549,0.30360334838835745
295,1724124022,1724124024,2,1.0026926540108032,4.829359043992642,0.19726476807358256,0.7015295697198941
296,1724174542,1724174544,2,0.9926969298481724,4.286408217913094,0.834068132495089,0.5312369033148694
297,1724245342,1724245349,7,1.123581123421527,4.8390082532714,0.7829452467870834,0.3462238448248505
298,1724296222,1724296228,6,0.5305773136273368,3.082873675652505,0.5711449919922484,0.39293887985456755
299,1724239402,1724239412,10,1.2379887948719754,3.1652095724796645,0.9632020528662092,0.27586960728306403
300,1724239462,1724239470,8,1.2669624668386468,3.0945294887607067,0.9432205402691783,0.6830691698330951
301,1724387422,1724387430,8,0.9214590201604936,4.027525963872221,0.3217054096118075,0.8204344532531632
302,1724469982,1724469989,7,1.1441406962898437,3.9190542218978144,0.5472332512687449,0.7164496698343968
303,1724541202,1724541208,6,1.3558933307466572,3.233717519051681,0.275424306035661,0.9665651291396401
304,1724505742,1724505743,1,1.1908488616670383,4.951151052104002,0.6795771017871002,0.9844705050803846
305,1724554042,1724554046,4,0.8803034950095593,4.746838170637588,0.18252812018286874,0.12657451981280185
306,1724556982,1724556987,5,0.6536781910465788,4.163070917244457,0.49342029645934826,0.3027320695570888
307,1724618902,1724618904,2,1.202322414407484,4.83097242314686,0.28421370328296847,0.9303914846437623
308,1724653762,1724653766,4,0.849098704293149,4.587167294724692,0.15269918761019521,0.978133605813424
309,1724689282,1724689288,6,1.478287515778424,3.602619605722076,0.6387809214499586,0.19974720683486274
310,1724775442,1724775452,10,1.3604220704497618,4.365287065004783,0.8661337990623864,0.40155813270917673
311,1724774602,1724774609,7,1.2876630782115461,4.928380177455576,0.8350168107145229,0.575642779635697
312,1724887402,1724887408,6,0.7935566256533763,3.009278803653179,0.7043424039821472,0.33323212421742876
313,1724946802,1724946803,1,1.126573274578035,4.696213078367989,0.4212141558926159,0.7482638382811644
314,1724961262,1724961268,6,1.2267411175038174,3.168221633460152,0.14336414670175926,0.22920731226040747
315,1724920882,1724920883,1,0.94197563562019,4.712145367095103,0.859211988303279,0.9990516430743098
316,1724925622,1724925632,10,0.7096639638744998,4.455665520183098,0.1600354160567386,0.16943613334302468
317,1725018202,1725018204,2,1.134798861640332,4.787082204799684,0.6698473896834783,0.3618781521081925
318,1725077482,1725077489,7,0.6051836864422706,3.298744283313911,0.5707713158020202,0.3969765908151911
319,1725014782,1725014787,5,0.7977993772987627,3.420398705709528,0.14062612091679916,0.5972477326747379
320,1725040462,1725040472,10,0.5746886198333752,4.672372544979398,0.6880141797135543,0.19721943233771344
321,1725159562,1725159565,3,1.4421557205714794,4.463002132582618,0.6253689454192656,0.80096464651197
322,1725150502,1725150507,5,1.023687501387161,3.3219004910396186,0.23336777397961223,0.43078306400821686
323,1725186142,1725186149,7,1.086435808897423,3.1025513809978937,0.38038937906153936,0.21083256111263404
324,1725182362,1725182372,10,0.5564993028082695,4.106491830632724,0.5599218234942428,0.9735385065985106
325,1725325102,1725325108,6,0.7362424131218795,3.3594513249993785,0.48526579811145076,0.7332426289131951
326,1725283582,1725283585,3,1.1593997541948682,4.091986828840097,0.3998688960325737,0.42082523406763206
327,1725281422,1725281427,5,0.8010689432765098,3.222640144931151,0.9315165025951292,0.9372791272015762
328,1725359182,1725359186,4,0.6782368737378135,3.7902314917301334,0.8547698379597158,0.8457022149819712
329,1725384202,1725384209,7,0.8560511645640312,4.428051451041565,0.9951703190825711,0.928477233694624
330,1725355462,1725355463,1,1.2153389260139928,4.962695092759185,0.5825813868304118,0.9314107599966099
331,1725444862,1725444867,5,0.8338024211142353,3.3764820469712884,0.7164661119275074,0.25430232774204187
332,1725513502,1725513508,6,0.5013917378290764,4.854882744764248,0.9689806485889749,0.4863833106506359
333,1725550942,1725550950,8,0.7085633894288468,4.759510534059427,0.13579446319726385,0.9967004935566136
334,1725603802,1725603806,4,0.7582217852230791,4.3177079935614255,0.9708004635840278,0.44039526058898426
335,1725640102,1725640108,6,1.279988950346378,3.48995820956414,0.9202889693303172,0.9751746876817149
336,1725628762,1725628770,8,1.3734154073938787,4.481570681157459,0.767588126720723,0.9527209148719716
337,1725754882,1725754886,4,1.3506407091713486,4.092593003025148,0.8982053004833817,0.3761373861239129
338,1725772042,1725772049,7,0.7080574017907012,4.911619858225584,0.2323141708802059,0.940771204775968
339,1725799642,1725799645,3,1.321821105756098,3.829711916431575,0.7084265658557496,0.7653398175253889
340,1725861382,1725861389,7,1.1510744769121013,3.8727044360006393,0.4658455031836145,0.9355716257204412
341,1725897262,1725897268,6,0.780986016654976,3.3850931135048157,0.8242048987029643,0.4485286691507262
342,1725937222,1725937228,6,0.8216688711510928,4.729447362901639,0.7719118978283462,0.9393379741438839
343,1725932902,1725932911,9,1.393571690932766,4.20202798826887,0.543002593486444,0.4001335406380071
344,1725980722,1725980723,1,0.6388080951068474,4.420271946850338,0.5023636774598035,0.17898320530479492
345,1725980902,1725980911,9,1.2676132088057868,4.529497232540241,0.7921367721759633,0.7407177972604447
346,1726106722,1726106731,9,0.7890395798424503,3.8133925683813183,0.23911741588477364,0.4586243540266557
347,1726065622,1726065628,6,1.12900271399086,3.797863454114449,0.3857001547690416,0.6555256167181107
348,1726041382,1726041386,4,1.438388179762018,3.2164875124109944,0.3313774079617359,0.982725239343021
349,1726111642,1726111651,9,0.8630700102931074,4.638642127093467,0.37489477107080416,0.6544562928910552
350,1726155322,1726155332,10,1.068036923838776,3.5758242713112565,0.43605613375353147,0.7879632813735975
351,1726215142,1726215151,9,0.9197172305298336,3.928787200528483,0.6708744407720407,0.2535565642352322
352,1726230922,1726230928,6,0.5293264728336239,3.0308869413685584,0.5393452407748437,0.7280506051814307
353,1726259182,1726259186,4,0.7861577273169802,4.886098158356804,0.2927423737052087,0.4259202951072555
354,1726322602,1726322605,3,1.0422784858866958,4.841338653521427,0.4450687857571818,0.8411891171291088
355,1726300762,1726300767,5,1.112617835819226,3.077637844463421,0.8040386313014211,0.18673000669452958
356,1726322302,1726322310,8,0.7892921910357672,3.3586458871916243,0.48305782311949264,0.2254795857256164
357,1726396342,1726396343,1,0.7587297886833118,4.306251471818262,0.6899106591878812,0.1443553340692033
358,1726519822,1726519825,3,0.7934550023467124,3.3307312372928175,0.9344134599700981,0.24820453852520713
359,1726493002,1726493011,9,1.1909214269073196,4.536897056113705,0.3235309542403284,0.45479022150675386
360,1726485322,1726485327,5,1.037500909462471,4.595974567441749,0.3880740779174936,0.9257860584653009
361,1726600462,1726600464,2,0.8348149609082821,4.170079918350619,0.2919540747891346,0.3904998526681086
362,1726559302,1726559306,4,0.8455247388015587,3.6575456963927784,0.1465203900806579,0.8868003493703919
363,1726597342,1726597343,1,1.4487779900043063,4.065810056921702,0.4044700185561644,0.44727786010127757
364,1726602862,1726602869,7,0.6803373916038435,3.9951960382564113,0.985325805355428,0.10428785911491882
365,1726724002,1726724005,3,0.7992112824162176,4.0065956926754085,0.3074928723092091,0.21635927196648624
366,1726683142,1726683152,10,0.6052024059121535,3.0670772503448474,0.39130644193192643,0.8377745449990723
367,1726788502,1726788503,1,0.8191431920308979,3.096160534936528,0.861269509793137,0.19072863601433715
368,1726738822,1726738823,1,1.0379440231435564,4.322986369647411,0.3959391312650461,0.5739682893223449
369,1726882102,1726882110,8,0.9787537540620533,4.4061755600084975,0.9811552300395823,0.6656405494994447
370,1726895902,1726895911,9,1.4015749498147874,3.2872935623634314,0.4918682025040736,0.8192587196191368
371,1726972882,1726972883,1,1.41048180966015,4.702743477347873,0.10862897255987002,0.3714080141749473
372,1726934782,1726934791,9,0.8090777086171295,4.899866084305778,0.5281501410721339,0.5983360869526286
373,1726970722,1726970731,9,0.5246880993018553,4.008862920707982,0.8004233966632518,0.466901145755402
374,1726945582,1726945590,8,1.2725350280263186,4.601350246957213,0.15502476882165672,0.5808772779461653
375,1727051362,1727051369,7,0.7138149579751529,4.104254524262425,0.30404827451063454,0.5450087420284243
376,1727001742,1727001749,7,1.1500842082595282,3.1947613918589743,0.47722173046189054,0.1582274583872762
377,1727077042,1727077047,5,1.4376603172837963,3.278919233899358,0.28917820739800704,0.3334412594124278
378,1727202562,1727202567,5,1.4502069441184855,4.0692060169487245,0.4388755226039326,0.7759985558921343
379,1727334322,1727334328,6,1.3740096001400017,3.218757459427627,0.28507473985126897,0.2600881090011734
380,1727375782,1727375785,3,1.1778792383920083,4.8836010193220165,0.857374650038859,0.28051948290174855
381,1727471062,1727471063,1,1.0196667575759255,3.4888632272974434,0.8377416054743879,0.15800243510738413
382,1727486002,1727486011,9,1.4070602760566278,3.90332609367194,0.9027674280386285,0.36550876180722547
383,1727583382,1727583392,10,0.5559855857728505,4.89938268482017,0.15190200805530113,0.7584324849598568
384,1727554762,1727554770,8,0.6097841155092454,3.53107545451126,0.9847977142086628,0.8570030528463234
385,1727658922,1727658928,6,0.7951150413668386,3.5755589367210914,0.4441349980191234,0.5475739409366264
386,1727600242,1727600245,3,0.8380548616382135,3.672397418629365,0.19675619996883748,0.5024886177178991
387,1727673682,1727673689,7,1.0877197322377012,4.79086484045054,0.6348874722401471,0.8102206854872751
388,1727745802,1727745803,1,1.3003004143757955,4.453446048862103,0.6950281576312664,0.11887115335206798
389,1727733382,1727733392,10,1.2580570509675586,4.741585517188051,0.46630514099931675,0.518301754521932
390,1727769502,1727769512,10,0.8673477122181108,4.332024975741101,0.3486623813329226,0.37056957484673203
391,1727840182,1727840190,8,0.922505211409917,3.2825307890865503,0.2835765816804302,0.6446682309868864
392,1727882422,1727882430,8,0.8288162543428362,4.053481785402721,0.3384796892646879,0.8137197754370351
393,1727920462,1727920463,1,0.7477726710914806,3.464486527277554,0.25454953193678476,0.2821417360451369
394,1727930182,1727930188,6,1.3027259476975352,3.6124567827932834,0.24317783582092573,0.6466308209552973
395,1728022882,1728022886,4,1.4421196627487016,3.6312847606808702,0.8396694792681938,0.3146974861521298
396,1727997322,1727997328,6,1.2457795179867603,4.566490020708136,0.4166030387343673,0.30033285492357864
397,1727944162,1727944164,2,0.8068303637668676,3.481380179095836,0.9543745743449616,0.18667398865713652
398,1727954182,1727954187,5,0.5381466494400798,3.0574526287748514,0.3379951628930088,0.21347436023779798
399,1728093682,1728093687,5,1.4660710629043532,3.8108769912001446,0.788800157370735,0.25029422470969176
400,1728099202,1728099211,9,1.388255474038793,4.597713809237552,0.6340297750927322,0.4510264381514659
401,1728097102,1728097109,7,0.5340994143936719,4.7121369744774935,0.9855447373248789,0.4500732717851852
402,1728151342,1728151346,4,0.5367623339428674,4.145807845316897,0.17398963455539973,0.7489789011703738
403,1728158842,1728158845,3,1.183213867508793,4.821369906925486,0.31931078229971654,0.28330037281962395
404,1728138742,1728138751,9,0.8108249787224492,3.4278486435708393,0.3657068115666381,0.6603338724248923
405,1728215662,1728215670,8,0.7451626820890623,4.148928200930671,0.6592292993895624,0.5998716898548878
406,1728283102,1728283105,3,0.7633680646732383,3.523469591654117,0.7442401409724271,0.16442927457674297
407,1728214762,1728214768,6,0.8752200165572185,4.1088424980476255,0.7528787535057816,0.507920216480183
408,1728344722,1728344727,5,0.9481939892362421,3.473428516382233,0.9758494203777583,0.9011951615021423
409,1728362542,1728362550,8,1.3230446829830247,4.204635018755647,0.509300478940694,0.8997693236391889
410,1728324682,1728324686,4,1.0942279367144292,3.915936460983243,0.29200347543599575,0.2102399299590977
411,1728446182,1728446185,3,0.7754602355605569,4.64926203522011,0.8786704243304766,0.31615244808384263
412,1728434302,1728434310,8,0.8301505965477928,3.36426356842132,0.45555756975295436,0.5423133943810026
413,1728405322,1728405324,2,1.3477589812214585,4.31420809090902,0.1844471788629937,0.22097680673670783
414,1728404182,1728404184,2,0.6385208864129718,4.098358028750739,0.8286006035034451,0.6919297630778339
415,1728492082,1728492085,3,1.1414637542098678,4.241183480373965,0.6582176900485813,0.7040610525743112
416,1728516742,1728516751,9,0.974870740787236,3.1113219895087463,0.31493681104756654,0.20059744346452027
417,1728610702,1728610707,5,1.0099833315526203,4.999325283530062,0.8655298455884762,0.9211556785804842
418,1728688042,1728688051,9,0.8996133329546122,3.395708428910131,0.880053022299265,0.5869837602673349
419,1728733102,1728733112,10,0.5693707618601128,3.4594710065176995,0.44272240406449515,0.35475158913034577
420,1728739702,1728739707,5,1.3817468650246088,4.291769351283606,0.5344584931461258,0.5409804196607367
421,1728754762,1728754766,4,1.2337970009002217,3.7164166011166744,0.5050064580272432,0.8700322669930708
422,1728828382,1728828388,6,1.0016201892829402,4.372278415701972,0.18913932247382778,0.17533656787577545
423,1728850522,1728850527,5,0.861719940331831,3.939880543837428,0.8325391171871089,0.4846265817972901
424,1728909262,1728909263,1,0.5079721545152255,3.0029918389165786,0.35373713466274725,0.4279053222628558
425,1728926002,1728926011,9,0.9743955621499786,3.3371525895894028,0.19076451149314194,0.2583198020842242
426,1728922162,1728922172,10,1.2407228956293532,4.365623360824704,0.23797809747559234,0.6830716567538545
427,1729035562,1729035563,1,0.7572861538411841,3.693508097527407,0.9491416675952362,0.8140345724201052
428,1729056202,1729056208,6,1.1569182659224724,4.4805624964586475,0.611052247306334,0.7173616332927074
429,1729109962,1729109971,9,1.047624441274384,3.416049376970084,0.6792088873063805,0.4664086988073629
430,1729076722,1729076724,2,1.247723759696044,4.281715994466501,0.6434094901396853,0.5962593597902042
431,1729085182,1729085190,8,0.6385476439407867,4.832733165312292,0.5515001322869756,0.48275846974005987
432,1729141042,1729141049,7,0.9427125479436482,3.2456210840911037,0.10596102507173108,0.8561755918747574
433,1729208842,1729208848,6,1.462454993902373,4.955863681546603,0.7822012722155727,0.6047188095929508
434,1729231642,1729231648,6,1.027342250187073,4.398056547103055,0.3541073425278216,0.6591312476306889
435,1729288462,1729288471,9,0.6981326333034075,4.932885831190315,0.2037103137026846,0.9490787380308381
436,1729371622,1729371626,4,0.8392387038642976,3.9811292682231265,0.6111354703113142,0.7105761525298773
437,1729450702,1729450712,10,1.0937145292966963,4.111972119423121,0.43514800008472243,0.9898306393498749
438,1729428322,1729428328,6,1.0858425051501879,3.8784187776551695,0.36958105935465857,0.7363468206409459
439,1729441582,1729441583,1,1.0838232535739807,4.625950325682673,0.986281767431748,0.5399662866523851
440,1729549282,1729549286,4,0.8147633186122492,3.921951276434587,0.693680471360974,0.2035338519088133
441,1729533442,1729533446,4,0.9085417489864596,3.7646065961396387,0.8068136793182908,0.7437324540097271
442,1729572682,1729572687,5,1.4412223240657536,4.943472892739569,0.1649389070769543,0.3414207235866191
443,1729529422,1729529427,5,1.0563135931950742,4.827926633929344,0.483935230824465,0.7698920901033186
444,1729584022,1729584025,3,1.2292112288282502,4.980942943566648,0.7876544749882286,0.9405494043703242
445,1729584382,1729584385,3,1.3071121415649327,4.14219916942928,0.776164607210878,0.9665690702681959
446,1729739122,1729739126,4,1.1842548171868246,3.0271084439670606,0.706555440608758,0.26802160666039926
447,1729713682,1729713688,6,0.9629315037033419,3.777493285359621,0.9002847828541778,0.9231071425351296
448,1729746022,1729746031,9,0.9577498869552535,3.785649937332624,0.9491979420158799,0.8241193558508767
449,1729804822,1729804829,7,1.0961748349996945,3.9598494183055366,0.10578809820182662,0.6952905518093135
450,1729802842,1729802848,6,1.3476867267860522,3.890848854600578,0.9756049914311741,0.21824427999297796
451,1729892842,1729892847,5,0.9043286192091912,3.032700962196942,0.8166713184565407,0.7951087948234445
452,1729880842,1729880846,4,0.5894853395557681,3.878384211567412,0.39938853102670346,0.6327820156647788
453,1730001562,1730001563,1,0.579468971410075,3.9831297834595034,0.28556636669734814,0.7107751488268724
454,1729953862,1729953863,1,1.487198803417203,4.939737938613811,0.18882605111406808,0.5827055324300089
455,1730037502,1730037510,8,1.4806718654458717,4.860309178426914,0.672276346294013,0.4464787327358676
456,1730036182,1730036188,6,0.9317619781297007,4.020586591988609,0.5404251708950037,0.4802989443230914
457,1730049922,1730049925,3,1.1417085545571983,3.843092047851679,0.1884513805679533,0.4697480061307665
458,1730055562,1730055570,8,0.7970404498519656,3.446593865280886,0.7687412550585132,0.3727159324147681
459,1730177062,1730177069,7,1.3139529766540856,3.538809261149889,0.9890237115957932,0.6953252935452467
460,1730158882,1730158891,9,0.6135428472980702,4.0110203713685095,0.38582599439548626,0.35951360095985774
461,1730177242,1730177244,2,1.1970528313547488,4.041248143126585,0.71837667323041,0.813951424337099
462,1730108482,1730108487,5,1.1618077646861829,3.32512729218824,0.8846287233874879,0.23794308395655453
463,1730213542,1730213545,3,0.959428197527616,4.322020764359807,0.43417875981073584,0.4330722257623316
464,1730205742,1730205749,7,0.7723952187712526,4.697456106637262,0.12041861026556876,0.6397139575707983
465,1730186542,1730186546,4,0.5328294128439881,4.805271902156891,0.12229815335183693,0.9263118377571455
466,1730207902,1730207909,7,1.2371148160756078,4.200817703689341,0.5137376789448954,0.9819590989461563
467,1730330242,1730330249,7,1.0456839987014974,3.1016660445406,0.4226532370750038,0.8669134385840513
468,1730289442,1730289443,1,1.4767847877949658,3.403745138290531,0.9868949319615168,0.8140900293295416
469,1730279362,1730279369,7,0.9079672260316539,4.408541766927312,0.5615479003120203,0.17626600275715365
470,1730408902,1730408910,8,1.2948572504444975,3.2756996161869605,0.43790330123411814,0.1903331832131569
471,1730419222,1730419230,8,0.8084874649577443,4.4172782368765,0.7933015581314504,0.20197920098487937
472,1730393542,1730393544,2,0.7247406534527343,3.956739918373705,0.2131074486807613,0.7860355129953689
473,1730398462,1730398463,1,1.1530681746995013,3.316483494821586,0.10160917546580014,0.21135665769686995
474,1730495362,1730495369,7,1.126049485044418,4.664523511024733,0.22577614279018732,0.29049384642287823
475,1730544862,1730544872,10,0.6852927132477264,3.7739494704294057,0.1667790532652182,0.6264675572568095
476,1730567242,1730567252,10,0.6040308190428055,3.422302820803046,0.5377102230410328,0.8115491595548933
477,1730546062,1730546064,2,0.9102392088819045,4.677625975155995,0.683396432268451,0.3451228158126317
478,1730584822,1730584823,1,1.0774723943239717,4.080321795846499,0.898622188131201,0.31798272605795797
479,1730635822,1730635826,4,1.033527360236099,4.24638808649277,0.7509732599334319,0.30568737639498567
480,1730620522,1730620528,6,0.738579338676899,3.0285826905557496,0.6081728788909564,0.7890789218249317
481,1730624902,1730624911,9,0.7827857527712095,3.533390343719792,0.6554529809838923,0.20982101372753276
482,1730690542,1730690544,2,0.7894709971053192,4.155026315462736,0.917799740557855,0.9105838592494093
483,1730777122,1730777130,8,0.6886292735130535,4.006187076879699,0.36326656511636723,0.8106497931284989
484,1730715082,1730715083,1,0.9691998345550447,4.167039221766721,0.5641475399693734,0.6234572970812221
485,1730777962,1730777965,3,1.1568706119012118,3.6687926949095497,0.5156972205832214,0.2649727255817366
486,1730721022,1730721026,4,1.2465996098187788,4.730506030416054,0.44402376426003953,0.5777881690699239
487,1730870002,1730870005,3,1.2309808055701557,4.613340092350667,0.7196446761532189,0.5830851305513448
488,1730850502,1730850511,9,0.7469236790789137,4.659053583717838,0.6607139260671,0.5517312458163358
489,1730811202,1730811210,8,1.2341193902699656,4.904457623839859,0.5045409589141305,0.31805491071788394
490,1730946862,1730946866,4,0.5415146281904106,4.94189905276305,0.2754503165035866,0.30434688505291474
491,1730964922,1730964923,1,1.418316357653031,4.213210509913128,0.9363371878986783,0.5889389261162665
492,1731005242,1731005244,2,1.1256976265884595,3.750183096755648,0.21173161456725814,0.6361476596207081
493,1730974402,1730974404,2,1.3031079194490423,3.4612286821456095,0.9242357583210826,0.7466701282167059
494,1730972002,1730972012,10,0.7223264087032093,3.1530651393887026,0.9868594408281958,0.2998102024675223
495,1731072802,1731072809,7,1.2482952886169068,3.2296174598787557,0.6547168688508337,0.9510460022000434
496,1731196042,1731196052,10,0.9652543168305244,3.042406116973847,0.8400622369893337,0.2035982320649316
497,1731251542,1731251548,6,0.5299028222351923,3.338344297876658,0.4497321676039606,0.9022842609049373
498,1731282322,1731282332,10,0.7241302331661015,3.402440879523653,0.6154461233755257,0.5568481885621143
499,1731233782,1731233790,8,1.4800030641921536,3.6761001722652047,0.9048843277614088,0.30857943515368447
500,1731391042,1731391044,2,1.380442383182821,3.578860441382123,0.7968598296199703,0.6209771717295827
501,1731336202,1731336203,1,1.148532696504822,4.575428330341412,0.6189339717241186,0.35106121060663764
502,1731370822,1731370832,10,0.5333702282504099,3.0145733777269452,0.14065316280843237,0.5841065219233607
503,1731475042,1731475051,9,1.4609197054011058,4.3012043068081915,0.9408226519799351,0.33764642837471043
504,1731425422,1731425423,1,1.4827988090652093,3.5834056163300048,0.12096762929844573,0.9763042528854529
505,1731435562,1731435569,7,1.027545163522153,4.091786228072448,0.18533422166525065,0.43618474491749537
506,1731558262,1731558272,10,1.0179099446586923,3.5052666351253645,0.23546642961924358,0.5470163025839563
507,1731570262,1731570269,7,0.8702491558006225,3.37589090346209,0.9052751641712591,0.35122908272016384
508,1731700762,1731700768,6,0.8290609136679759,3.7347324035686125,0.3439765577166357,0.19048224209877146
509,1731680782,1731680787,5,1.4431195061343396,4.563728604649095,0.38393992634516894,0.8454035117783769
510,1731658162,1731658163,1,0.5424837657688283,3.4731830690124856,0.838660586972739,0.18999879397535102
511,1731683422,1731683430,8,0.5176806277591902,4.035646673999082,0.9447722602523108,0.26380449078810264
512,1731816142,1731816149,7,0.5100224246367413,4.521372058581453,0.6779645517416512,0.4431167788525172
513,1731799462,1731799467,5,1.189643047236761,4.767730844257506,0.11821319048691466,0.3781639014550716
514,1731773542,1731773548,6,1.1638702072293754,4.628006243338486,0.3390188080543102,0.6599088200469554
515,1731846382,1731846391,9,0.833800577437649,4.598234288696437,0.7202312615727124,0.13353626946861272
516,1731849742,1731849750,8,0.5963941636028254,3.909924650844763,0.26759418259864215,0.16340558006562844
517,1731888742,1731888747,5,1.0686906123572708,4.8978611166454655,0.5065237736620133,0.9601137633659098
518,1731892942,1731892950,8,0.556373618899849,3.25640260128681,0.7497175698825411,0.564662121738546
519,1731963082,1731963089,7,1.0983997716928444,4.038430039026425,0.6076593227632953,0.6776831894372176
520,1731926182,1731926189,7,0.5266211494624679,3.0569482366537075,0.5922173432508547,0.21112778913197788
521,1731983962,1731983970,8,1.01610497597656,4.017766610842121,0.45467420829930205,0.9123327779791693
522,1732058362,1732058369,7,1.1939493336917582,3.8928953813232745,0.14648682576715924,0.8209127482121076
523,1732126402,1732126409,7,0.9009625106542849,4.020224884619455,0.6669610654252437,0.3285789338791467
524,1732112962,1732112964,2,1.0674157022746096,3.9371713127873735,0.8068319339698772,0.34117482331482546
525,1732120222,1732120229,7,0.5222527270619272,4.2690577648812615,0.1310775981639684,0.8194872095224358
526,1732216342,1732216349,7,1.287465025613079,4.111501101777867,0.8696694698525081,0.9675701584056828
527,1732189822,1732189824,2,0.7735660453573402,4.595430940787606,0.5040679671327656,0.6277494947325309
528,1732287562,1732287572,10,0.8938424479115235,3.4957144144769585,0.3868959706659756,0.8809516502800101
529,1732417102,1732417112,10,0.7705337782549697,3.4324312627405202,0.8405007419655581,0.7731211011641372
530,1732351102,1732351111,9,1.340693572988556,4.706051746774214,0.7196848674915263,0.21705894889809368
531,1732355662,1732355667,5,0.8025182450153732,3.68049934560196,0.6381761888154855,0.9773450795503346
532,1732424122,1732424123,1,1.364802727813788,3.8400393604624683,0.516338172088259,0.5959489376047821
533,1732457782,1732457792,10,0.5331221338575103,4.551547863209961,0.3715151348837643,0.8223919637506574
534,1732441102,1732441104,2,1.0959599534811355,3.010986091609892,0.6608537837871649,0.973271667917147
535,1732460662,1732460667,5,0.6201325842569956,4.877503474033042,0.49232330219832254,0.370944993550538
536,1732484002,1732484011,9,1.0768341304088231,4.50355534644758,0.24289343061375984,0.9538036636516458
537,1732530322,1732530326,4,0.614589066918195,4.921061187867904,0.6935258221863391,0.8841031259507776
538,1732574722,1732574726,4,1.1190147828425652,4.4755291477543695,0.2128915039095255,0.9073512001031341
539,1732584922,1732584929,7,1.4737028423648006,3.9095572015751463,0.4854414840585741,0.9185854135620263
540,1732569322,1732569332,10,0.7496341141021418,4.517196659994063,0.35772619126292504,0.2844038836027045
541,1732658602,1732658612,10,1.040339098611188,3.7237813161013253,0.5725551470500709,0.9489843198922747
542,1732663102,1732663107,5,1.097652935737984,3.916157924540684,0.2251517001144073,0.9172766120142666
543,1732610302,1732610303,1,1.0527737028785977,3.1620551031879076,0.9619896906771096,0.74735407704394
544,1732656562,1732656565,3,1.3625412259590268,3.557841340460755,0.6247477773304305,0.12719633826022325
545,1732722142,1732722148,6,1.3184525509208804,3.2657888453387582,0.29439312445597937,0.6573744153832776
546,1732824802,1732824803,1,1.1228602710074318,3.6308845088402406,0.8423744499732423,0.4228860466929075
547,1732799362,1732799363,1,1.3091997648676148,4.965457235513692,0.4113473785619197,0.9267777004468429
548,1732780582,1732780585,3,0.6530981487473255,3.3246172196404338,0.8671122598234292,0.1736414408240244
549,1732906462,1732906471,9,1.0553665679325288,4.061110540432943,0.6393131521099247,0.20344172027690072
550,1732978102,1732978104,2,1.1712790380760771,4.5474527627564925,0.3031092412417309,0.26379097484034403
551,1732997722,1732997724,2,1.332395901279865,3.638941541822125,0.8183692243523215,0.5108129104014603
552,1733048662,1733048663,1,1.0230299436990211,3.8887641727347813,0.2463880808540911,0.9964351656945887
553,1733078062,1733078065,3,1.0839954549505242,3.984660311096322,0.7420941110128912,0.8533157479366883
554,1733198002,1733198012,10,1.4789533227640597,4.662877940757928,0.28542636060284293,0.3145169772997648
555,1733229322,1733229323,1,0.5214602614231516,3.2088916449141935,0.19086961758893228,0.9755718373224569
556,1733228002,1733228003,1,1.0258000116859414,3.575780979960311,0.4742961828319734,0.11240428101181016
557,1733267782,1733267791,9,1.4376761144581356,4.521256822388795,0.8672742994794818,0.34519033486419765
558,1733243602,1733243606,4,1.449330275388168,3.188235136371828,0.6796153220316916,0.7210691194089478
559,1733349562,1733349567,5,1.4664938978394126,4.468250190087255,0.5114772466949233,0.7157925569365596
560,1733310922,1733310928,6,0.542953540240672,3.7131650256651225,0.7589003071936491,0.5552675838367387
561,1733362942,1733362951,9,1.3332300783415145,4.856525451811933,0.399122813293327,0.24486488196384687
562,1733318002,1733318005,3,1.4927085884818576,4.160240919892399,0.7541971749724008,0.661663160575109
563,1733448202,1733448204,2,1.0653475898723386,3.50419578875574,0.9577854131741596,0.8233375308144888
564,1733432902,1733432907,5,1.0367238422766412,3.7811917683417686,0.567761757103814,0.7058559705002256
565,1733451682,1733451691,9,1.4279279056779641,3.6498290436432947,0.38863108546789515,0.3810080374836925
566,1733514202,1733514211,9,1.0232626782168515,4.870977636606184,0.2754145296699898,0.44304805982933293
567,1733547142,1733547143,1,1.4353943231171844,4.626463816791883,0.12646884390397264,0.8542060698296631
568,1733599222,1733599232,10,0.6151110373216492,3.8777495776139683,0.24775795214502389,0.29564499913752545
569,1733600842,1733600849,7,0.8714477688852997,4.925345002357073,0.57526605210715,0.26967227533460986
570,1733658502,1733658504,2,0.6757148159029192,3.8189608206872876,0.4494732070876921,0.9201836328362452
571,1733708482,1733708489,7,1.3271910845151516,4.847913890829789,0.3545691459805609,0.8061740074910788
572,1733768962,1733768970,8,0.7970906515240122,4.0807354729197005,0.6976156492848195,0.5879565311338921
573,1733735722,1733735727,5,0.8414720754903527,3.4556009317038368,0.18592497000704555,0.2851936058946807
574,1733804062,1733804065,3,1.473428331349825,4.97993646199561,0.8789157449266549,0.4003962593256092
575,1733899702,1733899706,4,1.1039456347620389,4.688510894574856,0.5294814250139024,0.40748063190859274
576,1733914822,1733914830,8,0.9072607234040834,4.467148544909826,0.8870478709800659,0.8464088616704808
577,1733996842,1733996849,7,0.8577034635562794,4.380920058987383,0.9556998370164601,0.6244626514582956
578,1734021862,1734021865,3,0.5170070518379531,4.127213267160403,0.25642668497341736,0.46962380302120055
579,1734088882,1734088883,1,0.5260585853558083,4.522438728473683,0.9092123234521639,0.2819021893200458
580,1734111922,1734111923,1,0.8823700466671953,4.660467903083355,0.2993599846356778,0.4112574930614854
581,1734122362,1734122365,3,1.2469943733798212,4.094155170389614,0.5272603426966469,0.67339045520275
582,1734161782,1734161788,6,1.4229925415674805,3.084651397316282,0.7138278490468979,0.41217385674345874
583,1734163342,1734163352,10,0.7802639183557114,3.798663606986784,0.7995111182198245,0.6774152408987485
584,1734285142,1734285149,7,0.8531181208463888,4.135264308356507,0.5742173300824739,0.2527186822582952
585,1734282922,1734282930,8,1.217642392859947,4.633444657543929,0.5532196306984183,0.11728499261900012
586,1734328702,1734328710,8,1.3671915385797995,4.09834152069682,0.2640552579532486,0.1934426163849814
587,1734360562,1734360564,2,0.9391588424666087,4.148538849925211,0.6239847541875044,0.2648115485983107
588,1734385042,1734385052,10,0.5709738649729788,3.6313031936683675,0.7657553973566587,0.374721954876968
589,1734414502,1734414510,8,1.2123449804387842,4.620744556016715,0.39482767602931335,0.9013156172289177
590,1734482182,1734482189,7,1.0275895529854746,3.9424255957568004,0.8856901224332305,0.44928749766957843
591,1734477142,1734477149,7,1.144530377831086,3.8416524987471927,0.6382811098881047,0.17417773338457532
592,1734484162,1734484170,8,1.234095318735177,3.6322433641330933,0.5403235960465038,0.6417241961870024
593,1734457222,1734457224,2,1.079842617051675,4.933009121303684,0.5661731926516491,0.6404334994111267
594,1734573322,1734573332,10,0.9595689254514598,4.774212378990145,0.8670045478812017,0.42150641018315205
595,1734640342,1734640347,5,0.7351862261849924,3.0003033471057936,0.44118727364170174,0.648903419035884
596,1734611362,1734611369,7,0.5987147999329423,3.265726843435009,0.3757934212974995,0.4604094461414867
597,1734684442,1734684446,4,1.334863805218648,4.89545811604134,0.8867855054088162,0.7407337408601586
598,1734742462,1734742467,5,1.3911783622420826,3.776344951356392,0.8683697779876058,0.7423953359562795
599,1734735262,1734735264,2,1.368246051734639,3.78568881827737,0.6512291397189062,0.11328870943152636
600,1734849982,1734849991,9,0.8021856992772356,3.645253405042169,0.16235731085793675,0.25479106242977545
601,1734843922,1734843930,8,1.365520570634947,4.391898874135971,0.5193886531538074,0.23289911876767005
602,1734771502,1734771505,3,0.8719350309893172,4.653802956945268,0.41080511239224027,0.9740894586198389
603,1734805342,1734805346,4,1.2248239207247225,3.979499826452397,0.5163206768930778,0.21111362679297763
604,1734895882,1734895889,7,0.9710206276548016,3.040700030529969,0.8083446312669281,0.372162536356639
605,1734887002,1734887003,1,0.7265936871016382,4.200470086123374,0.21441186654281824,0.1791797761762593
606,1734933502,1734933512,10,0.6769606883007794,4.3937771821791305,0.28381680038286916,0.21792047554029786
607,1734988522,1734988531,9,0.7990211469857939,4.059875097814117,0.2000817243071062,0.6578430893063197
608,1734959422,1734959426,4,1.1795625834494738,4.518722525233125,0.8768225508248456,0.1509461333991076
609,1734966862,1734966865,3,0.7038527740174659,3.82440271722979,0.15381743837941173,0.5912024125223816
610,1735016542,1735016545,3,0.7483762302827905,4.494574813985183,0.345354604790414,0.34307654196777815
611,1735081702,1735081712,10,1.051992524070204,4.03273370382964,0.16688138917369907,0.23263532475646895
612,1735127962,1735127968,6,0.7699404087444907,3.578768208847662,0.22325912370059753,0.12295236281002012
613,1735170742,1735170743,1,0.8590513885684635,3.0011213683816083,0.48404693819342437,0.9615737143334235
614,1735205602,1735205608,6,1.33945171728103,4.529947387979482,0.9025209411600916,0.3793994878831306
615,1735303042,1735303044,2,0.7214481663327063,3.359486465365226,0.22152129348867583,0.2946703472282758
616,1735288042,1735288052,10,1.4684540842838065,4.502482618920256,0.4308549504539342,0.3387943108969668
617,1735398382,1735398383,1,1.3851630655521898,4.782116123070312,0.6826857438678755,0.9239049043830835
618,1735422922,1735422931,9,0.581878813311196,4.151479052444847,0.2725603150374768,0.4272458886104682
619,1735386202,1735386207,5,1.2886485726334338,3.0378640052642325,0.427619171117682,0.4378034544987057
620,1735460422,1735460423,1,1.1078087814690807,4.398333486172763,0.9878544107075499,0.28976740994517314
621,1735534222,1735534225,3,0.5877416807814168,3.1152450554776805,0.8712382853448191,0.677471057785198
622,1735540702,1735540703,1,0.7304699923539516,3.957515473632359,0.3292895003005102,0.7123947629573694
623,1735461862,1735461871,9,0.8659293726948893,3.094027194196957,0.5901523408111479,0.7269316446183484
624,1735562482,1735562491,9,0.6000208571252653,4.804739131755144,0.8236502457375865,0.4923430534195
625,1735601542,1735601549,7,0.7086356942976814,3.9484492487871505,0.10108153091350236,0.6057620605258046
626,1735621342,1735621344,2,1.2982124548213174,3.9239548257636394,0.47368368544802075,0.36491904395673624
627,1735637542,1735637549,7,1.4235360019565713,4.751556314002716,0.6693219899218728,0.6716294629272959
628,1735796062,1735796063,1,0.6614733188035248,4.254257542965192,0.7530637462877834,0.7968942817979409
629,1735809562,1735809563,1,0.5740129367743896,4.290948380929881,0.8710858470586311,0.31868469585978776
630,1735908082,1735908087,5,0.5528878645303883,4.310817762671931,0.25161367522979844,0.4675453633202812
631,1736031622,1736031630,8,1.3641323396832574,3.8027350908554474,0.9522239998650983,0.44934215509080355
632,1735998682,1735998684,2,0.9878753665712723,3.0469366102210964,0.8817472580761594,0.6880086903370927
633,1736050882,1736050891,9,1.239424516674644,4.7864114733788306,0.25927963556090805,0.7460185708868569
634,1736020582,1736020589,7,1.151492895342718,3.1064408671326778,0.5294507051984254,0.1580783662552876
635,1736145982,1736145983,1,0.959647136455645,4.502734900830892,0.7111820438500298,0.6738360660838445
636,1736126962,1736126972,10,0.5585312892895679,4.686799592203386,0.24741704996451486,0.25820336117638615
637,1736073622,1736073630,8,0.6726674476615931,3.460627712437763,0.5495513657977724,0.3080517840390897
638,1736096182,1736096188,6,1.1833305276846353,4.2820955423505405,0.430464556061544,0.27563847331355795
639,1736178502,1736178511,9,0.7989436443665817,3.5418547624940935,0.2375547166346365,0.2908165010463326
640,1736228362,1736228367,5,1.1094645705178436,3.785465998139662,0.8123737269129059,0.8754148873822459
641,1736290342,1736290343,1,0.8011428347806231,3.626425840427875,0.3903951673366861,0.5056550322664841
642,1736349742,1736349751,9,1.2362395245325888,3.572482523200998,0.43051175643889994,0.29041679398111875
643,1736415862,1736415870,8,1.4326517694260645,3.034884608268645,0.22674080252831977,0.9454228685868205
644,1736439742,1736439748,6,1.1361300837359587,4.712517589051226,0.2334194313194724,0.6203542567034
645,1736521462,1736521468,6,0.5981648999743521,4.6965920001196775,0.1328059342267152,0.4075737814984959
646,1736502982,1736502988,6,0.6288841768281813,3.164194488220628,0.6147783376781065,0.8900679831465015
647,1736564122,1736564127,5,0.5467687480337167,3.7867893102483414,0.6334886679159023,0.7545293839130859
648,1736578582,1736578591,9,1.1728104863364806,3.9392616542162635,0.6951979316758395,0.16383575635463055
649,1736654722,1736654726,4,0.8287306556647163,4.453951310618146,0.48573984755825017,0.3960835660311406
650,1736580562,1736580567,5,0.5350051917868154,3.980627928445679,0.22969729931128752,0.7568517515945972
651,1736598742,1736598749,7,1.0565368869248222,4.404903366768127,0.9083203696869458,0.7798863030494781
652,1736662462,1736662466,4,0.6832015489083009,4.669339644816936,0.7263242998016538,0.46875042337390105
653,1736729242,1736729243,1,0.6733780393078469,4.228027921361996,0.2083782563122703,0.678229595404131
654,1736750482,1736750490,8,0.6138585674448517,3.6790628354521426,0.9068822344592771,0.9006890049621459
655,1736825122,1736825123,1,0.8384974961828091,3.0716073433128632,0.4959626204275195,0.5646929207666361
656,1736799562,1736799568,6,0.739094100647853,3.160077134634606,0.6213097907730648,0.6221668620240438
657,1736791762,1736791767,5,0.6411397934946729,3.309596994600301,0.16575284882822483,0.5680347778887572
658,1736902042,1736902045,3,0.5941089579996989,3.154636530067613,0.38548624755789995,0.38942623883714866
659,1736996362,1736996367,5,0.52783249740907,3.056535188420681,0.8536432515559954,0.7905512536597721
660,1736985442,1736985444,2,1.2351425530184699,4.3434351637864665,0.32638157278382207,0.8274379040740663
661,1736980882,1736980883,1,1.4354296479059032,4.468997488471779,0.7165426249351874,0.5299938991897482
662,1737005662,1737005671,9,0.8611821227946264,4.19594615159158,0.23369232432173992,0.9231560826591604
663,1737043882,1737043890,8,1.250290776036488,4.490441273789852,0.18027413789800395,0.4553121909181066
664,1737079522,1737079525,3,0.8987359676668822,4.205480381981042,0.3233814570745739,0.5530589526250035
665,1737139102,1737139104,2,1.0076983028380861,3.692224090763075,0.8698317619256098,0.8972286640946556
666,1737189682,1737189687,5,0.7717646896821472,4.944471821114515,0.5626677603696472,0.9428715028875274
667,1737186442,1737186451,9,1.4364742639950798,3.4904533283294468,0.49818711327164167,0.3078576227854063
668,1737185722,1737185728,6,0.7919016912941762,3.3501069100144325,0.979160048880999,0.1467049379053663
669,1737291142,1737291152,10,1.4336958923726053,3.4453717676730684,0.534037092139024,0.18313623375267069
670,1737382522,1737382529,7,1.1415752497446392,3.962471201358608,0.9186143453229555,0.4783952993609609
671,1737442102,1737442110,8,1.3265488713803617,4.084286293279866,0.9404372257427421,0.32098895721337867
672,1737418342,1737418346,4,1.4083909690001066,3.8748619137920777,0.26055785906038476,0.6648875288071912
673,1737528802,1737528803,1,0.8103320305129786,3.3135436038742316,0.20327897406983925,0.30247454270033103
674,1737558922,1737558924,2,1.130854840399814,3.1121699916235483,0.8349853730990892,0.3028938565074102
675,1737649162,1737649171,9,1.3059519902923529,3.7892337250900017,0.3752009626583638,0.21828573713530425
676,1737723142,1737723148,6,0.5975981849482661,3.6778637530521507,0.12882526196054755,0.3026787962760795
677,1737824962,1737824965,3,0.6993735461031378,4.400137278942662,0.8656723847902663,0.825574849756694
678,1737825562,1737825564,2,1.3670839501731553,4.409463553578733,0.6681461310811397,0.6175789967267407
679,1737792202,1737792203,1,1.3527751294366408,3.5640308973459236,0.4970638407035576,0.2303060002245894
680,1737848002,1737848012,10,1.1019139565054625,4.761988372577598,0.3168389965995007,0.9916825019713449
681,1737937222,1737937228,6,0.7291267521645521,4.507217688649051,0.8487391597634193,0.30680661450233404
682,1737929482,1737929486,4,1.4813600737120913,3.138241938737555,0.9656681018593652,0.622467607102577
683,1738032442,1738032450,8,0.9250607389518213,4.246329768865801,0.1894997588795716,0.20906277642577914
684,1738066042,1738066050,8,0.5375603118167851,4.576599031631112,0.6254450048339243,0.32267316086462317
685,1738113322,1738113329,7,1.4181219895469868,4.558923197625378,0.691671576596369,0.14423864607589454
686,1738055362,1738055366,4,0.6482752563403562,4.01118952159894,0.2687859566279473,0.877058263219523
687,1738060822,1738060827,5,0.506292987956215,4.1297421041298525,0.8493652829508469,0.2520385389370112
688,1738168882,1738168890,8,1.1933101608178704,3.8140063048484336,0.8673267040430452,0.3067477970960064
689,1738147582,1738147588,6,1.0812488375452938,3.5196113640737443,0.7758730762908229,0.1864117228960238
690,1738285702,1738285711,9,1.0849390070986429,4.752075680603651,0.18663704923293817,0.5322413915043268
691,1738306822,1738306830,8,1.4528100832008137,3.9702101528166613,0.547274401793888,0.7382331580483666
692,1738248082,1738248083,1,0.9372091889876953,4.988980372656405,0.6138364379440174,0.43228995570750894
693,1738264942,1738264950,8,0.8582630908730612,3.3209846947540234,0.7790426014814531,0.20075107171771955
694,1738339162,1738339169,7,1.022824582983857,3.9212983375317823,0.6331240477974656,0.3251460429719277
695,1738372642,1738372645,3,0.7524932748815626,3.742299931448752,0.3870182674865178,0.5038310031264569
696,1738370062,1738370069,7,1.3512766105822442,3.4802225120717676,0.4761401872874359,0.4677137397010652
697,1738374442,1738374444,2,1.0644726197981258,4.818871942649188,0.7256903478925217,0.439156252536544
698,1738407502,1738407509,7,0.8231508962751288,4.969425917569111,0.9175892848068113,0.9989810082663706
699,1738444402,1738444404,2,1.1769984023275586,4.358889907206912,0.7901483937391982,0.3248135043138035
700,1738425262,1738425263,1,1.0596294252959444,4.307850964549665,0.3804494017754765,0.2602711409031554
701,1738530562,1738530571,9,1.486644624624317,4.197048080240654,0.2097742412916347,0.7640816242564226
702,1738526422,1738526431,9,1.360330812968559,4.226626175234136,0.2018692989828253,0.9096584608003647
703,1738508662,1738508672,10,0.7196023215054963,4.913226202982991,0.6445525518672119,0.5564885221469912
704,1738617922,1738617931,9,0.9547379764387123,3.411104950746992,0.92717075473997,0.5600560857510601
705,1738595182,1738595192,10,0.7820130496011536,3.203424897365874,0.655492489942533,0.46021818356989685
706,1738626982,1738626987,5,1.012519337227607,4.767822317159133,0.7133371081487222,0.7511169975619818
707,1738629022,1738629031,9,1.2511190636291396,4.4967471667885714,0.9440810507813324,0.656118918351518
708,1738669102,1738669106,4,1.062725111667313,4.743511385447205,0.11981111258969976,0.30199988923784915
709,1738714102,1738714104,2,0.8872298892696401,4.768445753061894,0.14732803126284902,0.27815890754142447
710,1738712782,1738712789,7,1.1953423373014413,3.4044087530336027,0.2030682693062188,0.1022108460296932
711,1738717882,1738717884,2,1.4107817593194238,3.6309059872522567,0.2057060994381164,0.5862189153634872
712,1738750342,1738750347,5,1.1781285490360083,4.817114521284324,0.38498355408319607,0.5783221584433723
713,1738794682,1738794684,2,0.974212541035437,4.516676234905731,0.12836514213599096,0.32646395986628846
714,1738742962,1738742963,1,0.857885828758232,4.529054798881072,0.6140580241658029,0.8591828605307467
715,1738743082,1738743084,2,1.4447532899734297,4.3353070769913105,0.29215804646729293,0.1348747000101665
716,1738882462,1738882463,1,0.9517288816946807,3.085566896088931,0.45461321138706823,0.39616267705022634
717,1738911442,1738911450,8,0.9046193035072613,3.95716395546588,0.5441482905397734,0.9692979123197129
718,1738866142,1738866148,6,0.8289090751430724,4.637516649013845,0.1386818116565221,0.11586246302563753
719,1738858702,1738858712,10,1.441257258709113,4.902151264204543,0.7713254693049824,0.15200255474745253
720,1738980082,1738980090,8,1.4869711121832774,4.6041106236434715,0.49158240390944397,0.7710917729966348
721,1739011042,1739011048,6,1.4140333668139178,4.974687980216652,0.1689259985058504,0.604105372109115
722,1739045122,1739045124,2,0.5985771627957973,4.603203327158134,0.9648738032055866,0.12680428826148313
723,1739064622,1739064627,5,0.7198687664571679,3.0271422724595,0.29908145616474385,0.634386717190495
724,1739065642,1739065650,8,0.7811180372513289,3.020785480525161,0.9527752097167521,0.30246491958231825
725,1739160982,1739160991,9,1.1456298524799076,3.3718742912932735,0.12955827446939552,0.6013390466320581
726,1739154442,1739154450,8,0.7261638769995411,3.334106972756788,0.7501284108153021,0.6811453930967135
727,1739199382,1739199389,7,1.4754234172614606,4.287364309281602,0.37052043765135456,0.6785485404202207
728,1739180302,1739180309,7,0.9429640379556709,4.748375338464285,0.9503510209549464,0.9372128551361933
729,1739200342,1739200344,2,0.9022158452462276,3.137902683179309,0.5788405476682373,0.3279974736796054
730,1739176882,1739176885,3,0.813182131823898,4.741287928509987,0.8088935322111376,0.533641485344632
731,1739289082,1739289087,5,0.6638078552666514,3.5508410619365365,0.25771053592631554,0.5651371432656132
732,1739294962,1739294969,7,0.8030488292145319,3.3878491981818266,0.9614660529217814,0.33484975265172623
733,1739274502,1739274508,6,0.8982609850938359,3.2760999907911557,0.9797823058088718,0.9558951853308055
734,1739321902,1739321908,6,1.3274357171527442,4.222255435444094,0.2158317890680962,0.566905034250286
735,1739398282,1739398289,7,1.2751340307064696,3.568927615734581,0.9544848901358153,0.358612009868417
736,1739366662,1739366665,3,0.8244957370855033,3.000255658551509,0.9493339361500858,0.10650293961859436
737,1739466742,1739466750,8,1.4892683466386796,3.405464694993446,0.1492828369035247,0.6253469340947326
738,1739474122,1739474129,7,0.8364479467829136,3.791133774915594,0.23999195717949373,0.8406205318929375
739,1739568862,1739568871,9,1.3645814973579142,3.457746976351566,0.7920489955607602,0.28320021421103575
740,1739595382,1739595383,1,1.4082640792647358,3.3738791209915466,0.13151758844487627,0.3252640028161902
741,1739675242,1739675252,10,0.7680443855664585,4.4724001357958505,0.7508498458954711,0.6597591594836757
742,1739657122,1739657123,1,1.184805135855774,3.3531793498884377,0.1243662992744266,0.28077254181770017
743,1739739622,1739739626,4,1.3266536798337691,4.298646472849644,0.2199283755087483,0.44157124016846316
744,1739828242,1739828245,3,0.8514461364127602,4.633204601002637,0.27004388282579217,0.5683914433437637
745,1739826022,1739826030,8,0.6043363534117571,3.7979826944611292,0.23828275268690205,0.38258821933417664
746,1739854342,1739854350,8,0.5672727860580707,4.28466266217641,0.4152856527736022,0.14626424598556925
747,1739778562,1739778564,2,0.5776322214674748,4.7385949926092845,0.23702975992011516,0.34042187245254074
748,1739919562,1739919568,6,1.3765419854102687,4.787259166980508,0.9900108522214444,0.5357448846624683
749,1739903782,1739903786,4,1.3581986618959014,3.1710170753771396,0.7068902377153466,0.8582888236145948
750,1739901502,1739901510,8,1.1698011727128426,4.868806944516159,0.32006704780412576,0.3630306323457898
751,1740019462,1740019467,5,0.8465472400606242,3.4884103470615235,0.4227723432064078,0.9579759348351049
752,1739980222,1739980228,6,1.2952885758489574,4.756891686242322,0.609560087519155,0.884171447375946
753,1739975302,1739975304,2,1.1581673900998701,3.5117933229136797,0.4036767607538774,0.6834146094537126
754,1740027082,1740027089,7,1.3122037473157218,3.294407217511459,0.3565837142141475,0.1839249582274975
755,1740036262,1740036263,1,0.701215409055879,3.7335923568883995,0.12570968221754072,0.7891825457620071
756,1740079942,1740079950,8,0.8382643224151307,4.889587486325182,0.8588032152913364,0.1315317175253345
757,1740083182,1740083185,3,0.7085798622989871,3.300698987442903,0.9342093396904763,0.8263660218114159
758,1740106222,1740106230,8,0.7074587126525508,3.57764539982478,0.18316636306016393,0.35226854505979255
759,1740152542,1740152550,8,0.6704947608458556,3.374503672377413,0.8394855375225482,0.7955521514298791
760,1740185602,1740185610,8,0.6027619479141877,4.350489899308162,0.35557162873014025,0.8016621389184715
761,1740146782,1740146786,4,0.6348177519812819,3.4445975968643543,0.49342318614025726,0.220816727975371
762,1740141562,1740141563,1,0.7568273154990912,3.719547443756147,0.18054106207071274,0.7357538928098438
763,1740273322,1740273324,2,1.383963068268157,3.977581370160498,0.6609828595564007,0.8677317630000623
764,1740208942,1740208952,10,0.6668220670270258,3.5291914207763186,0.6794961259105561,0.6017730423851706
765,1740281002,1740281008,6,0.9343577083678588,3.783796211581988,0.6611451674427934,0.4312300357936951
766,1740235102,1740235107,5,1.3432187581834598,4.271810196926653,0.20836271870295942,0.31047727895906174
767,1740344482,1740344489,7,0.8821310337370267,4.7535124586210635,0.3448545637929332,0.45359651960155734
768,1740437962,1740437966,4,0.7609483548022787,4.469040523943452,0.7985442686872014,0.5015444843718931
769,1740462262,1740462268,6,0.8185263535177341,4.231268705511279,0.27405280223236594,0.3359093950048357
770,1740516442,1740516443,1,0.7712280769655914,3.9823078964980567,0.4464657250698676,0.9466934859589863
771,1740516322,1740516332,10,0.5675572598933328,3.4085046918999,0.2808356744701183,0.923039222747833
772,1740633982,1740633988,6,1.1934195296683314,4.489173217153989,0.8637188849198169,0.9168422870241558
773,1740600562,1740600570,8,1.3303241129962073,3.444752953965791,0.11755211628798683,0.5043117538101425
774,1740606562,1740606566,4,0.7783804356776042,4.912735562419025,0.6015082565050301,0.7728807116444797
775,1740601762,1740601763,1,0.5683410329246739,4.790194540025922,0.2073210527971396,0.44513272574044827
776,1740695182,1740695189,7,0.9159692133987244,4.195710898923326,0.6787670917810379,0.800327528536087
777,1740704362,1740704365,3,0.6984590234323295,4.948929811162834,0.10992090529080517,0.3841748715928782
778,1740716902,1740716912,10,1.1156446463647387,4.910123655284891,0.5460871152794895,0.15860790488658233
779,1740737902,1740737911,9,0.5557536631424113,4.522657233630349,0.7258626171152381,0.22467349076838344
780,1740793882,1740793886,4,0.9772958255595624,3.6698441540723463,0.4857941922407557,0.7244631278226793
781,1740834022,1740834024,2,0.8637550718111543,3.5460912544919463,0.8898967992242206,0.4722010006296925
782,1740848962,1740848963,1,0.9859050390881768,3.271407657288445,0.8263564060876967,0.11577084224461005
783,1740939382,1740939389,7,0.8295825714010973,3.9415134215457965,0.3075198716697106,0.5057973215488399
784,1740985762,1740985772,10,0.7915130860527262,4.573008397603135,0.10907582222739658,0.6949770301447481
785,1740965002,1740965007,5,0.5854279113752568,4.633022865503652,0.8319280975897402,0.5164190947736892
786,1740920662,1740920668,6,1.2213689170225805,4.343842356046826,0.7363816896283502,0.7329455718361373
787,1741008202,1741008204,2,1.1403480772030137,3.5226542930526303,0.15290160678094983,0.4806786220191662
788,1741033822,1741033823,1,1.4041589208190786,3.1797773314140696,0.1706746851087907,0.6926878878663099
789,1741156642,1741156644,2,1.2113196982239742,3.727544381806574,0.9526360550171368,0.7737146682209192
790,1741226602,1741226603,1,0.951890266953593,3.6337640691205433,0.9085651373936653,0.27641250979298027
791,1741264942,1741264949,7,1.4490795653877178,4.9930694165099165,0.8098622167302651,0.3928010338726401
792,1741307542,1741307552,10,1.2966230659647242,4.327631092112102,0.9586930661010421,0.29704637042390025
793,1741302802,1741302809,7,1.3952582325484755,3.8279279605085366,0.30297604197473826,0.5764041946627001
794,1741412002,1741412011,9,0.7565449740076382,4.568793347862389,0.7150349173596976,0.5478154531263817
795,1741428502,1741428503,1,1.1519263937988455,3.45472464411769,0.11716529565663741,0.5296391199767463
796,1741508242,1741508251,9,1.4383202534750716,3.6267876394403267,0.11907589052307925,0.48175841779539363
797,1741670902,1741670903,1,0.8175364014092145,3.3717071690541185,0.7951314336783166,0.4361354711926295
798,1741646062,1741646071,9,0.8408982634311203,4.789753080050876,0.1692094161536561,0.12746097242591403
799,1741672762,1741672768,6,0.5270886215847033,3.1197154612957014,0.8209039675454696,0.39070500389603635
800,1741686802,1741686804,2,0.8976517817108101,3.95466417437735,0.8165965376975108,0.8513851423812793
801,1741706122,1741706127,5,0.7714654705726289,4.318058928851193,0.48454757629171497,0.19475418880902678
802,1741711882,1741711885,3,1.0966933645897328,3.8704602184839,0.1672724851784042,0.8730041104609157
803,1741761682,1741761685,3,1.1878292626207734,4.9591574123475235,0.26944416888647615,0.7040527921794684
804,1741830082,1741830088,6,0.7812762822483685,3.89743904026235,0.35037208473469095,0.14460815290808218
805,1741787902,1741787903,1,1.118661596007199,3.794978762608986,0.22210747431414574,0.8600282204539013
806,1741829962,1741829964,2,0.5800601192586704,3.1942100195718703,0.5509335123760258,0.9720933737101203
807,1741886122,1741886126,4,0.8832124311506021,4.22736632194909,0.1625938190249211,0.6971093113863475
808,1741894702,1741894707,5,1.3679883608797487,4.610544758513476,0.6282620622734317,0.96953272167089
809,1742002342,1742002347,5,1.4210332865551414,3.226416204952745,0.7499367658493753,0.6141115949921888
810,1741961182,1741961189,7,1.4008673985199955,4.578103475462383,0.8368438372286507,0.11864054222433905
811,1741969582,1741969584,2,0.6840736934888674,4.912555522866912,0.1674329517610229,0.41792187057070684
812,1742055202,1742055209,7,1.0521598489157231,4.7688685217824185,0.4333244793065333,0.11568886208905571
813,1742072002,1742072010,8,0.6969304906147902,3.0712215458319774,0.7638852147118934,0.27604980886577
814,1742064322,1742064324,2,0.5425162674821192,3.196181368158006,0.3412760219088384,0.8568942974192857
815,1742144362,1742144372,10,1.1763861357473937,3.2378518493521824,0.20620083819882273,0.9734783907899827
816,1742152702,1742152711,9,0.9323035153783308,3.787787305667565,0.5205840547046958,0.566891753122031
817,1742131462,1742131467,5,0.5401041158389164,4.172807768460615,0.6337191893588688,0.4701995543665636
818,1742178802,1742178812,10,1.0332331737438523,3.671072145555228,0.5861917590641884,0.3397493354881201
819,1742257462,1742257465,3,1.22347568167995,3.783414378965353,0.8595629359807198,0.8517064847629197
820,1742324482,1742324492,10,0.5734131448377877,3.7098462313685534,0.538148163739836,0.9850541136530101
821,1742339902,1742339908,6,1.0876525128322845,4.395680942585729,0.23981139658844636,0.172857146615304
822,1742285422,1742285427,5,0.7511868913530237,4.960979951061465,0.6357288502111789,0.513029677771507
823,1742313922,1742313931,9,1.3058883018924548,4.200295993706858,0.9966805260717464,0.3469888132772821
824,1742401222,1742401225,3,0.8211299576345785,4.683319912125578,0.8780262545729939,0.18091585162768747
825,1742457442,1742457451,9,0.8258447605775909,4.933298900611403,0.3836681805665304,0.7737654699940516
826,1742461282,1742461286,4,0.5078097569336635,4.450586858794571,0.23913659829418235,0.8352558630222734
827,1742498842,1742498847,5,1.164809700315089,3.3629253816813804,0.4813079628715269,0.5308319930491188
828,1742602342,1742602352,10,1.0617113693567681,4.863037077571057,0.9080916612638554,0.7869544454358964
829,1742642182,1742642191,9,1.0768412251660928,4.109688495673992,0.11476042750140665,0.44705939757118607
830,1742637442,1742637446,4,0.900772415762246,3.9043977996979,0.7059394793832592,0.3836460492971754
831,1742647762,1742647768,6,1.4786544786007778,4.241554575307877,0.7957875598273052,0.24690176051161755
832,1742670742,1742670752,10,0.9282617942181124,3.856776294361423,0.42776350004803565,0.2903503129346012
833,1742715922,1742715924,2,1.0279482599396323,3.2826395329674,0.7006353805135407,0.3731524844422037
834,1742766202,1742766207,5,0.5813099151269046,3.240181280214223,0.4002712040198274,0.3367610107153619
835,1742724982,1742724983,1,1.4498608517433476,3.7997013941898388,0.3981735285388277,0.26077140501189744
836,1742721562,1742721569,7,1.36874908846884,4.4355487678950745,0.3207251350251893,0.7600769216416262
837,1742852722,1742852726,4,0.792791790990695,3.481512960980519,0.4207775160578092,0.47175508031780444
838,1742878222,1742878225,3,0.9553870169801928,4.456884845226231,0.5836884232225061,0.20706503107289323
839,1742912722,1742912732,10,0.7080359470274878,3.0496446259206014,0.33012396720069065,0.48079940876222493
840,1742971042,1742971052,10,0.6099031581122447,3.0152617444767795,0.3880686307693211,0.23647648826861214
841,1742888602,1742888604,2,0.9272140881877412,4.798840992865672,0.691301507254712,0.7434688451624237
842,1743021982,1743021992,10,0.7694614410833223,4.74601251199589,0.5411007226046274,0.858637115404007
843,1743041182,1743041185,3,1.1358418340346454,3.0365540102478006,0.8725459203480026,0.4164012498714884
844,1743057322,1743057329,7,1.4091919644281221,4.137358025606419,0.5741848180551832,0.9009077591187533
845,1743014062,1743014064,2,1.2408400911917572,4.29560673617776,0.8627836709031647,0.33787674804995804
846,1743085942,1743085949,7,1.2645955867071927,4.483455708699835,0.9011960372051385,0.2019256466522827
847,1743087262,1743087265,3,0.5617918194043229,4.4510365442369615,0.7465599340457072,0.11395437882775666
848,1743144802,1743144810,8,1.2183956054207234,4.183676951678179,0.5526514388653772,0.44857232628219945
849,1743143482,1743143484,2,0.8200022547548117,3.5385340404005268,0.838630340535301,0.2413743964125657
850,1743146962,1743146966,4,0.7152805348004737,3.4610562566266614,0.6248069125109385,0.3718273348468455
851,1743155542,1743155546,4,1.1199725044799183,3.5803023439566917,0.6669046233343812,0.46614261528141254
852,1743265882,1743265892,10,1.3771546296830928,4.142115850049329,0.8471614174288565,0.4461826582394032
853,1743237862,1743237870,8,0.5989562178877708,3.8966703765860498,0.958201593621132,0.10389616094426346
854,1743326902,1743326907,5,1.4078161992827471,3.4928306603079284,0.5782850279923709,0.2143450835084007
855,1743351742,1743351750,8,0.7753003441312357,3.504919136312016,0.2804018327454112,0.21557356620720178
856,1743463882,1743463883,1,0.9877881799394798,3.340373071838762,0.8538469866105318,0.36968767383245893
857,1743466042,1743466048,6,1.1745021927049888,3.5452763339268767,0.8291883376651705,0.30610638249781774
858,1743487162,1743487163,1,0.8671681205787631,4.561046532713471,0.8410995322746894,0.735243212011681
859,1743438622,1743438624,2,0.6461300390080635,3.172868449004036,0.4042615118274796,0.2311296198737322
860,1743527422,1743527431,9,1.39371122742704,3.180482799283812,0.18596052431133225,0.30765291536230094
861,1743505942,1743505946,4,0.6545911823871184,4.384705582413366,0.2643913289423463,0.3589630857508752
862,1743540202,1743540207,5,0.619046293604761,4.685140947927507,0.7995315577281055,0.73998400375353
863,1743581302,1743581305,3,0.9159798945521628,4.834066236054584,0.9544430290923034,0.6174054250848484
864,1743644182,1743644187,5,1.369979114892172,4.883885851376058,0.5061071867379867,0.6815104888221508
865,1743634942,1743634944,2,0.6068450486604374,3.065764251088237,0.9349883263262914,0.6517054471982338
866,1743595402,1743595407,5,0.9755096384547199,3.3154196317351614,0.8954643071253903,0.4117762185251458
867,1743671902,1743671907,5,0.552658376668497,4.074031566487982,0.8430121469892248,0.31966245805538185
868,1743706402,1743706411,9,0.9956572960958203,4.545582844602332,0.36540745684051734,0.9699003934971008
869,1743804502,1743804504,2,1.1721504282238144,3.0580820452235367,0.8797011817409565,0.4678624228451106
870,1743888022,1743888032,10,1.2552967444676426,4.620342033564682,0.7607744552757085,0.7232437479313925
871,1743999022,1743999028,6,0.9333247838537997,4.13503857689736,0.193034416807229,0.9376800931786448
872,1743938482,1743938485,3,0.8812871113836217,3.9433227109487596,0.5849834178922161,0.49906861342893094
873,1743946162,1743946170,8,1.471053468562119,3.7759827847681344,0.1257154388584291,0.24421335939197503
874,1744007362,1744007368,6,1.005225321777866,4.965583726166795,0.9970657794365219,0.37895257752354927
875,1744026322,1744026328,6,1.2064907675785599,3.1275170474263323,0.22206997995560612,0.7414428990962045
876,1744080622,1744080629,7,1.050430839227425,3.433436931508572,0.9930698493246825,0.30168093557991155
877,1744043902,1744043905,3,1.0480737216689975,4.0264667256687305,0.5306935449034397,0.7100540870690363
878,1744166662,1744166666,4,1.0233230190665656,4.8758064919469515,0.4194280426171417,0.5903799332701222
879,1744190422,1744190427,5,1.273170969335168,3.803372273671749,0.8178563422546428,0.577880039148195
880,1744197742,1744197745,3,1.319222248644429,3.9434933293107504,0.7415243775838815,0.8576453888164794
881,1744243762,1744243770,8,1.3072359190144742,3.283963260910555,0.9299620525475827,0.21131748951979873
882,1744318162,1744318169,7,0.9284150917890641,4.439345924182909,0.16360879656583333,0.2803359502786441
883,1744305382,1744305389,7,0.5522036279860435,4.690593571451683,0.9267365346003738,0.24759676024014865
884,1744361602,1744361605,3,0.5928539105581055,4.797788031708637,0.6092585108394698,0.9376816150038166
885,1744410862,1744410870,8,1.1786963867820623,4.604171995566675,0.2911263803482836,0.1780400531263619
886,1744388722,1744388724,2,1.1289310321370576,4.445929419970309,0.31253115396831727,0.9190577812696487
887,1744415182,1744415192,10,1.4733599982085286,4.367034962781731,0.7304684390905094,0.11706988543065831
888,1744457542,1744457543,1,1.2412815610959003,3.9976700058500443,0.8262329708129722,0.8167271906983635
889,1744454602,1744454612,10,0.5179573033866737,4.503930419208045,0.1470741101137243,0.20548156346616753
890,1744462522,1744462531,9,1.2721156965777332,3.4113274722916676,0.6361683623045128,0.7401057091227956
891,1744547362,1744547365,3,1.2319234816293057,4.116663592536364,0.42826388050834574,0.8084612731276363
892,1744605502,1744605508,6,1.2073622770514882,4.322357837190749,0.43720717298585055,0.15297489312900558
893,1744531042,1744531043,1,1.1952987958614283,3.120172907482761,0.8113433984330254,0.6697875272711359
894,1744637542,1744637543,1,1.3199631275728676,3.246193603465099,0.23909627320498253,0.3415916088713282
895,1744677022,1744677025,3,1.2117237305629445,4.800828254314958,0.28881801905219173,0.2735900944049434
896,1744679362,1744679368,6,0.763237713456246,4.699425932557721,0.9482806438012591,0.23054395638505537
897,1744657882,1744657887,5,1.2770840960080387,3.1087864036060058,0.6203842858506239,0.9573067002588788
898,1744734922,1744734926,4,0.8527156331273259,3.489017896851651,0.2264788973684544,0.5495177217181193
899,1744746322,1744746327,5,1.4464990563399485,3.0755973797956457,0.1303072413696158,0.5228114968191453
900,1744864042,1744864044,2,1.0693576534572893,4.449992287392496,0.4050884458278592,0.5105082558621962
901,1744794442,1744794447,5,0.9091808639660506,3.491776383726633,0.9580515393024083,0.5316851731015118
902,1744798222,1744798225,3,1.4173068543105063,4.436957169542293,0.39202228145135487,0.3369795001793187
903,1744845202,1744845204,2,1.2886759352807782,3.4691426189745966,0.4195592773997505,0.42046298336994614
904,1744920382,1744920388,6,1.1165447706429068,4.414530955959933,0.7747023139003675,0.2907437268161922
905,1744942342,1744942348,6,0.6384129049255752,3.9524377808655706,0.23165270473021946,0.46470537029073256
906,1744874662,1744874668,6,1.1763262341920837,3.38224848339775,0.6721633139640214,0.19727100087512103
907,1744962802,1744962809,7,0.6556356838452994,3.702680194851114,0.3344851900029427,0.7829953462850474
908,1745036122,1745036123,1,1.438982680423802,3.130175781299842,0.564402519319711,0.48393520896246456
909,1745043322,1745043330,8,0.7930288335643282,4.537798271250501,0.5726324489049065,0.8183194509613819
910,1744966462,1744966470,8,1.2906919960683259,4.183660806602029,0.7853619255155014,0.7229534669870806
911,1745052982,1745052986,4,1.4168116314684436,3.244444350082387,0.6790820412283028,0.7231596047062026
912,1745118322,1745118326,4,0.9480119846041692,4.378999975631255,0.14338535293507632,0.646772089410966
913,1745127862,1745127865,3,1.2182157689208366,3.3577754729898133,0.9123713815208775,0.8290778563862213
914,1745128702,1745128710,8,1.0919888091294472,4.949150037224139,0.5903954470650221,0.27077646063360505
915,1745150962,1745150963,1,1.109539331249327,3.72069525042678,0.6439417694938379,0.7558056168095288
916,1745165062,1745165068,6,0.6177846642187429,4.796412799551499,0.7122173275998861,0.11799769698154777
917,1745245222,1745245223,1,0.552298781320381,4.895084808872382,0.8512867803010924,0.6210967261013428
918,1745276182,1745276189,7,1.0402631157253555,4.285222277876997,0.9170721430258597,0.6980849732232963
919,1745285242,1745285243,1,0.5217711916129126,4.5267349986588625,0.6656478691773025,0.967091692132277
920,1745385082,1745385092,10,0.8099692873186862,4.979114104435775,0.311980705119249,0.16526818731697607
